"state_id","state","city_id","city","total","male","female","share","total_old","male_old","female_old","share_old","farming","production","service"
1,"Schleswig-Holstein",1001000,"Flensburg, Stadt",82801,40817,41984,0.492952983659618,89357,44028,45329,0.492720212182593,0.0180150197514072,0.248694091941715,0.733290888306877
1,"Schleswig-Holstein",1002000,"Kiel, Landeshauptstadt",237667,114429,123238,0.481467767927394,242041,118724,123317,0.490511938060081,0.0180150197514072,0.248694091941715,0.733290888306877
1,"Schleswig-Holstein",1003000,"Lübeck, Hansestadt",210679,100153,110526,0.475381979219571,210577,100356,110221,0.476576264264378,0.0180150197514072,0.248694091941715,0.733290888306877
1,"Schleswig-Holstein",1004000,"Neumünster, Stadt",77201,37724,39477,0.488646520122796,76939,37953,38986,0.49328688961385,0.0180150197514072,0.248694091941715,0.733290888306877
1,"Schleswig-Holstein",1051001,"Albersdorf",3500,1694,1806,0.484,3468,1701,1767,0.490484429065744,0.0180150197514072,0.248694091941715,0.733290888306877
1,"Schleswig-Holstein",1051002,"Arkebek",225,111,114,0.493333333333333,239,118,121,0.493723849372385,0.0180150197514072,0.248694091941715,0.733290888306877
1,"Schleswig-Holstein",1051003,"Averlak",610,310,300,0.508196721311475,594,298,296,0.501683501683502,0.0180150197514072,0.248694091941715,0.733290888306877
1,"Schleswig-Holstein",1051004,"Bargenstedt",912,431,481,0.472587719298246,910,440,470,0.483516483516484,0.0180150197514072,0.248694091941715,0.733290888306877
1,"Schleswig-Holstein",1051005,"Barkenholm",177,97,80,0.548022598870056,176,92,84,0.522727272727273,0.0180150197514072,0.248694091941715,0.733290888306877
1,"Schleswig-Holstein",1051006,"Barlt",799,399,400,0.499374217772215,787,397,390,0.504447268106734,0.0180150197514072,0.248694091941715,0.733290888306877
1,"Schleswig-Holstein",1051008,"Bergewöhrden",38,17,21,0.447368421052632,36,15,21,0.416666666666667,0.0180150197514072,0.248694091941715,0.733290888306877
1,"Schleswig-Holstein",1051010,"Brickeln",216,106,110,0.490740740740741,217,110,107,0.506912442396313,0.0180150197514072,0.248694091941715,0.733290888306877
1,"Schleswig-Holstein",1051011,"Brunsbüttel, Stadt",12734,6323,6411,0.496544683524423,12989,6467,6522,0.497882823927939,0.0180150197514072,0.248694091941715,0.733290888306877
1,"Schleswig-Holstein",1051012,"Buchholz",1085,552,533,0.508755760368664,1086,560,526,0.515653775322284,0.0180150197514072,0.248694091941715,0.733290888306877
1,"Schleswig-Holstein",1051013,"Büsum",4810,2218,2592,0.461122661122661,5037,2345,2692,0.465554893785984,0.0180150197514072,0.248694091941715,0.733290888306877
1,"Schleswig-Holstein",1051014,"Büsumer Deichhausen",366,168,198,0.459016393442623,340,135,205,0.397058823529412,0.0180150197514072,0.248694091941715,0.733290888306877
1,"Schleswig-Holstein",1051015,"Bunsoh",805,410,395,0.509316770186335,862,446,416,0.517401392111369,0.0180150197514072,0.248694091941715,0.733290888306877
1,"Schleswig-Holstein",1051016,"Burg (Dithmarschen)",4187,2021,2166,0.482684499641748,4173,2026,2147,0.485502036903906,0.0180150197514072,0.248694091941715,0.733290888306877
1,"Schleswig-Holstein",1051017,"Busenwurth",277,150,127,0.541516245487365,288,159,129,0.552083333333333,0.0180150197514072,0.248694091941715,0.733290888306877
1,"Schleswig-Holstein",1051019,"Dellstedt",774,398,376,0.51421188630491,789,405,384,0.513307984790874,0.0180150197514072,0.248694091941715,0.733290888306877
1,"Schleswig-Holstein",1051020,"Delve",711,365,346,0.513361462728551,712,370,342,0.519662921348315,0.0180150197514072,0.248694091941715,0.733290888306877
1,"Schleswig-Holstein",1051021,"Diekhusen-Fahrstedt",756,396,360,0.523809523809524,752,397,355,0.527925531914894,0.0180150197514072,0.248694091941715,0.733290888306877
1,"Schleswig-Holstein",1051022,"Dingen",659,329,330,0.499241274658574,662,329,333,0.496978851963746,0.0180150197514072,0.248694091941715,0.733290888306877
1,"Schleswig-Holstein",1051023,"Dörpling",604,304,300,0.503311258278146,610,310,300,0.508196721311475,0.0180150197514072,0.248694091941715,0.733290888306877
1,"Schleswig-Holstein",1051024,"Eddelak",1408,693,715,0.4921875,1353,666,687,0.492239467849224,0.0180150197514072,0.248694091941715,0.733290888306877
1,"Schleswig-Holstein",1051026,"Eggstedt",773,381,392,0.492884864165589,772,385,387,0.498704663212435,0.0180150197514072,0.248694091941715,0.733290888306877
1,"Schleswig-Holstein",1051027,"Elpersbüttel",883,451,432,0.510758776896942,879,449,430,0.510807736063709,0.0180150197514072,0.248694091941715,0.733290888306877
1,"Schleswig-Holstein",1051028,"Epenwöhrden",775,384,391,0.495483870967742,799,404,395,0.505632040050063,0.0180150197514072,0.248694091941715,0.733290888306877
1,"Schleswig-Holstein",1051030,"Fedderingen",274,132,142,0.481751824817518,278,137,141,0.492805755395683,0.0180150197514072,0.248694091941715,0.733290888306877
1,"Schleswig-Holstein",1051032,"Frestedt",381,195,186,0.511811023622047,381,194,187,0.509186351706037,0.0180150197514072,0.248694091941715,0.733290888306877
1,"Schleswig-Holstein",1051033,"Friedrichsgabekoog",53,26,27,0.490566037735849,54,22,32,0.407407407407407,0.0180150197514072,0.248694091941715,0.733290888306877
1,"Schleswig-Holstein",1051034,"Friedrichskoog",2492,1223,1269,0.490770465489567,2448,1222,1226,0.499183006535948,0.0180150197514072,0.248694091941715,0.733290888306877
1,"Schleswig-Holstein",1051035,"Gaushorn",178,86,92,0.48314606741573,188,94,94,0.5,0.0180150197514072,0.248694091941715,0.733290888306877
1,"Schleswig-Holstein",1051036,"Glüsing",116,65,51,0.560344827586207,113,64,49,0.566371681415929,0.0180150197514072,0.248694091941715,0.733290888306877
1,"Schleswig-Holstein",1051037,"Großenrade",490,240,250,0.489795918367347,505,254,251,0.502970297029703,0.0180150197514072,0.248694091941715,0.733290888306877
1,"Schleswig-Holstein",1051038,"Groven",79,51,28,0.645569620253165,119,69,50,0.579831932773109,0.0180150197514072,0.248694091941715,0.733290888306877
1,"Schleswig-Holstein",1051039,"Gudendorf",392,196,196,0.5,401,197,204,0.491271820448878,0.0180150197514072,0.248694091941715,0.733290888306877
1,"Schleswig-Holstein",1051043,"Hedwigenkoog",247,113,134,0.45748987854251,283,132,151,0.46643109540636,0.0180150197514072,0.248694091941715,0.733290888306877
1,"Schleswig-Holstein",1051044,"Heide, Stadt",20773,9757,11016,0.469696240311943,20814,9963,10851,0.478668204093399,0.0180150197514072,0.248694091941715,0.733290888306877
1,"Schleswig-Holstein",1051045,"Hellschen-Heringsand-Unterschaar",173,84,89,0.485549132947977,180,82,98,0.455555555555556,0.0180150197514072,0.248694091941715,0.733290888306877
1,"Schleswig-Holstein",1051046,"Helse",931,466,465,0.500537056928034,974,485,489,0.497946611909651,0.0180150197514072,0.248694091941715,0.733290888306877
1,"Schleswig-Holstein",1051047,"Hemme",521,265,256,0.508637236084453,561,298,263,0.531194295900178,0.0180150197514072,0.248694091941715,0.733290888306877
1,"Schleswig-Holstein",1051048,"Hemmingstedt",2923,1467,1456,0.501881628463907,2923,1455,1468,0.497776257269928,0.0180150197514072,0.248694091941715,0.733290888306877
1,"Schleswig-Holstein",1051049,"Hennstedt",1954,984,970,0.503582395087001,1914,968,946,0.505747126436782,0.0180150197514072,0.248694091941715,0.733290888306877
1,"Schleswig-Holstein",1051050,"Hillgroven",75,46,29,0.613333333333333,82,52,30,0.634146341463415,0.0180150197514072,0.248694091941715,0.733290888306877
1,"Schleswig-Holstein",1051051,"Hochdonn",1183,576,607,0.486897717666948,1209,599,610,0.495450785773366,0.0180150197514072,0.248694091941715,0.733290888306877
1,"Schleswig-Holstein",1051052,"Hövede",70,38,32,0.542857142857143,68,41,27,0.602941176470588,0.0180150197514072,0.248694091941715,0.733290888306877
1,"Schleswig-Holstein",1051053,"Hollingstedt",312,155,157,0.496794871794872,296,153,143,0.516891891891892,0.0180150197514072,0.248694091941715,0.733290888306877
1,"Schleswig-Holstein",1051054,"Immenstedt",103,45,58,0.436893203883495,99,40,59,0.404040404040404,0.0180150197514072,0.248694091941715,0.733290888306877
1,"Schleswig-Holstein",1051057,"Kaiser-Wilhelm-Koog",361,185,176,0.512465373961219,389,199,190,0.511568123393316,0.0180150197514072,0.248694091941715,0.733290888306877
1,"Schleswig-Holstein",1051058,"Karolinenkoog",146,77,69,0.527397260273973,135,71,64,0.525925925925926,0.0180150197514072,0.248694091941715,0.733290888306877
1,"Schleswig-Holstein",1051060,"Kleve",439,222,217,0.505694760820046,415,212,203,0.510843373493976,0.0180150197514072,0.248694091941715,0.733290888306877
1,"Schleswig-Holstein",1051061,"Krempel",605,310,295,0.512396694214876,609,308,301,0.505747126436782,0.0180150197514072,0.248694091941715,0.733290888306877
1,"Schleswig-Holstein",1051062,"Kronprinzenkoog",823,407,416,0.49453219927096,864,436,428,0.50462962962963,0.0180150197514072,0.248694091941715,0.733290888306877
1,"Schleswig-Holstein",1051063,"Krumstedt",524,260,264,0.49618320610687,533,260,273,0.48780487804878,0.0180150197514072,0.248694091941715,0.733290888306877
1,"Schleswig-Holstein",1051064,"Kuden",643,332,311,0.516329704510109,658,342,316,0.519756838905775,0.0180150197514072,0.248694091941715,0.733290888306877
1,"Schleswig-Holstein",1051065,"Lehe",1077,525,552,0.487465181058496,1066,520,546,0.48780487804878,0.0180150197514072,0.248694091941715,0.733290888306877
1,"Schleswig-Holstein",1051067,"Lieth",415,182,233,0.43855421686747,392,183,209,0.466836734693878,0.0180150197514072,0.248694091941715,0.733290888306877
1,"Schleswig-Holstein",1051068,"Linden",849,429,420,0.50530035335689,836,425,411,0.508373205741627,0.0180150197514072,0.248694091941715,0.733290888306877
1,"Schleswig-Holstein",1051069,"Lohe-Rickelshof",2044,974,1070,0.476516634050881,2042,968,1074,0.474045053868756,0.0180150197514072,0.248694091941715,0.733290888306877
1,"Schleswig-Holstein",1051071,"Lunden",1738,880,858,0.506329113924051,1604,827,777,0.515586034912718,0.0180150197514072,0.248694091941715,0.733290888306877
1,"Schleswig-Holstein",1051072,"Marne, Stadt",5631,2640,2991,0.468833244539158,5699,2664,3035,0.467450429899982,0.0180150197514072,0.248694091941715,0.733290888306877
1,"Schleswig-Holstein",1051073,"Marnerdeich",403,215,188,0.533498759305211,338,187,151,0.553254437869823,0.0180150197514072,0.248694091941715,0.733290888306877
1,"Schleswig-Holstein",1051074,"Meldorf, Stadt",7253,3476,3777,0.479249965531504,7364,3561,3803,0.483568712656165,0.0180150197514072,0.248694091941715,0.733290888306877
1,"Schleswig-Holstein",1051075,"Neuenkirchen",1038,532,506,0.51252408477842,1022,527,495,0.515655577299413,0.0180150197514072,0.248694091941715,0.733290888306877
1,"Schleswig-Holstein",1051076,"Neufeld",628,324,304,0.515923566878981,623,332,291,0.532905296950241,0.0180150197514072,0.248694091941715,0.733290888306877
1,"Schleswig-Holstein",1051077,"Neufelderkoog",127,65,62,0.511811023622047,138,65,73,0.471014492753623,0.0180150197514072,0.248694091941715,0.733290888306877
1,"Schleswig-Holstein",1051078,"Nindorf",1147,579,568,0.504795117698344,1183,605,578,0.511411665257819,0.0180150197514072,0.248694091941715,0.733290888306877
1,"Schleswig-Holstein",1051079,"Norddeich",436,232,204,0.532110091743119,408,214,194,0.524509803921569,0.0180150197514072,0.248694091941715,0.733290888306877
1,"Schleswig-Holstein",1051080,"Norderheistedt",143,70,73,0.48951048951049,142,72,70,0.507042253521127,0.0180150197514072,0.248694091941715,0.733290888306877
1,"Schleswig-Holstein",1051081,"Norderwöhrden",294,158,136,0.537414965986395,289,156,133,0.539792387543253,0.0180150197514072,0.248694091941715,0.733290888306877
1,"Schleswig-Holstein",1051082,"Nordhastedt",2745,1368,1377,0.498360655737705,2754,1402,1352,0.509077705156136,0.0180150197514072,0.248694091941715,0.733290888306877
1,"Schleswig-Holstein",1051083,"Odderade",321,160,161,0.498442367601246,318,160,158,0.50314465408805,0.0180150197514072,0.248694091941715,0.733290888306877
1,"Schleswig-Holstein",1051084,"Oesterdeichstrich",244,122,122,0.5,284,145,139,0.51056338028169,0.0180150197514072,0.248694091941715,0.733290888306877
1,"Schleswig-Holstein",1051085,"Offenbüttel",273,136,137,0.498168498168498,284,140,144,0.492957746478873,0.0180150197514072,0.248694091941715,0.733290888306877
1,"Schleswig-Holstein",1051086,"Osterrade",433,218,215,0.503464203233256,442,231,211,0.52262443438914,0.0180150197514072,0.248694091941715,0.733290888306877
1,"Schleswig-Holstein",1051087,"Ostrohe",959,472,487,0.492179353493222,940,459,481,0.488297872340426,0.0180150197514072,0.248694091941715,0.733290888306877
1,"Schleswig-Holstein",1051088,"Pahlen",1196,595,601,0.497491638795987,1180,589,591,0.499152542372881,0.0180150197514072,0.248694091941715,0.733290888306877
1,"Schleswig-Holstein",1051089,"Quickborn",193,90,103,0.466321243523316,201,92,109,0.45771144278607,0.0180150197514072,0.248694091941715,0.733290888306877
1,"Schleswig-Holstein",1051090,"Ramhusen",166,86,80,0.518072289156627,165,87,78,0.527272727272727,0.0180150197514072,0.248694091941715,0.733290888306877
1,"Schleswig-Holstein",1051092,"Rehm-Flehde-Bargen",517,267,250,0.516441005802708,534,285,249,0.533707865168539,0.0180150197514072,0.248694091941715,0.733290888306877
1,"Schleswig-Holstein",1051093,"Reinsbüttel",448,223,225,0.497767857142857,443,217,226,0.489841986455982,0.0180150197514072,0.248694091941715,0.733290888306877
1,"Schleswig-Holstein",1051096,"Sankt Annen",331,174,157,0.525679758308157,335,178,157,0.53134328358209,0.0180150197514072,0.248694091941715,0.733290888306877
1,"Schleswig-Holstein",1051097,"Sankt Michaelisdonn",3583,1784,1799,0.497906782026235,3598,1790,1808,0.497498610339077,0.0180150197514072,0.248694091941715,0.733290888306877
1,"Schleswig-Holstein",1051098,"Sarzbüttel",730,367,363,0.502739726027397,729,372,357,0.510288065843621,0.0180150197514072,0.248694091941715,0.733290888306877
1,"Schleswig-Holstein",1051099,"Schafstedt",1355,683,672,0.504059040590406,1321,661,660,0.500378501135503,0.0180150197514072,0.248694091941715,0.733290888306877
1,"Schleswig-Holstein",1051100,"Schalkholz",597,295,302,0.494137353433836,582,281,301,0.482817869415808,0.0180150197514072,0.248694091941715,0.733290888306877
1,"Schleswig-Holstein",1051102,"Schlichting",224,115,109,0.513392857142857,218,106,112,0.486238532110092,0.0180150197514072,0.248694091941715,0.733290888306877
1,"Schleswig-Holstein",1051103,"Schmedeswurth",195,104,91,0.533333333333333,193,102,91,0.528497409326425,0.0180150197514072,0.248694091941715,0.733290888306877
1,"Schleswig-Holstein",1051104,"Schrum",79,42,37,0.531645569620253,76,42,34,0.552631578947368,0.0180150197514072,0.248694091941715,0.733290888306877
1,"Schleswig-Holstein",1051105,"Schülp",475,243,232,0.511578947368421,484,244,240,0.504132231404959,0.0180150197514072,0.248694091941715,0.733290888306877
1,"Schleswig-Holstein",1051107,"Stelle-Wittenwurth",458,213,245,0.465065502183406,468,224,244,0.478632478632479,0.0180150197514072,0.248694091941715,0.733290888306877
1,"Schleswig-Holstein",1051108,"Strübbel",87,41,46,0.471264367816092,85,40,45,0.470588235294118,0.0180150197514072,0.248694091941715,0.733290888306877
1,"Schleswig-Holstein",1051109,"Süderdeich",472,231,241,0.489406779661017,507,252,255,0.497041420118343,0.0180150197514072,0.248694091941715,0.733290888306877
1,"Schleswig-Holstein",1051110,"Süderhastedt",860,426,434,0.495348837209302,860,421,439,0.48953488372093,0.0180150197514072,0.248694091941715,0.733290888306877
1,"Schleswig-Holstein",1051113,"Wöhrden",1308,657,651,0.502293577981651,1294,653,641,0.504636785162287,0.0180150197514072,0.248694091941715,0.733290888306877
1,"Schleswig-Holstein",1051114,"Tellingstedt",2629,1288,1341,0.489920121719285,2510,1225,1285,0.48804780876494,0.0180150197514072,0.248694091941715,0.733290888306877
1,"Schleswig-Holstein",1051117,"Tielenhemme",163,78,85,0.478527607361963,140,69,71,0.492857142857143,0.0180150197514072,0.248694091941715,0.733290888306877
1,"Schleswig-Holstein",1051118,"Trennewurth",259,137,122,0.528957528957529,260,136,124,0.523076923076923,0.0180150197514072,0.248694091941715,0.733290888306877
1,"Schleswig-Holstein",1051119,"Volsemenhusen",349,180,169,0.515759312320917,348,179,169,0.514367816091954,0.0180150197514072,0.248694091941715,0.733290888306877
1,"Schleswig-Holstein",1051120,"Wallen",33,18,15,0.545454545454545,31,17,14,0.548387096774194,0.0180150197514072,0.248694091941715,0.733290888306877
1,"Schleswig-Holstein",1051121,"Warwerort",244,122,122,0.5,288,146,142,0.506944444444444,0.0180150197514072,0.248694091941715,0.733290888306877
1,"Schleswig-Holstein",1051122,"Weddingstedt",2295,1130,1165,0.492374727668845,2259,1103,1156,0.488269145639664,0.0180150197514072,0.248694091941715,0.733290888306877
1,"Schleswig-Holstein",1051125,"Welmbüttel",457,219,238,0.479212253829322,453,225,228,0.496688741721854,0.0180150197514072,0.248694091941715,0.733290888306877
1,"Schleswig-Holstein",1051126,"Wennbüttel",91,42,49,0.461538461538462,82,36,46,0.439024390243902,0.0180150197514072,0.248694091941715,0.733290888306877
1,"Schleswig-Holstein",1051127,"Wesselburen, Stadt",3025,1439,1586,0.475702479338843,3021,1433,1588,0.474346242965905,0.0180150197514072,0.248694091941715,0.733290888306877
1,"Schleswig-Holstein",1051128,"Wesselburener Deichhausen",125,62,63,0.496,134,66,68,0.492537313432836,0.0180150197514072,0.248694091941715,0.733290888306877
1,"Schleswig-Holstein",1051129,"Wesselburenerkoog",147,80,67,0.54421768707483,117,60,57,0.512820512820513,0.0180150197514072,0.248694091941715,0.733290888306877
1,"Schleswig-Holstein",1051130,"Wesseln",1402,710,692,0.50641940085592,1385,693,692,0.500361010830325,0.0180150197514072,0.248694091941715,0.733290888306877
1,"Schleswig-Holstein",1051131,"Westerborstel",116,56,60,0.482758620689655,115,54,61,0.469565217391304,0.0180150197514072,0.248694091941715,0.733290888306877
1,"Schleswig-Holstein",1051132,"Westerdeichstrich",840,406,434,0.483333333333333,923,457,466,0.495124593716143,0.0180150197514072,0.248694091941715,0.733290888306877
1,"Schleswig-Holstein",1051133,"Wiemerstedt",159,78,81,0.490566037735849,157,77,80,0.490445859872611,0.0180150197514072,0.248694091941715,0.733290888306877
1,"Schleswig-Holstein",1051134,"Windbergen",820,420,400,0.51219512195122,826,426,400,0.515738498789346,0.0180150197514072,0.248694091941715,0.733290888306877
1,"Schleswig-Holstein",1051135,"Wolmersdorf",338,171,167,0.505917159763314,333,168,165,0.504504504504504,0.0180150197514072,0.248694091941715,0.733290888306877
1,"Schleswig-Holstein",1051136,"Wrohm",683,355,328,0.519765739385066,707,361,346,0.510608203677511,0.0180150197514072,0.248694091941715,0.733290888306877
1,"Schleswig-Holstein",1051137,"Nordermeldorf",604,315,289,0.521523178807947,625,329,296,0.5264,0.0180150197514072,0.248694091941715,0.733290888306877
1,"Schleswig-Holstein",1051138,"Tensbüttel-Röst",687,336,351,0.489082969432314,685,339,346,0.494890510948905,0.0180150197514072,0.248694091941715,0.733290888306877
1,"Schleswig-Holstein",1051139,"Süderdorf",372,183,189,0.491935483870968,373,190,183,0.509383378016086,0.0180150197514072,0.248694091941715,0.733290888306877
1,"Schleswig-Holstein",1051140,"Oesterwurth",269,141,128,0.524163568773234,262,139,123,0.530534351145038,0.0180150197514072,0.248694091941715,0.733290888306877
1,"Schleswig-Holstein",1051141,"Süderheistedt",563,279,284,0.495559502664298,570,273,297,0.478947368421053,0.0180150197514072,0.248694091941715,0.733290888306877
1,"Schleswig-Holstein",1053001,"Albsfelde",66,34,32,0.515151515151515,60,31,29,0.516666666666667,0.0180150197514072,0.248694091941715,0.733290888306877
1,"Schleswig-Holstein",1053002,"Alt Mölln",865,416,449,0.480924855491329,914,449,465,0.491247264770241,0.0180150197514072,0.248694091941715,0.733290888306877
1,"Schleswig-Holstein",1053003,"Aumühle",3162,1471,1691,0.465211891208096,3021,1362,1659,0.450844091360477,0.0180150197514072,0.248694091941715,0.733290888306877
1,"Schleswig-Holstein",1053004,"Bäk",870,417,453,0.479310344827586,846,408,438,0.482269503546099,0.0180150197514072,0.248694091941715,0.733290888306877
1,"Schleswig-Holstein",1053005,"Bälau",245,110,135,0.448979591836735,244,106,138,0.434426229508197,0.0180150197514072,0.248694091941715,0.733290888306877
1,"Schleswig-Holstein",1053006,"Basedow",651,339,312,0.52073732718894,712,379,333,0.532303370786517,0.0180150197514072,0.248694091941715,0.733290888306877
1,"Schleswig-Holstein",1053007,"Basthorst",398,202,196,0.507537688442211,405,213,192,0.525925925925926,0.0180150197514072,0.248694091941715,0.733290888306877
1,"Schleswig-Holstein",1053008,"Behlendorf",376,186,190,0.49468085106383,387,196,191,0.506459948320413,0.0180150197514072,0.248694091941715,0.733290888306877
1,"Schleswig-Holstein",1053009,"Berkenthin",2070,1019,1051,0.492270531400966,2030,1002,1028,0.493596059113301,0.0180150197514072,0.248694091941715,0.733290888306877
1,"Schleswig-Holstein",1053010,"Besenthal",79,43,36,0.544303797468354,77,44,33,0.571428571428571,0.0180150197514072,0.248694091941715,0.733290888306877
1,"Schleswig-Holstein",1053011,"Bliestorf",668,320,348,0.479041916167665,648,305,343,0.470679012345679,0.0180150197514072,0.248694091941715,0.733290888306877
1,"Schleswig-Holstein",1053012,"Börnsen",4286,2139,2147,0.499066728884741,4160,2051,2109,0.493028846153846,0.0180150197514072,0.248694091941715,0.733290888306877
1,"Schleswig-Holstein",1053013,"Borstorf",280,137,143,0.489285714285714,287,139,148,0.484320557491289,0.0180150197514072,0.248694091941715,0.733290888306877
1,"Schleswig-Holstein",1053014,"Breitenfelde",1867,937,930,0.50187466523835,1819,925,894,0.508521165475536,0.0180150197514072,0.248694091941715,0.733290888306877
1,"Schleswig-Holstein",1053015,"Bröthen",279,141,138,0.505376344086022,272,142,130,0.522058823529412,0.0180150197514072,0.248694091941715,0.733290888306877
1,"Schleswig-Holstein",1053016,"Brunsmark",151,75,76,0.496688741721854,163,85,78,0.521472392638037,0.0180150197514072,0.248694091941715,0.733290888306877
1,"Schleswig-Holstein",1053017,"Brunstorf",632,322,310,0.509493670886076,614,316,298,0.514657980456026,0.0180150197514072,0.248694091941715,0.733290888306877
1,"Schleswig-Holstein",1053018,"Buchholz",239,114,125,0.476987447698745,235,115,120,0.48936170212766,0.0180150197514072,0.248694091941715,0.733290888306877
1,"Schleswig-Holstein",1053019,"Buchhorst",175,83,92,0.474285714285714,169,80,89,0.473372781065089,0.0180150197514072,0.248694091941715,0.733290888306877
1,"Schleswig-Holstein",1053020,"Büchen",5662,2762,2900,0.487813493465207,5602,2748,2854,0.490539093181007,0.0180150197514072,0.248694091941715,0.733290888306877
1,"Schleswig-Holstein",1053021,"Dahmker",159,85,74,0.534591194968553,150,83,67,0.553333333333333,0.0180150197514072,0.248694091941715,0.733290888306877
1,"Schleswig-Holstein",1053022,"Dalldorf",362,182,180,0.502762430939227,367,188,179,0.512261580381471,0.0180150197514072,0.248694091941715,0.733290888306877
1,"Schleswig-Holstein",1053023,"Dassendorf",3100,1553,1547,0.500967741935484,3107,1545,1562,0.497264242034117,0.0180150197514072,0.248694091941715,0.733290888306877
1,"Schleswig-Holstein",1053024,"Düchelsdorf",158,83,75,0.525316455696203,160,84,76,0.525,0.0180150197514072,0.248694091941715,0.733290888306877
1,"Schleswig-Holstein",1053025,"Duvensee",529,247,282,0.466918714555766,509,238,271,0.467583497053045,0.0180150197514072,0.248694091941715,0.733290888306877
1,"Schleswig-Holstein",1053026,"Einhaus",374,180,194,0.481283422459893,374,182,192,0.486631016042781,0.0180150197514072,0.248694091941715,0.733290888306877
1,"Schleswig-Holstein",1053027,"Elmenhorst",893,448,445,0.501679731243001,925,490,435,0.52972972972973,0.0180150197514072,0.248694091941715,0.733290888306877
1,"Schleswig-Holstein",1053028,"Escheburg",3354,1665,1689,0.496422182468694,3375,1698,1677,0.503111111111111,0.0180150197514072,0.248694091941715,0.733290888306877
1,"Schleswig-Holstein",1053029,"Fitzen",332,172,160,0.518072289156627,370,182,188,0.491891891891892,0.0180150197514072,0.248694091941715,0.733290888306877
1,"Schleswig-Holstein",1053030,"Fredeburg",40,22,18,0.55,31,14,17,0.451612903225806,0.0180150197514072,0.248694091941715,0.733290888306877
1,"Schleswig-Holstein",1053031,"Fuhlenhagen",284,139,145,0.48943661971831,296,139,157,0.469594594594595,0.0180150197514072,0.248694091941715,0.733290888306877
1,"Schleswig-Holstein",1053032,"Geesthacht, Stadt",28852,13955,14897,0.483675308470817,29481,14332,15149,0.486143617923408,0.0180150197514072,0.248694091941715,0.733290888306877
1,"Schleswig-Holstein",1053033,"Giesensdorf",125,63,62,0.504,119,60,59,0.504201680672269,0.0180150197514072,0.248694091941715,0.733290888306877
1,"Schleswig-Holstein",1053034,"Göldenitz",233,121,112,0.51931330472103,233,120,113,0.515021459227468,0.0180150197514072,0.248694091941715,0.733290888306877
1,"Schleswig-Holstein",1053035,"Göttin",60,31,29,0.516666666666667,51,27,24,0.529411764705882,0.0180150197514072,0.248694091941715,0.733290888306877
1,"Schleswig-Holstein",1053036,"Grabau",282,141,141,0.5,280,132,148,0.471428571428571,0.0180150197514072,0.248694091941715,0.733290888306877
1,"Schleswig-Holstein",1053037,"Grambek",419,199,220,0.474940334128878,425,201,224,0.472941176470588,0.0180150197514072,0.248694091941715,0.733290888306877
1,"Schleswig-Holstein",1053038,"Grinau",302,158,144,0.52317880794702,315,161,154,0.511111111111111,0.0180150197514072,0.248694091941715,0.733290888306877
1,"Schleswig-Holstein",1053039,"Groß Boden",192,99,93,0.515625,197,103,94,0.522842639593909,0.0180150197514072,0.248694091941715,0.733290888306877
1,"Schleswig-Holstein",1053040,"Groß Disnack",82,45,37,0.548780487804878,86,51,35,0.593023255813954,0.0180150197514072,0.248694091941715,0.733290888306877
1,"Schleswig-Holstein",1053041,"Groß Grönau",3603,1755,1848,0.487094088259784,3550,1733,1817,0.488169014084507,0.0180150197514072,0.248694091941715,0.733290888306877
1,"Schleswig-Holstein",1053042,"Groß Pampau",151,77,74,0.509933774834437,139,69,70,0.496402877697842,0.0180150197514072,0.248694091941715,0.733290888306877
1,"Schleswig-Holstein",1053043,"Groß Sarau",880,434,446,0.493181818181818,927,453,474,0.488673139158576,0.0180150197514072,0.248694091941715,0.733290888306877
1,"Schleswig-Holstein",1053044,"Groß Schenkenberg",542,258,284,0.476014760147601,541,267,274,0.493530499075786,0.0180150197514072,0.248694091941715,0.733290888306877
1,"Schleswig-Holstein",1053045,"Grove",242,124,118,0.512396694214876,238,126,112,0.529411764705882,0.0180150197514072,0.248694091941715,0.733290888306877
1,"Schleswig-Holstein",1053046,"Gudow",1670,827,843,0.495209580838323,1621,806,815,0.497223935842073,0.0180150197514072,0.248694091941715,0.733290888306877
1,"Schleswig-Holstein",1053047,"Gülzow",1231,629,602,0.510966693744923,1236,639,597,0.516990291262136,0.0180150197514072,0.248694091941715,0.733290888306877
1,"Schleswig-Holstein",1053048,"Güster",1267,625,642,0.493291239147593,1284,639,645,0.497663551401869,0.0180150197514072,0.248694091941715,0.733290888306877
1,"Schleswig-Holstein",1053049,"Hamfelde",479,230,249,0.480167014613779,455,192,263,0.421978021978022,0.0180150197514072,0.248694091941715,0.733290888306877
1,"Schleswig-Holstein",1053050,"Hamwarde",756,388,368,0.513227513227513,762,394,368,0.517060367454068,0.0180150197514072,0.248694091941715,0.733290888306877
1,"Schleswig-Holstein",1053051,"Harmsdorf",290,145,145,0.5,291,142,149,0.487972508591065,0.0180150197514072,0.248694091941715,0.733290888306877
1,"Schleswig-Holstein",1053052,"Havekost",156,72,84,0.461538461538462,155,73,82,0.470967741935484,0.0180150197514072,0.248694091941715,0.733290888306877
1,"Schleswig-Holstein",1053053,"Hohenhorn",510,255,255,0.5,509,263,246,0.516699410609037,0.0180150197514072,0.248694091941715,0.733290888306877
1,"Schleswig-Holstein",1053054,"Hollenbek",443,231,212,0.521444695259594,441,226,215,0.512471655328798,0.0180150197514072,0.248694091941715,0.733290888306877
1,"Schleswig-Holstein",1053056,"Hornbek",199,100,99,0.50251256281407,180,90,90,0.5,0.0180150197514072,0.248694091941715,0.733290888306877
1,"Schleswig-Holstein",1053057,"Horst",235,119,116,0.506382978723404,224,122,102,0.544642857142857,0.0180150197514072,0.248694091941715,0.733290888306877
1,"Schleswig-Holstein",1053058,"Juliusburg",176,83,93,0.471590909090909,192,86,106,0.447916666666667,0.0180150197514072,0.248694091941715,0.733290888306877
1,"Schleswig-Holstein",1053059,"Kankelau",218,110,108,0.504587155963303,219,113,106,0.515981735159817,0.0180150197514072,0.248694091941715,0.733290888306877
1,"Schleswig-Holstein",1053060,"Kasseburg",569,279,290,0.490333919156415,567,279,288,0.492063492063492,0.0180150197514072,0.248694091941715,0.733290888306877
1,"Schleswig-Holstein",1053061,"Kastorf",1179,590,589,0.500424088210348,1196,600,596,0.501672240802676,0.0180150197514072,0.248694091941715,0.733290888306877
1,"Schleswig-Holstein",1053062,"Kittlitz",243,131,112,0.539094650205761,261,142,119,0.544061302681992,0.0180150197514072,0.248694091941715,0.733290888306877
1,"Schleswig-Holstein",1053064,"Klein Pampau",612,306,306,0.5,625,310,315,0.496,0.0180150197514072,0.248694091941715,0.733290888306877
1,"Schleswig-Holstein",1053066,"Klein Zecher",240,117,123,0.4875,235,112,123,0.476595744680851,0.0180150197514072,0.248694091941715,0.733290888306877
1,"Schleswig-Holstein",1053067,"Klempau",610,313,297,0.513114754098361,600,304,296,0.506666666666667,0.0180150197514072,0.248694091941715,0.733290888306877
1,"Schleswig-Holstein",1053068,"Klinkrade",602,288,314,0.478405315614618,575,285,290,0.495652173913044,0.0180150197514072,0.248694091941715,0.733290888306877
1,"Schleswig-Holstein",1053069,"Koberg",764,384,380,0.50261780104712,752,381,371,0.506648936170213,0.0180150197514072,0.248694091941715,0.733290888306877
1,"Schleswig-Holstein",1053070,"Köthel",269,133,136,0.494423791821561,289,155,134,0.536332179930796,0.0180150197514072,0.248694091941715,0.733290888306877
1,"Schleswig-Holstein",1053071,"Kollow",604,290,314,0.480132450331126,619,302,317,0.487883683360259,0.0180150197514072,0.248694091941715,0.733290888306877
1,"Schleswig-Holstein",1053072,"Kröppelshagen-Fahrendorf",1164,588,576,0.505154639175258,1159,579,580,0.499568593615186,0.0180150197514072,0.248694091941715,0.733290888306877
1,"Schleswig-Holstein",1053073,"Krüzen",358,183,175,0.511173184357542,347,176,171,0.507204610951009,0.0180150197514072,0.248694091941715,0.733290888306877
1,"Schleswig-Holstein",1053074,"Krukow",161,85,76,0.527950310559006,172,95,77,0.552325581395349,0.0180150197514072,0.248694091941715,0.733290888306877
1,"Schleswig-Holstein",1053075,"Krummesse",1751,824,927,0.470588235294118,1502,718,784,0.478029294274301,0.0180150197514072,0.248694091941715,0.733290888306877
1,"Schleswig-Holstein",1053076,"Kuddewörde",1344,649,695,0.482886904761905,1349,651,698,0.482579688658265,0.0180150197514072,0.248694091941715,0.733290888306877
1,"Schleswig-Holstein",1053077,"Kühsen",376,180,196,0.478723404255319,382,180,202,0.471204188481675,0.0180150197514072,0.248694091941715,0.733290888306877
1,"Schleswig-Holstein",1053078,"Kulpin",217,102,115,0.470046082949309,234,113,121,0.482905982905983,0.0180150197514072,0.248694091941715,0.733290888306877
1,"Schleswig-Holstein",1053079,"Labenz",848,430,418,0.507075471698113,818,413,405,0.504889975550122,0.0180150197514072,0.248694091941715,0.733290888306877
1,"Schleswig-Holstein",1053080,"Langenlehsten",169,86,83,0.50887573964497,163,82,81,0.503067484662577,0.0180150197514072,0.248694091941715,0.733290888306877
1,"Schleswig-Holstein",1053081,"Lankau",491,251,240,0.511201629327902,493,260,233,0.527383367139959,0.0180150197514072,0.248694091941715,0.733290888306877
1,"Schleswig-Holstein",1053082,"Lanze",279,138,141,0.494623655913978,396,205,191,0.517676767676768,0.0180150197514072,0.248694091941715,0.733290888306877
1,"Schleswig-Holstein",1053083,"Lauenburg/ Elbe, Stadt",11150,5509,5641,0.494080717488789,11234,5598,5636,0.498308705714794,0.0180150197514072,0.248694091941715,0.733290888306877
1,"Schleswig-Holstein",1053084,"Lehmrade",483,230,253,0.476190476190476,485,234,251,0.482474226804124,0.0180150197514072,0.248694091941715,0.733290888306877
1,"Schleswig-Holstein",1053085,"Linau",1199,609,590,0.507923269391159,1214,624,590,0.514003294892916,0.0180150197514072,0.248694091941715,0.733290888306877
1,"Schleswig-Holstein",1053086,"Lüchow",285,140,145,0.491228070175439,196,97,99,0.494897959183673,0.0180150197514072,0.248694091941715,0.733290888306877
1,"Schleswig-Holstein",1053087,"Lütau",714,354,360,0.495798319327731,704,359,345,0.509943181818182,0.0180150197514072,0.248694091941715,0.733290888306877
1,"Schleswig-Holstein",1053088,"Mechow",110,55,55,0.5,111,57,54,0.513513513513513,0.0180150197514072,0.248694091941715,0.733290888306877
1,"Schleswig-Holstein",1053089,"Möhnsen",543,273,270,0.502762430939227,556,274,282,0.492805755395683,0.0180150197514072,0.248694091941715,0.733290888306877
1,"Schleswig-Holstein",1053090,"Mölln, Stadt",18409,8649,9760,0.469824542343419,18460,8829,9631,0.478277356446371,0.0180150197514072,0.248694091941715,0.733290888306877
1,"Schleswig-Holstein",1053091,"Mühlenrade",177,93,84,0.525423728813559,194,107,87,0.551546391752577,0.0180150197514072,0.248694091941715,0.733290888306877
1,"Schleswig-Holstein",1053092,"Müssen",996,495,501,0.496987951807229,953,481,472,0.504721930745016,0.0180150197514072,0.248694091941715,0.733290888306877
1,"Schleswig-Holstein",1053093,"Mustin",757,362,395,0.478203434610304,725,360,365,0.496551724137931,0.0180150197514072,0.248694091941715,0.733290888306877
1,"Schleswig-Holstein",1053094,"Niendorf bei Berkenthin",195,94,101,0.482051282051282,198,96,102,0.484848484848485,0.0180150197514072,0.248694091941715,0.733290888306877
1,"Schleswig-Holstein",1053095,"Niendorf/ Stecknitz",647,323,324,0.499227202472952,608,302,306,0.496710526315789,0.0180150197514072,0.248694091941715,0.733290888306877
1,"Schleswig-Holstein",1053096,"Nusse",1084,529,555,0.488007380073801,1026,513,513,0.5,0.0180150197514072,0.248694091941715,0.733290888306877
1,"Schleswig-Holstein",1053097,"Panten",637,320,317,0.502354788069074,706,366,340,0.518413597733711,0.0180150197514072,0.248694091941715,0.733290888306877
1,"Schleswig-Holstein",1053098,"Pogeez",381,199,182,0.522309711286089,377,199,178,0.527851458885942,0.0180150197514072,0.248694091941715,0.733290888306877
1,"Schleswig-Holstein",1053099,"Poggensee",341,158,183,0.463343108504399,347,162,185,0.46685878962536,0.0180150197514072,0.248694091941715,0.733290888306877
1,"Schleswig-Holstein",1053100,"Ratzeburg, Stadt",13613,6355,7258,0.466833174171748,13662,6406,7256,0.468891816717904,0.0180150197514072,0.248694091941715,0.733290888306877
1,"Schleswig-Holstein",1053101,"Ritzerau",274,136,138,0.496350364963504,285,138,147,0.484210526315789,0.0180150197514072,0.248694091941715,0.733290888306877
1,"Schleswig-Holstein",1053102,"Römnitz",54,26,28,0.481481481481481,61,26,35,0.426229508196721,0.0180150197514072,0.248694091941715,0.733290888306877
1,"Schleswig-Holstein",1053103,"Rondeshagen",832,408,424,0.490384615384615,857,432,425,0.504084014002334,0.0180150197514072,0.248694091941715,0.733290888306877
1,"Schleswig-Holstein",1053104,"Roseburg",504,253,251,0.501984126984127,498,251,247,0.504016064257028,0.0180150197514072,0.248694091941715,0.733290888306877
1,"Schleswig-Holstein",1053106,"Sahms",372,183,189,0.491935483870968,377,185,192,0.490716180371353,0.0180150197514072,0.248694091941715,0.733290888306877
1,"Schleswig-Holstein",1053107,"Salem",598,297,301,0.496655518394649,581,287,294,0.493975903614458,0.0180150197514072,0.248694091941715,0.733290888306877
1,"Schleswig-Holstein",1053108,"Sandesneben",1699,849,850,0.49970570924073,1691,858,833,0.507392075694855,0.0180150197514072,0.248694091941715,0.733290888306877
1,"Schleswig-Holstein",1053109,"Schiphorst",608,299,309,0.491776315789474,596,294,302,0.493288590604027,0.0180150197514072,0.248694091941715,0.733290888306877
1,"Schleswig-Holstein",1053110,"Schmilau",544,270,274,0.496323529411765,567,277,290,0.488536155202822,0.0180150197514072,0.248694091941715,0.733290888306877
1,"Schleswig-Holstein",1053111,"Schnakenbek",833,394,439,0.472989195678271,855,416,439,0.486549707602339,0.0180150197514072,0.248694091941715,0.733290888306877
1,"Schleswig-Holstein",1053112,"Schönberg",1382,694,688,0.502170767004341,1333,683,650,0.512378094523631,0.0180150197514072,0.248694091941715,0.733290888306877
1,"Schleswig-Holstein",1053113,"Schretstaken",485,242,243,0.498969072164948,500,251,249,0.502,0.0180150197514072,0.248694091941715,0.733290888306877
1,"Schleswig-Holstein",1053114,"Schürensöhlen",150,74,76,0.493333333333333,147,77,70,0.523809523809524,0.0180150197514072,0.248694091941715,0.733290888306877
1,"Schleswig-Holstein",1053115,"Schulendorf",459,240,219,0.522875816993464,478,249,229,0.52092050209205,0.0180150197514072,0.248694091941715,0.733290888306877
1,"Schleswig-Holstein",1053116,"Schwarzenbek, Stadt",14978,7322,7656,0.488850313793564,15173,7393,7780,0.487247083635405,0.0180150197514072,0.248694091941715,0.733290888306877
1,"Schleswig-Holstein",1053117,"Seedorf",542,271,271,0.5,525,272,253,0.518095238095238,0.0180150197514072,0.248694091941715,0.733290888306877
1,"Schleswig-Holstein",1053118,"Siebenbäumen",645,332,313,0.514728682170543,646,317,329,0.490712074303406,0.0180150197514072,0.248694091941715,0.733290888306877
1,"Schleswig-Holstein",1053119,"Siebeneichen",266,133,133,0.5,258,130,128,0.503875968992248,0.0180150197514072,0.248694091941715,0.733290888306877
1,"Schleswig-Holstein",1053120,"Sierksrade",352,180,172,0.511363636363636,340,173,167,0.508823529411765,0.0180150197514072,0.248694091941715,0.733290888306877
1,"Schleswig-Holstein",1053121,"Sirksfelde",318,172,146,0.540880503144654,301,155,146,0.514950166112957,0.0180150197514072,0.248694091941715,0.733290888306877
1,"Schleswig-Holstein",1053122,"Steinhorst",567,290,277,0.511463844797178,580,298,282,0.513793103448276,0.0180150197514072,0.248694091941715,0.733290888306877
1,"Schleswig-Holstein",1053123,"Sterley",947,467,480,0.493136219640971,947,462,485,0.487856388595565,0.0180150197514072,0.248694091941715,0.733290888306877
1,"Schleswig-Holstein",1053124,"Stubben",393,183,210,0.465648854961832,384,176,208,0.458333333333333,0.0180150197514072,0.248694091941715,0.733290888306877
1,"Schleswig-Holstein",1053125,"Talkau",517,258,259,0.499032882011605,529,265,264,0.500945179584121,0.0180150197514072,0.248694091941715,0.733290888306877
1,"Schleswig-Holstein",1053126,"Tramm",337,164,173,0.486646884272997,345,171,174,0.495652173913044,0.0180150197514072,0.248694091941715,0.733290888306877
1,"Schleswig-Holstein",1053127,"Walksfelde",181,93,88,0.513812154696133,177,94,83,0.531073446327684,0.0180150197514072,0.248694091941715,0.733290888306877
1,"Schleswig-Holstein",1053128,"Wangelau",231,113,118,0.489177489177489,214,106,108,0.495327102803738,0.0180150197514072,0.248694091941715,0.733290888306877
1,"Schleswig-Holstein",1053129,"Wentorf bei Hamburg",11833,5661,6172,0.478407842474436,11688,5537,6151,0.473733744010951,0.0180150197514072,0.248694091941715,0.733290888306877
1,"Schleswig-Holstein",1053130,"Wentorf (Amt Sandesneben)",688,344,344,0.5,667,329,338,0.493253373313343,0.0180150197514072,0.248694091941715,0.733290888306877
1,"Schleswig-Holstein",1053131,"Wiershop",164,81,83,0.49390243902439,162,77,85,0.475308641975309,0.0180150197514072,0.248694091941715,0.733290888306877
1,"Schleswig-Holstein",1053132,"Witzeeze",895,406,489,0.453631284916201,907,428,479,0.471885336273429,0.0180150197514072,0.248694091941715,0.733290888306877
1,"Schleswig-Holstein",1053133,"Wohltorf",2420,1179,1241,0.487190082644628,2334,1117,1217,0.478577549271637,0.0180150197514072,0.248694091941715,0.733290888306877
1,"Schleswig-Holstein",1053134,"Woltersdorf",293,150,143,0.511945392491468,268,135,133,0.503731343283582,0.0180150197514072,0.248694091941715,0.733290888306877
1,"Schleswig-Holstein",1053135,"Worth",166,81,85,0.487951807228916,159,75,84,0.471698113207547,0.0180150197514072,0.248694091941715,0.733290888306877
1,"Schleswig-Holstein",1053136,"Ziethen",997,483,514,0.484453360080241,1009,496,513,0.491575817641229,0.0180150197514072,0.248694091941715,0.733290888306877
1,"Schleswig-Holstein",1054001,"Achtrup",1513,786,727,0.519497686715136,1520,797,723,0.524342105263158,0.0180150197514072,0.248694091941715,0.733290888306877
1,"Schleswig-Holstein",1054002,"Ahrenshöft",505,250,255,0.495049504950495,512,256,256,0.5,0.0180150197514072,0.248694091941715,0.733290888306877
1,"Schleswig-Holstein",1054003,"Ahrenviöl",518,270,248,0.521235521235521,498,249,249,0.5,0.0180150197514072,0.248694091941715,0.733290888306877
1,"Schleswig-Holstein",1054004,"Ahrenviölfeld",250,117,133,0.468,271,135,136,0.498154981549816,0.0180150197514072,0.248694091941715,0.733290888306877
1,"Schleswig-Holstein",1054005,"Alkersum",428,202,226,0.47196261682243,423,191,232,0.451536643026005,0.0180150197514072,0.248694091941715,0.733290888306877
1,"Schleswig-Holstein",1054006,"Almdorf",555,297,258,0.535135135135135,537,281,256,0.523277467411546,0.0180150197514072,0.248694091941715,0.733290888306877
1,"Schleswig-Holstein",1054007,"Arlewatt",331,182,149,0.549848942598187,336,188,148,0.55952380952381,0.0180150197514072,0.248694091941715,0.733290888306877
1,"Schleswig-Holstein",1054009,"Aventoft",466,223,243,0.478540772532189,456,219,237,0.480263157894737,0.0180150197514072,0.248694091941715,0.733290888306877
1,"Schleswig-Holstein",1054010,"Bargum",608,306,302,0.503289473684211,605,305,300,0.504132231404959,0.0180150197514072,0.248694091941715,0.733290888306877
1,"Schleswig-Holstein",1054011,"Behrendorf",561,297,264,0.529411764705882,574,301,273,0.524390243902439,0.0180150197514072,0.248694091941715,0.733290888306877
1,"Schleswig-Holstein",1054012,"Bohmstedt",733,357,376,0.487039563437926,721,347,374,0.48127600554785,0.0180150197514072,0.248694091941715,0.733290888306877
1,"Schleswig-Holstein",1054013,"Bondelum",206,109,97,0.529126213592233,209,112,97,0.535885167464115,0.0180150197514072,0.248694091941715,0.733290888306877
1,"Schleswig-Holstein",1054014,"Bordelum",2023,1037,986,0.512605042016807,2002,1014,988,0.506493506493506,0.0180150197514072,0.248694091941715,0.733290888306877
1,"Schleswig-Holstein",1054015,"Borgsum",341,169,172,0.495601173020528,349,178,171,0.510028653295129,0.0180150197514072,0.248694091941715,0.733290888306877
1,"Schleswig-Holstein",1054016,"Bosbüll",215,106,109,0.493023255813954,220,105,115,0.477272727272727,0.0180150197514072,0.248694091941715,0.733290888306877
1,"Schleswig-Holstein",1054017,"Braderup",661,333,328,0.503782148260212,657,335,322,0.509893455098935,0.0180150197514072,0.248694091941715,0.733290888306877
1,"Schleswig-Holstein",1054018,"Bramstedtlund",192,97,95,0.505208333333333,200,99,101,0.495,0.0180150197514072,0.248694091941715,0.733290888306877
1,"Schleswig-Holstein",1054019,"Bredstedt, Stadt",5065,2432,2633,0.480157946692991,4921,2334,2587,0.474293842714895,0.0180150197514072,0.248694091941715,0.733290888306877
1,"Schleswig-Holstein",1054020,"Breklum",2359,1160,1199,0.491733785502331,2342,1144,1198,0.488471391972673,0.0180150197514072,0.248694091941715,0.733290888306877
1,"Schleswig-Holstein",1054022,"Dagebüll",917,447,470,0.487459105779716,896,435,461,0.485491071428571,0.0180150197514072,0.248694091941715,0.733290888306877
1,"Schleswig-Holstein",1054023,"Drage",622,275,347,0.442122186495177,581,247,334,0.42512908777969,0.0180150197514072,0.248694091941715,0.733290888306877
1,"Schleswig-Holstein",1054024,"Drelsdorf",1253,644,609,0.513966480446927,1270,643,627,0.506299212598425,0.0180150197514072,0.248694091941715,0.733290888306877
1,"Schleswig-Holstein",1054025,"Dunsum",67,31,36,0.462686567164179,66,32,34,0.484848484848485,0.0180150197514072,0.248694091941715,0.733290888306877
1,"Schleswig-Holstein",1054026,"Elisabeth-Sophien-Koog",40,22,18,0.55,49,28,21,0.571428571428571,0.0180150197514072,0.248694091941715,0.733290888306877
1,"Schleswig-Holstein",1054027,"Ellhöft",111,62,49,0.558558558558559,104,62,42,0.596153846153846,0.0180150197514072,0.248694091941715,0.733290888306877
1,"Schleswig-Holstein",1054032,"Fresendelf",97,59,38,0.608247422680412,96,59,37,0.614583333333333,0.0180150197514072,0.248694091941715,0.733290888306877
1,"Schleswig-Holstein",1054033,"Friedrichstadt, Stadt",2558,1218,1340,0.476153244722439,2368,1109,1259,0.468327702702703,0.0180150197514072,0.248694091941715,0.733290888306877
1,"Schleswig-Holstein",1054034,"Friedrich-Wilhelm-Lübke-Koog",185,95,90,0.513513513513513,176,92,84,0.522727272727273,0.0180150197514072,0.248694091941715,0.733290888306877
1,"Schleswig-Holstein",1054035,"Garding, Kirchspiel",397,191,206,0.481108312342569,358,165,193,0.460893854748603,0.0180150197514072,0.248694091941715,0.733290888306877
1,"Schleswig-Holstein",1054036,"Garding, Stadt",2472,1152,1320,0.466019417475728,2603,1206,1397,0.463311563580484,0.0180150197514072,0.248694091941715,0.733290888306877
1,"Schleswig-Holstein",1054037,"Goldebek",351,173,178,0.492877492877493,354,175,179,0.494350282485876,0.0180150197514072,0.248694091941715,0.733290888306877
1,"Schleswig-Holstein",1054038,"Goldelund",403,200,203,0.496277915632754,381,189,192,0.496062992125984,0.0180150197514072,0.248694091941715,0.733290888306877
1,"Schleswig-Holstein",1054039,"Gröde",11,6,5,0.545454545454545,5,4,1,0.8,0.0180150197514072,0.248694091941715,0.733290888306877
1,"Schleswig-Holstein",1054040,"Grothusenkoog",23,9,14,0.391304347826087,22,10,12,0.454545454545455,0.0180150197514072,0.248694091941715,0.733290888306877
1,"Schleswig-Holstein",1054041,"Haselund",905,467,438,0.516022099447514,906,471,435,0.519867549668874,0.0180150197514072,0.248694091941715,0.733290888306877
1,"Schleswig-Holstein",1054042,"Hattstedt",2565,1254,1311,0.488888888888889,2515,1200,1315,0.47713717693837,0.0180150197514072,0.248694091941715,0.733290888306877
1,"Schleswig-Holstein",1054043,"Hattstedtermarsch",304,164,140,0.539473684210526,335,181,154,0.540298507462687,0.0180150197514072,0.248694091941715,0.733290888306877
1,"Schleswig-Holstein",1054045,"Högel",461,223,238,0.483731019522777,440,213,227,0.484090909090909,0.0180150197514072,0.248694091941715,0.733290888306877
1,"Schleswig-Holstein",1054046,"Hörnum (Sylt)",882,445,437,0.50453514739229,1015,503,512,0.495566502463054,0.0180150197514072,0.248694091941715,0.733290888306877
1,"Schleswig-Holstein",1054048,"Holm",78,37,41,0.474358974358974,70,35,35,0.5,0.0180150197514072,0.248694091941715,0.733290888306877
1,"Schleswig-Holstein",1054050,"Hallig Hooge",106,51,55,0.481132075471698,84,39,45,0.464285714285714,0.0180150197514072,0.248694091941715,0.733290888306877
1,"Schleswig-Holstein",1054052,"Horstedt",721,368,353,0.510402219140083,743,387,356,0.520861372812921,0.0180150197514072,0.248694091941715,0.733290888306877
1,"Schleswig-Holstein",1054054,"Hude",194,104,90,0.536082474226804,175,98,77,0.56,0.0180150197514072,0.248694091941715,0.733290888306877
1,"Schleswig-Holstein",1054055,"Humptrup",717,362,355,0.504881450488145,732,364,368,0.497267759562842,0.0180150197514072,0.248694091941715,0.733290888306877
1,"Schleswig-Holstein",1054056,"Husum, Stadt",22135,10450,11685,0.472103004291845,22076,10518,11558,0.476445008153651,0.0180150197514072,0.248694091941715,0.733290888306877
1,"Schleswig-Holstein",1054057,"Immenstedt",681,354,327,0.519823788546256,694,360,334,0.518731988472622,0.0180150197514072,0.248694091941715,0.733290888306877
1,"Schleswig-Holstein",1054059,"Joldelund",761,385,376,0.505913272010513,736,375,361,0.509510869565217,0.0180150197514072,0.248694091941715,0.733290888306877
1,"Schleswig-Holstein",1054061,"Kampen (Sylt)",515,251,264,0.487378640776699,609,317,292,0.520525451559934,0.0180150197514072,0.248694091941715,0.733290888306877
1,"Schleswig-Holstein",1054062,"Karlum",219,106,113,0.484018264840183,217,99,118,0.456221198156682,0.0180150197514072,0.248694091941715,0.733290888306877
1,"Schleswig-Holstein",1054063,"Katharinenheerd",176,84,92,0.477272727272727,163,76,87,0.466257668711656,0.0180150197514072,0.248694091941715,0.733290888306877
1,"Schleswig-Holstein",1054065,"Klanxbüll",953,460,493,0.482686253934942,921,457,464,0.496199782844734,0.0180150197514072,0.248694091941715,0.733290888306877
1,"Schleswig-Holstein",1054068,"Klixbüll",949,493,456,0.519494204425711,953,486,467,0.5099685204617,0.0180150197514072,0.248694091941715,0.733290888306877
1,"Schleswig-Holstein",1054070,"Koldenbüttel",917,458,459,0.499454743729553,913,459,454,0.502738225629792,0.0180150197514072,0.248694091941715,0.733290888306877
1,"Schleswig-Holstein",1054071,"Kolkerheide",55,27,28,0.490909090909091,59,29,30,0.491525423728814,0.0180150197514072,0.248694091941715,0.733290888306877
1,"Schleswig-Holstein",1054072,"Kotzenbüll",227,117,110,0.515418502202643,224,117,107,0.522321428571429,0.0180150197514072,0.248694091941715,0.733290888306877
1,"Schleswig-Holstein",1054073,"Ladelund",1387,686,701,0.494592645998558,1345,655,690,0.486988847583643,0.0180150197514072,0.248694091941715,0.733290888306877
1,"Schleswig-Holstein",1054074,"Langeneß",134,68,66,0.507462686567164,118,55,63,0.466101694915254,0.0180150197514072,0.248694091941715,0.733290888306877
1,"Schleswig-Holstein",1054075,"Langenhorn",3113,1542,1571,0.495342113716672,3109,1529,1580,0.491798005789643,0.0180150197514072,0.248694091941715,0.733290888306877
1,"Schleswig-Holstein",1054076,"Leck",7716,3746,3970,0.485484707102125,7647,3726,3921,0.487249901922322,0.0180150197514072,0.248694091941715,0.733290888306877
1,"Schleswig-Holstein",1054077,"Lexgaard",54,33,21,0.611111111111111,58,36,22,0.620689655172414,0.0180150197514072,0.248694091941715,0.733290888306877
1,"Schleswig-Holstein",1054078,"List",1560,773,787,0.495512820512821,2599,1772,827,0.681800692574067,0.0180150197514072,0.248694091941715,0.733290888306877
1,"Schleswig-Holstein",1054079,"Löwenstedt",657,337,320,0.512937595129376,678,338,340,0.498525073746313,0.0180150197514072,0.248694091941715,0.733290888306877
1,"Schleswig-Holstein",1054080,"Lütjenholm",321,168,153,0.523364485981308,320,166,154,0.51875,0.0180150197514072,0.248694091941715,0.733290888306877
1,"Schleswig-Holstein",1054083,"Midlum",401,168,233,0.418952618453865,358,158,200,0.441340782122905,0.0180150197514072,0.248694091941715,0.733290888306877
1,"Schleswig-Holstein",1054084,"Mildstedt",3804,1797,2007,0.472397476340694,3811,1796,2015,0.471267383888743,0.0180150197514072,0.248694091941715,0.733290888306877
1,"Schleswig-Holstein",1054085,"Nebel",960,435,525,0.453125,922,431,491,0.467462039045553,0.0180150197514072,0.248694091941715,0.733290888306877
1,"Schleswig-Holstein",1054086,"Neukirchen",1243,626,617,0.503620273531778,1263,649,614,0.513855898653998,0.0180150197514072,0.248694091941715,0.733290888306877
1,"Schleswig-Holstein",1054087,"Nieblum",606,282,324,0.465346534653465,607,282,325,0.464579901153213,0.0180150197514072,0.248694091941715,0.733290888306877
1,"Schleswig-Holstein",1054088,"Niebüll, Stadt",9574,4570,5004,0.477334447461876,9372,4468,4904,0.476739223218096,0.0180150197514072,0.248694091941715,0.733290888306877
1,"Schleswig-Holstein",1054089,"Norddorf auf Amrum",572,263,309,0.45979020979021,592,252,340,0.425675675675676,0.0180150197514072,0.248694091941715,0.733290888306877
1,"Schleswig-Holstein",1054090,"Norderfriedrichskoog",49,28,21,0.571428571428571,40,23,17,0.575,0.0180150197514072,0.248694091941715,0.733290888306877
1,"Schleswig-Holstein",1054091,"Nordstrand",2254,1071,1183,0.475155279503106,2196,1071,1125,0.487704918032787,0.0180150197514072,0.248694091941715,0.733290888306877
1,"Schleswig-Holstein",1054092,"Norstedt",432,220,212,0.509259259259259,445,224,221,0.503370786516854,0.0180150197514072,0.248694091941715,0.733290888306877
1,"Schleswig-Holstein",1054093,"Ockholm",341,179,162,0.524926686217009,357,190,167,0.532212885154062,0.0180150197514072,0.248694091941715,0.733290888306877
1,"Schleswig-Holstein",1054094,"Oevenum",458,212,246,0.462882096069869,469,220,249,0.46908315565032,0.0180150197514072,0.248694091941715,0.733290888306877
1,"Schleswig-Holstein",1054095,"Oldenswort",1269,646,623,0.509062253743105,1248,629,619,0.50400641025641,0.0180150197514072,0.248694091941715,0.733290888306877
1,"Schleswig-Holstein",1054096,"Oldersbek",662,352,310,0.531722054380665,668,348,320,0.520958083832335,0.0180150197514072,0.248694091941715,0.733290888306877
1,"Schleswig-Holstein",1054097,"Olderup",437,222,215,0.508009153318078,438,233,205,0.531963470319635,0.0180150197514072,0.248694091941715,0.733290888306877
1,"Schleswig-Holstein",1054098,"Oldsum",562,258,304,0.459074733096085,571,255,316,0.446584938704028,0.0180150197514072,0.248694091941715,0.733290888306877
1,"Schleswig-Holstein",1054099,"Ostenfeld (Husum)",1530,749,781,0.489542483660131,1551,777,774,0.500967117988395,0.0180150197514072,0.248694091941715,0.733290888306877
1,"Schleswig-Holstein",1054100,"Osterhever",249,119,130,0.477911646586345,241,115,126,0.477178423236515,0.0180150197514072,0.248694091941715,0.733290888306877
1,"Schleswig-Holstein",1054101,"Oster-Ohrstedt",624,322,302,0.516025641025641,630,328,302,0.520634920634921,0.0180150197514072,0.248694091941715,0.733290888306877
1,"Schleswig-Holstein",1054103,"Pellworm",1179,552,627,0.468193384223919,1041,466,575,0.447646493756004,0.0180150197514072,0.248694091941715,0.733290888306877
1,"Schleswig-Holstein",1054104,"Poppenbüll",238,121,117,0.508403361344538,197,96,101,0.487309644670051,0.0180150197514072,0.248694091941715,0.733290888306877
1,"Schleswig-Holstein",1054105,"Ramstedt",435,210,225,0.482758620689655,433,208,225,0.480369515011547,0.0180150197514072,0.248694091941715,0.733290888306877
1,"Schleswig-Holstein",1054106,"Rantrum",1653,832,821,0.503327283726558,1645,835,810,0.507598784194529,0.0180150197514072,0.248694091941715,0.733290888306877
1,"Schleswig-Holstein",1054108,"Reußenköge",356,189,167,0.530898876404494,338,177,161,0.523668639053254,0.0180150197514072,0.248694091941715,0.733290888306877
1,"Schleswig-Holstein",1054109,"Risum-Lindholm",3642,1818,1824,0.499176276771005,3667,1819,1848,0.496045814016908,0.0180150197514072,0.248694091941715,0.733290888306877
1,"Schleswig-Holstein",1054110,"Rodenäs",443,231,212,0.521444695259594,427,222,205,0.519906323185012,0.0180150197514072,0.248694091941715,0.733290888306877
1,"Schleswig-Holstein",1054113,"Sankt Peter-Ording",3799,1777,2022,0.46775467228218,4069,1926,2143,0.473334971737528,0.0180150197514072,0.248694091941715,0.733290888306877
1,"Schleswig-Holstein",1054116,"Schwabstedt",1320,647,673,0.490151515151515,1332,655,677,0.491741741741742,0.0180150197514072,0.248694091941715,0.733290888306877
1,"Schleswig-Holstein",1054118,"Schwesing",919,464,455,0.504896626768226,928,462,466,0.497844827586207,0.0180150197514072,0.248694091941715,0.733290888306877
1,"Schleswig-Holstein",1054119,"Seeth",580,289,291,0.498275862068966,678,412,266,0.607669616519174,0.0180150197514072,0.248694091941715,0.733290888306877
1,"Schleswig-Holstein",1054120,"Simonsberg",785,390,395,0.496815286624204,794,403,391,0.507556675062972,0.0180150197514072,0.248694091941715,0.733290888306877
1,"Schleswig-Holstein",1054121,"Sönnebüll",270,132,138,0.488888888888889,270,135,135,0.5,0.0180150197514072,0.248694091941715,0.733290888306877
1,"Schleswig-Holstein",1054123,"Sollwitt",287,143,144,0.498257839721254,283,136,147,0.480565371024735,0.0180150197514072,0.248694091941715,0.733290888306877
1,"Schleswig-Holstein",1054124,"Sprakebüll",232,123,109,0.530172413793103,236,122,114,0.516949152542373,0.0180150197514072,0.248694091941715,0.733290888306877
1,"Schleswig-Holstein",1054125,"Stadum",987,526,461,0.532928064842959,1000,519,481,0.519,0.0180150197514072,0.248694091941715,0.733290888306877
1,"Schleswig-Holstein",1054126,"Stedesand",848,428,420,0.504716981132076,848,434,414,0.511792452830189,0.0180150197514072,0.248694091941715,0.733290888306877
1,"Schleswig-Holstein",1054128,"Struckum",990,485,505,0.48989898989899,971,478,493,0.492276004119464,0.0180150197514072,0.248694091941715,0.733290888306877
1,"Schleswig-Holstein",1054129,"Süderende",198,92,106,0.464646464646465,193,94,99,0.487046632124352,0.0180150197514072,0.248694091941715,0.733290888306877
1,"Schleswig-Holstein",1054130,"Süderhöft",19,10,9,0.526315789473684,21,9,12,0.428571428571429,0.0180150197514072,0.248694091941715,0.733290888306877
1,"Schleswig-Holstein",1054131,"Süderlügum",2289,1121,1168,0.489733508082132,2249,1115,1134,0.495775900400178,0.0180150197514072,0.248694091941715,0.733290888306877
1,"Schleswig-Holstein",1054132,"Südermarsch",169,91,78,0.538461538461538,158,89,69,0.563291139240506,0.0180150197514072,0.248694091941715,0.733290888306877
1,"Schleswig-Holstein",1054134,"Tating",929,456,473,0.490850376749193,946,467,479,0.493657505285412,0.0180150197514072,0.248694091941715,0.733290888306877
1,"Schleswig-Holstein",1054135,"Tetenbüll",650,307,343,0.472307692307692,607,287,320,0.472817133443163,0.0180150197514072,0.248694091941715,0.733290888306877
1,"Schleswig-Holstein",1054136,"Tinningstedt",242,117,125,0.483471074380165,223,103,120,0.461883408071749,0.0180150197514072,0.248694091941715,0.733290888306877
1,"Schleswig-Holstein",1054138,"Tönning, Stadt",4900,2385,2515,0.486734693877551,4866,2385,2481,0.490135635018496,0.0180150197514072,0.248694091941715,0.733290888306877
1,"Schleswig-Holstein",1054140,"Tümlauer Koog",113,61,52,0.539823008849557,98,59,39,0.602040816326531,0.0180150197514072,0.248694091941715,0.733290888306877
1,"Schleswig-Holstein",1054141,"Uelvesbüll",281,138,143,0.491103202846975,254,127,127,0.5,0.0180150197514072,0.248694091941715,0.733290888306877
1,"Schleswig-Holstein",1054142,"Uphusum",374,185,189,0.494652406417112,383,192,191,0.501305483028721,0.0180150197514072,0.248694091941715,0.733290888306877
1,"Schleswig-Holstein",1054143,"Utersum",414,187,227,0.451690821256039,413,187,226,0.452784503631961,0.0180150197514072,0.248694091941715,0.733290888306877
1,"Schleswig-Holstein",1054144,"Viöl",2059,1026,1033,0.498300145701797,2025,1005,1020,0.496296296296296,0.0180150197514072,0.248694091941715,0.733290888306877
1,"Schleswig-Holstein",1054145,"Vollerwiek",195,101,94,0.517948717948718,204,109,95,0.534313725490196,0.0180150197514072,0.248694091941715,0.733290888306877
1,"Schleswig-Holstein",1054146,"Vollstedt",179,89,90,0.497206703910615,172,90,82,0.523255813953488,0.0180150197514072,0.248694091941715,0.733290888306877
1,"Schleswig-Holstein",1054148,"Welt",222,105,117,0.472972972972973,215,103,112,0.47906976744186,0.0180150197514072,0.248694091941715,0.733290888306877
1,"Schleswig-Holstein",1054149,"Wenningstedt-Braderup (Sylt)",1402,630,772,0.449358059914408,1463,650,813,0.444292549555707,0.0180150197514072,0.248694091941715,0.733290888306877
1,"Schleswig-Holstein",1054150,"Westerhever",125,60,65,0.48,124,64,60,0.516129032258065,0.0180150197514072,0.248694091941715,0.733290888306877
1,"Schleswig-Holstein",1054152,"Wester-Ohrstedt",1057,528,529,0.499526963103122,1076,527,549,0.489776951672862,0.0180150197514072,0.248694091941715,0.733290888306877
1,"Schleswig-Holstein",1054154,"Westre",390,184,206,0.471794871794872,405,192,213,0.474074074074074,0.0180150197514072,0.248694091941715,0.733290888306877
1,"Schleswig-Holstein",1054156,"Winnert",731,358,373,0.489740082079343,752,369,383,0.490691489361702,0.0180150197514072,0.248694091941715,0.733290888306877
1,"Schleswig-Holstein",1054157,"Wisch",113,57,56,0.504424778761062,122,59,63,0.483606557377049,0.0180150197514072,0.248694091941715,0.733290888306877
1,"Schleswig-Holstein",1054158,"Witsum",46,22,24,0.478260869565217,44,18,26,0.409090909090909,0.0180150197514072,0.248694091941715,0.733290888306877
1,"Schleswig-Holstein",1054159,"Wittbek",808,408,400,0.504950495049505,807,412,395,0.510532837670384,0.0180150197514072,0.248694091941715,0.733290888306877
1,"Schleswig-Holstein",1054160,"Wittdün auf Amrum",750,345,405,0.46,741,333,408,0.449392712550607,0.0180150197514072,0.248694091941715,0.733290888306877
1,"Schleswig-Holstein",1054161,"Witzwort",1031,513,518,0.497575169738118,994,493,501,0.495975855130785,0.0180150197514072,0.248694091941715,0.733290888306877
1,"Schleswig-Holstein",1054162,"Wobbenbüll",462,239,223,0.517316017316017,470,245,225,0.521276595744681,0.0180150197514072,0.248694091941715,0.733290888306877
1,"Schleswig-Holstein",1054163,"Wrixum",661,328,333,0.496217851739788,687,338,349,0.491994177583697,0.0180150197514072,0.248694091941715,0.733290888306877
1,"Schleswig-Holstein",1054164,"Wyk auf Föhr, Stadt",4304,1973,2331,0.458410780669145,4413,2015,2398,0.45660548379787,0.0180150197514072,0.248694091941715,0.733290888306877
1,"Schleswig-Holstein",1054165,"Galmsbüll",647,330,317,0.510046367851623,671,331,340,0.493293591654247,0.0180150197514072,0.248694091941715,0.733290888306877
1,"Schleswig-Holstein",1054166,"Emmelsbüll-Horsbüll",959,490,469,0.510948905109489,936,461,475,0.492521367521368,0.0180150197514072,0.248694091941715,0.733290888306877
1,"Schleswig-Holstein",1054167,"Enge-Sande",1117,560,557,0.501342882721576,1129,561,568,0.496899911426041,0.0180150197514072,0.248694091941715,0.733290888306877
1,"Schleswig-Holstein",1054168,"Sylt",13703,6485,7218,0.473254031963804,15125,7279,7846,0.481256198347107,0.0180150197514072,0.248694091941715,0.733290888306877
1,"Schleswig-Holstein",1055001,"Ahrensbök",8345,4125,4220,0.494307968843619,8360,4098,4262,0.490191387559809,0.0180150197514072,0.248694091941715,0.733290888306877
1,"Schleswig-Holstein",1055002,"Altenkrempe",1045,518,527,0.495693779904306,1132,562,570,0.496466431095406,0.0180150197514072,0.248694091941715,0.733290888306877
1,"Schleswig-Holstein",1055004,"Bad Schwartau, Stadt",19434,9077,10357,0.467068025110631,19698,9228,10470,0.468473956746878,0.0180150197514072,0.248694091941715,0.733290888306877
1,"Schleswig-Holstein",1055006,"Beschendorf",521,245,276,0.470249520153551,546,251,295,0.45970695970696,0.0180150197514072,0.248694091941715,0.733290888306877
1,"Schleswig-Holstein",1055007,"Bosau",3461,1749,1712,0.505345275931812,3412,1728,1684,0.506447831184056,0.0180150197514072,0.248694091941715,0.733290888306877
1,"Schleswig-Holstein",1055010,"Dahme",1228,579,649,0.471498371335505,1227,582,645,0.474327628361858,0.0180150197514072,0.248694091941715,0.733290888306877
1,"Schleswig-Holstein",1055011,"Damlos",672,325,347,0.483630952380952,687,332,355,0.483260553129549,0.0180150197514072,0.248694091941715,0.733290888306877
1,"Schleswig-Holstein",1055012,"Eutin, Stadt",16379,7648,8731,0.466939373588131,16933,8067,8866,0.476407015886139,0.0180150197514072,0.248694091941715,0.733290888306877
1,"Schleswig-Holstein",1055014,"Göhl",1160,576,584,0.496551724137931,1154,575,579,0.498266897746967,0.0180150197514072,0.248694091941715,0.733290888306877
1,"Schleswig-Holstein",1055015,"Gremersdorf",1459,756,703,0.518163125428376,1463,749,714,0.511961722488038,0.0180150197514072,0.248694091941715,0.733290888306877
1,"Schleswig-Holstein",1055016,"Grömitz",6906,3287,3619,0.475962930784825,7620,3621,3999,0.475196850393701,0.0180150197514072,0.248694091941715,0.733290888306877
1,"Schleswig-Holstein",1055017,"Großenbrode",2053,963,1090,0.469069654164637,2070,978,1092,0.472463768115942,0.0180150197514072,0.248694091941715,0.733290888306877
1,"Schleswig-Holstein",1055018,"Grube",997,478,519,0.479438314944835,961,457,504,0.475546305931322,0.0180150197514072,0.248694091941715,0.733290888306877
1,"Schleswig-Holstein",1055020,"Harmsdorf",679,338,341,0.49779086892489,694,343,351,0.494236311239193,0.0180150197514072,0.248694091941715,0.733290888306877
1,"Schleswig-Holstein",1055021,"Heiligenhafen, Stadt",9062,4356,4706,0.480688589715295,9188,4492,4696,0.488898563343492,0.0180150197514072,0.248694091941715,0.733290888306877
1,"Schleswig-Holstein",1055022,"Heringsdorf",1121,562,559,0.501338090990187,1058,546,512,0.516068052930057,0.0180150197514072,0.248694091941715,0.733290888306877
1,"Schleswig-Holstein",1055023,"Kabelhorst",442,197,245,0.445701357466063,436,177,259,0.405963302752294,0.0180150197514072,0.248694091941715,0.733290888306877
1,"Schleswig-Holstein",1055024,"Kasseedorf",1464,737,727,0.503415300546448,1528,791,737,0.517670157068063,0.0180150197514072,0.248694091941715,0.733290888306877
1,"Schleswig-Holstein",1055025,"Kellenhusen (Ostsee)",1039,477,562,0.459095283926853,1053,477,576,0.452991452991453,0.0180150197514072,0.248694091941715,0.733290888306877
1,"Schleswig-Holstein",1055027,"Lensahn",5087,2404,2683,0.472577157460193,4862,2282,2580,0.469354175236528,0.0180150197514072,0.248694091941715,0.733290888306877
1,"Schleswig-Holstein",1055028,"Malente",10489,5013,5476,0.477929259223949,10812,5136,5676,0.475027746947836,0.0180150197514072,0.248694091941715,0.733290888306877
1,"Schleswig-Holstein",1055029,"Manhagen",386,195,191,0.505181347150259,391,195,196,0.498721227621483,0.0180150197514072,0.248694091941715,0.733290888306877
1,"Schleswig-Holstein",1055031,"Neukirchen",1205,609,596,0.505394190871369,1170,593,577,0.506837606837607,0.0180150197514072,0.248694091941715,0.733290888306877
1,"Schleswig-Holstein",1055032,"Neustadt in Holstein, Stadt",15034,7109,7925,0.472861513901823,16288,8286,8002,0.508718074656189,0.0180150197514072,0.248694091941715,0.733290888306877
1,"Schleswig-Holstein",1055033,"Oldenburg in Holstein, Stadt",9699,4732,4967,0.487885349005052,9615,4629,4986,0.481435257410296,0.0180150197514072,0.248694091941715,0.733290888306877
1,"Schleswig-Holstein",1055035,"Ratekau",15183,7340,7843,0.483435421194757,15508,7553,7955,0.487038947639928,0.0180150197514072,0.248694091941715,0.733290888306877
1,"Schleswig-Holstein",1055036,"Riepsdorf",985,502,483,0.509644670050761,1007,513,494,0.509433962264151,0.0180150197514072,0.248694091941715,0.733290888306877
1,"Schleswig-Holstein",1055037,"Schashagen",2169,1101,1068,0.507607192254495,2495,1260,1235,0.50501002004008,0.0180150197514072,0.248694091941715,0.733290888306877
1,"Schleswig-Holstein",1055038,"Schönwalde am Bungsberg",2628,1277,1351,0.485920852359209,2503,1212,1291,0.48421893727527,0.0180150197514072,0.248694091941715,0.733290888306877
1,"Schleswig-Holstein",1055039,"Sierksdorf",1529,751,778,0.491170699803793,1583,772,811,0.487681617182565,0.0180150197514072,0.248694091941715,0.733290888306877
1,"Schleswig-Holstein",1055040,"Stockelsdorf",16544,8025,8519,0.485070116054159,17120,8358,8762,0.488200934579439,0.0180150197514072,0.248694091941715,0.733290888306877
1,"Schleswig-Holstein",1055041,"Süsel",5332,2642,2690,0.49549887471868,5409,2689,2720,0.497134405620263,0.0180150197514072,0.248694091941715,0.733290888306877
1,"Schleswig-Holstein",1055042,"Timmendorfer Strand",8819,4113,4706,0.466379408096156,9019,4210,4809,0.466792327309014,0.0180150197514072,0.248694091941715,0.733290888306877
1,"Schleswig-Holstein",1055043,"Wangels",2204,1127,1077,0.511343012704174,2191,1115,1076,0.50890004564126,0.0180150197514072,0.248694091941715,0.733290888306877
1,"Schleswig-Holstein",1055044,"Scharbeutz",10758,5183,5575,0.481781000185908,11704,5636,6068,0.481544771018455,0.0180150197514072,0.248694091941715,0.733290888306877
1,"Schleswig-Holstein",1055046,"Fehmarn, Stadt",12442,6046,6396,0.485934737180518,12911,6254,6657,0.484393153125242,0.0180150197514072,0.248694091941715,0.733290888306877
1,"Schleswig-Holstein",1056001,"Appen",4837,2382,2455,0.492454000413479,5838,3341,2497,0.572285029119561,0.0180150197514072,0.248694091941715,0.733290888306877
1,"Schleswig-Holstein",1056002,"Barmstedt, Stadt",9836,4800,5036,0.488003253355022,9844,4824,5020,0.490044697277529,0.0180150197514072,0.248694091941715,0.733290888306877
1,"Schleswig-Holstein",1056003,"Bevern",607,300,307,0.494233937397035,583,282,301,0.483704974271012,0.0180150197514072,0.248694091941715,0.733290888306877
1,"Schleswig-Holstein",1056004,"Bilsen",754,375,379,0.497347480106101,722,349,373,0.483379501385042,0.0180150197514072,0.248694091941715,0.733290888306877
1,"Schleswig-Holstein",1056005,"Bönningstedt",4436,2169,2267,0.488954012623986,4392,2156,2236,0.490892531876138,0.0180150197514072,0.248694091941715,0.733290888306877
1,"Schleswig-Holstein",1056006,"Bokel",630,322,308,0.511111111111111,642,327,315,0.509345794392523,0.0180150197514072,0.248694091941715,0.733290888306877
1,"Schleswig-Holstein",1056008,"Bokholt-Hanredder",1221,631,590,0.516789516789517,1267,663,604,0.523283346487766,0.0180150197514072,0.248694091941715,0.733290888306877
1,"Schleswig-Holstein",1056009,"Borstel-Hohenraden",2264,1123,1141,0.496024734982332,2308,1151,1157,0.498700173310225,0.0180150197514072,0.248694091941715,0.733290888306877
1,"Schleswig-Holstein",1056010,"Brande-Hörnerkirchen",1597,788,809,0.493425172197871,1577,769,808,0.487634749524413,0.0180150197514072,0.248694091941715,0.733290888306877
1,"Schleswig-Holstein",1056011,"Bullenkuhlen",370,191,179,0.516216216216216,362,192,170,0.530386740331492,0.0180150197514072,0.248694091941715,0.733290888306877
1,"Schleswig-Holstein",1056013,"Ellerbek",4162,2071,2091,0.497597308986064,4277,2136,2141,0.499415478138882,0.0180150197514072,0.248694091941715,0.733290888306877
1,"Schleswig-Holstein",1056014,"Ellerhoop",1446,717,729,0.495850622406639,1446,722,724,0.499308437067773,0.0180150197514072,0.248694091941715,0.733290888306877
1,"Schleswig-Holstein",1056015,"Elmshorn, Stadt",47436,22848,24588,0.481659499114596,48993,23919,25074,0.488212601800257,0.0180150197514072,0.248694091941715,0.733290888306877
1,"Schleswig-Holstein",1056016,"Groß Nordende",714,348,366,0.487394957983193,725,350,375,0.482758620689655,0.0180150197514072,0.248694091941715,0.733290888306877
1,"Schleswig-Holstein",1056017,"Groß Offenseth-Aspern",405,237,168,0.585185185185185,450,278,172,0.617777777777778,0.0180150197514072,0.248694091941715,0.733290888306877
1,"Schleswig-Holstein",1056018,"Halstenbek",16482,7964,8518,0.483193787161752,16789,8170,8619,0.486628149383525,0.0180150197514072,0.248694091941715,0.733290888306877
1,"Schleswig-Holstein",1056019,"Haselau",1056,519,537,0.491477272727273,1104,556,548,0.503623188405797,0.0180150197514072,0.248694091941715,0.733290888306877
1,"Schleswig-Holstein",1056020,"Haseldorf",1712,845,867,0.49357476635514,1684,825,859,0.489904988123515,0.0180150197514072,0.248694091941715,0.733290888306877
1,"Schleswig-Holstein",1056021,"Hasloh",3330,1623,1707,0.487387387387387,3416,1698,1718,0.497072599531616,0.0180150197514072,0.248694091941715,0.733290888306877
1,"Schleswig-Holstein",1056022,"Heede",694,352,342,0.507204610951009,706,357,349,0.505665722379603,0.0180150197514072,0.248694091941715,0.733290888306877
1,"Schleswig-Holstein",1056023,"Heidgraben",2492,1266,1226,0.508025682182986,2480,1249,1231,0.503629032258065,0.0180150197514072,0.248694091941715,0.733290888306877
1,"Schleswig-Holstein",1056024,"Heist",2808,1424,1384,0.507122507122507,2828,1435,1393,0.507425742574257,0.0180150197514072,0.248694091941715,0.733290888306877
1,"Schleswig-Holstein",1056025,"Helgoland",1372,670,702,0.488338192419825,1131,544,587,0.480990274093722,0.0180150197514072,0.248694091941715,0.733290888306877
1,"Schleswig-Holstein",1056026,"Hemdingen",1651,809,842,0.490006056935191,1653,813,840,0.491833030852995,0.0180150197514072,0.248694091941715,0.733290888306877
1,"Schleswig-Holstein",1056027,"Hetlingen",1311,650,661,0.49580472921434,1326,652,674,0.491704374057315,0.0180150197514072,0.248694091941715,0.733290888306877
1,"Schleswig-Holstein",1056028,"Holm",3080,1520,1560,0.493506493506494,3095,1537,1558,0.496607431340872,0.0180150197514072,0.248694091941715,0.733290888306877
1,"Schleswig-Holstein",1056029,"Klein Nordende",3036,1510,1526,0.497364953886693,3049,1512,1537,0.495900295178747,0.0180150197514072,0.248694091941715,0.733290888306877
1,"Schleswig-Holstein",1056030,"Klein Offenseth-Sparrieshoop",2868,1431,1437,0.498953974895398,2940,1486,1454,0.505442176870748,0.0180150197514072,0.248694091941715,0.733290888306877
1,"Schleswig-Holstein",1056031,"Kölln-Reisiek",2847,1377,1470,0.483667017913593,2857,1410,1447,0.493524676233812,0.0180150197514072,0.248694091941715,0.733290888306877
1,"Schleswig-Holstein",1056032,"Kummerfeld",2101,1044,1057,0.49690623512613,2097,1046,1051,0.498807820696233,0.0180150197514072,0.248694091941715,0.733290888306877
1,"Schleswig-Holstein",1056033,"Seester",905,448,457,0.495027624309392,957,466,491,0.486938349007315,0.0180150197514072,0.248694091941715,0.733290888306877
1,"Schleswig-Holstein",1056034,"Langeln",532,280,252,0.526315789473684,533,284,249,0.532833020637899,0.0180150197514072,0.248694091941715,0.733290888306877
1,"Schleswig-Holstein",1056035,"Lutzhorn",816,414,402,0.507352941176471,812,417,395,0.513546798029557,0.0180150197514072,0.248694091941715,0.733290888306877
1,"Schleswig-Holstein",1056036,"Moorrege",4082,2022,2060,0.495345418912298,4094,2037,2057,0.497557401074743,0.0180150197514072,0.248694091941715,0.733290888306877
1,"Schleswig-Holstein",1056037,"Neuendeich",529,252,277,0.476370510396975,526,243,283,0.461977186311787,0.0180150197514072,0.248694091941715,0.733290888306877
1,"Schleswig-Holstein",1056038,"Osterhorn",393,197,196,0.501272264631043,416,214,202,0.514423076923077,0.0180150197514072,0.248694091941715,0.733290888306877
1,"Schleswig-Holstein",1056039,"Pinneberg, Stadt",41270,19819,21451,0.480227768354737,42851,20831,22020,0.486126344776085,0.0180150197514072,0.248694091941715,0.733290888306877
1,"Schleswig-Holstein",1056040,"Prisdorf",2154,1064,1090,0.493964716805942,2234,1094,1140,0.489704565801253,0.0180150197514072,0.248694091941715,0.733290888306877
1,"Schleswig-Holstein",1056041,"Quickborn, Stadt",19843,9635,10208,0.485561659023333,20677,10072,10605,0.487111283068143,0.0180150197514072,0.248694091941715,0.733290888306877
1,"Schleswig-Holstein",1056042,"Raa-Besenbek",536,260,276,0.485074626865672,555,269,286,0.484684684684685,0.0180150197514072,0.248694091941715,0.733290888306877
1,"Schleswig-Holstein",1056043,"Rellingen",13484,6541,6943,0.485093444081875,13782,6705,7077,0.486504135829343,0.0180150197514072,0.248694091941715,0.733290888306877
1,"Schleswig-Holstein",1056044,"Schenefeld, Stadt",18332,8903,9429,0.485653502072878,18707,9124,9583,0.487731865077244,0.0180150197514072,0.248694091941715,0.733290888306877
1,"Schleswig-Holstein",1056045,"Seestermühe",959,478,481,0.498435870698644,891,445,446,0.499438832772166,0.0180150197514072,0.248694091941715,0.733290888306877
1,"Schleswig-Holstein",1056046,"Seeth-Ekholt",835,420,415,0.502994011976048,844,427,417,0.505924170616114,0.0180150197514072,0.248694091941715,0.733290888306877
1,"Schleswig-Holstein",1056047,"Tangstedt",2195,1099,1096,0.500683371298405,2235,1120,1115,0.501118568232662,0.0180150197514072,0.248694091941715,0.733290888306877
1,"Schleswig-Holstein",1056048,"Tornesch, Stadt",12609,6193,6416,0.491157110000793,12930,6399,6531,0.494895591647332,0.0180150197514072,0.248694091941715,0.733290888306877
1,"Schleswig-Holstein",1056049,"Uetersen, Stadt",17571,8526,9045,0.485231347106027,17829,8707,9122,0.488361657972965,0.0180150197514072,0.248694091941715,0.733290888306877
1,"Schleswig-Holstein",1056050,"Wedel, Stadt",31403,15053,16350,0.479349106773238,32360,15760,16600,0.487021013597033,0.0180150197514072,0.248694091941715,0.733290888306877
1,"Schleswig-Holstein",1056051,"Westerhorn",1304,638,666,0.489263803680982,1288,622,666,0.482919254658385,0.0180150197514072,0.248694091941715,0.733290888306877
1,"Schleswig-Holstein",1057001,"Ascheberg (Holstein)",3107,1489,1618,0.479240424847119,3163,1513,1650,0.478343344925703,0.0180150197514072,0.248694091941715,0.733290888306877
1,"Schleswig-Holstein",1057002,"Barmissen",160,77,83,0.48125,174,79,95,0.454022988505747,0.0180150197514072,0.248694091941715,0.733290888306877
1,"Schleswig-Holstein",1057003,"Barsbek",549,285,264,0.519125683060109,600,315,285,0.525,0.0180150197514072,0.248694091941715,0.733290888306877
1,"Schleswig-Holstein",1057004,"Behrensdorf (Ostsee)",605,307,298,0.507438016528926,614,303,311,0.493485342019544,0.0180150197514072,0.248694091941715,0.733290888306877
1,"Schleswig-Holstein",1057005,"Belau",367,187,180,0.509536784741144,352,173,179,0.491477272727273,0.0180150197514072,0.248694091941715,0.733290888306877
1,"Schleswig-Holstein",1057006,"Bendfeld",213,95,118,0.446009389671362,222,101,121,0.454954954954955,0.0180150197514072,0.248694091941715,0.733290888306877
1,"Schleswig-Holstein",1057007,"Blekendorf",1766,868,898,0.491506228765572,1746,860,886,0.492554410080183,0.0180150197514072,0.248694091941715,0.733290888306877
1,"Schleswig-Holstein",1057008,"Bönebüttel",2022,971,1051,0.480217606330366,2058,990,1068,0.481049562682216,0.0180150197514072,0.248694091941715,0.733290888306877
1,"Schleswig-Holstein",1057009,"Bösdorf",1329,646,683,0.486079759217457,1454,737,717,0.50687757909216,0.0180150197514072,0.248694091941715,0.733290888306877
1,"Schleswig-Holstein",1057010,"Boksee",448,225,223,0.502232142857143,467,235,232,0.50321199143469,0.0180150197514072,0.248694091941715,0.733290888306877
1,"Schleswig-Holstein",1057011,"Bothkamp",267,134,133,0.50187265917603,288,138,150,0.479166666666667,0.0180150197514072,0.248694091941715,0.733290888306877
1,"Schleswig-Holstein",1057012,"Brodersdorf",420,205,215,0.488095238095238,419,200,219,0.477326968973747,0.0180150197514072,0.248694091941715,0.733290888306877
1,"Schleswig-Holstein",1057013,"Dannau",651,322,329,0.494623655913978,650,317,333,0.487692307692308,0.0180150197514072,0.248694091941715,0.733290888306877
1,"Schleswig-Holstein",1057015,"Dersau",861,418,443,0.48548199767712,902,441,461,0.488913525498891,0.0180150197514072,0.248694091941715,0.733290888306877
1,"Schleswig-Holstein",1057016,"Dobersdorf",1094,534,560,0.488117001828154,1133,560,573,0.494263018534863,0.0180150197514072,0.248694091941715,0.733290888306877
1,"Schleswig-Holstein",1057017,"Dörnick",266,122,144,0.458646616541353,271,125,146,0.461254612546125,0.0180150197514072,0.248694091941715,0.733290888306877
1,"Schleswig-Holstein",1057018,"Fahren",139,71,68,0.510791366906475,144,73,71,0.506944444444444,0.0180150197514072,0.248694091941715,0.733290888306877
1,"Schleswig-Holstein",1057020,"Fiefbergen",567,289,278,0.509700176366843,571,293,278,0.513134851138354,0.0180150197514072,0.248694091941715,0.733290888306877
1,"Schleswig-Holstein",1057021,"Giekau",1078,540,538,0.500927643784787,1093,542,551,0.495882891125343,0.0180150197514072,0.248694091941715,0.733290888306877
1,"Schleswig-Holstein",1057022,"Grebin",927,456,471,0.491909385113269,945,464,481,0.491005291005291,0.0180150197514072,0.248694091941715,0.733290888306877
1,"Schleswig-Holstein",1057023,"Großbarkau",175,83,92,0.474285714285714,179,90,89,0.502793296089385,0.0180150197514072,0.248694091941715,0.733290888306877
1,"Schleswig-Holstein",1057024,"Großharrie",537,270,267,0.502793296089385,545,280,265,0.513761467889908,0.0180150197514072,0.248694091941715,0.733290888306877
1,"Schleswig-Holstein",1057025,"Heikendorf",8208,3805,4403,0.463572124756335,8234,3842,4392,0.466601894583435,0.0180150197514072,0.248694091941715,0.733290888306877
1,"Schleswig-Holstein",1057026,"Helmstorf",329,166,163,0.504559270516717,331,169,162,0.510574018126888,0.0180150197514072,0.248694091941715,0.733290888306877
1,"Schleswig-Holstein",1057027,"Högsdorf",420,210,210,0.5,418,212,206,0.507177033492823,0.0180150197514072,0.248694091941715,0.733290888306877
1,"Schleswig-Holstein",1057028,"Höhndorf",404,197,207,0.487623762376238,399,195,204,0.488721804511278,0.0180150197514072,0.248694091941715,0.733290888306877
1,"Schleswig-Holstein",1057029,"Hohenfelde",1040,543,497,0.522115384615385,1073,580,493,0.540540540540541,0.0180150197514072,0.248694091941715,0.733290888306877
1,"Schleswig-Holstein",1057030,"Hohwacht (Ostsee)",859,419,440,0.487776484284051,871,428,443,0.491389207807118,0.0180150197514072,0.248694091941715,0.733290888306877
1,"Schleswig-Holstein",1057031,"Honigsee",446,215,231,0.482062780269058,460,218,242,0.473913043478261,0.0180150197514072,0.248694091941715,0.733290888306877
1,"Schleswig-Holstein",1057032,"Kalübbe",571,288,283,0.504378283712785,559,286,273,0.511627906976744,0.0180150197514072,0.248694091941715,0.733290888306877
1,"Schleswig-Holstein",1057033,"Kirchbarkau",734,349,385,0.475476839237057,722,338,384,0.46814404432133,0.0180150197514072,0.248694091941715,0.733290888306877
1,"Schleswig-Holstein",1057034,"Kirchnüchel",171,93,78,0.543859649122807,170,95,75,0.558823529411765,0.0180150197514072,0.248694091941715,0.733290888306877
1,"Schleswig-Holstein",1057035,"Klamp",726,365,361,0.502754820936639,747,378,369,0.506024096385542,0.0180150197514072,0.248694091941715,0.733290888306877
1,"Schleswig-Holstein",1057037,"Klein Barkau",261,127,134,0.486590038314176,246,117,129,0.475609756097561,0.0180150197514072,0.248694091941715,0.733290888306877
1,"Schleswig-Holstein",1057038,"Kletkamp",111,57,54,0.513513513513513,125,61,64,0.488,0.0180150197514072,0.248694091941715,0.733290888306877
1,"Schleswig-Holstein",1057039,"Köhn",823,416,407,0.50546780072904,835,426,409,0.510179640718563,0.0180150197514072,0.248694091941715,0.733290888306877
1,"Schleswig-Holstein",1057040,"Krokau",449,221,228,0.492204899777283,477,234,243,0.490566037735849,0.0180150197514072,0.248694091941715,0.733290888306877
1,"Schleswig-Holstein",1057041,"Krummbek",413,217,196,0.525423728813559,403,214,189,0.531017369727047,0.0180150197514072,0.248694091941715,0.733290888306877
1,"Schleswig-Holstein",1057042,"Kühren",660,337,323,0.510606060606061,681,346,335,0.508076358296623,0.0180150197514072,0.248694091941715,0.733290888306877
1,"Schleswig-Holstein",1057043,"Laboe",4914,2347,2567,0.477614977614978,5192,2539,2653,0.48902157164869,0.0180150197514072,0.248694091941715,0.733290888306877
1,"Schleswig-Holstein",1057044,"Lammershagen",256,127,129,0.49609375,270,141,129,0.522222222222222,0.0180150197514072,0.248694091941715,0.733290888306877
1,"Schleswig-Holstein",1057045,"Lebrade",600,301,299,0.501666666666667,579,286,293,0.493955094991364,0.0180150197514072,0.248694091941715,0.733290888306877
1,"Schleswig-Holstein",1057046,"Lehmkuhlen",1372,696,676,0.507288629737609,1459,744,715,0.50993831391364,0.0180150197514072,0.248694091941715,0.733290888306877
1,"Schleswig-Holstein",1057047,"Löptin",311,150,161,0.482315112540193,314,152,162,0.484076433121019,0.0180150197514072,0.248694091941715,0.733290888306877
1,"Schleswig-Holstein",1057048,"Lütjenburg, Stadt",5422,2603,2819,0.480081150866839,5326,2569,2757,0.482350732256853,0.0180150197514072,0.248694091941715,0.733290888306877
1,"Schleswig-Holstein",1057049,"Lutterbek",374,191,183,0.510695187165775,364,190,174,0.521978021978022,0.0180150197514072,0.248694091941715,0.733290888306877
1,"Schleswig-Holstein",1057050,"Martensrade",968,488,480,0.504132231404959,963,483,480,0.501557632398754,0.0180150197514072,0.248694091941715,0.733290888306877
1,"Schleswig-Holstein",1057051,"Mönkeberg",3790,1799,1991,0.47467018469657,3791,1789,2002,0.471907148509628,0.0180150197514072,0.248694091941715,0.733290888306877
1,"Schleswig-Holstein",1057052,"Mucheln",572,292,280,0.510489510489511,566,287,279,0.507067137809187,0.0180150197514072,0.248694091941715,0.733290888306877
1,"Schleswig-Holstein",1057053,"Nehmten",301,156,145,0.518272425249169,275,138,137,0.501818181818182,0.0180150197514072,0.248694091941715,0.733290888306877
1,"Schleswig-Holstein",1057054,"Nettelsee",429,203,226,0.473193473193473,421,203,218,0.482185273159145,0.0180150197514072,0.248694091941715,0.733290888306877
1,"Schleswig-Holstein",1057055,"Panker",1439,707,732,0.49131341209173,1520,743,777,0.488815789473684,0.0180150197514072,0.248694091941715,0.733290888306877
1,"Schleswig-Holstein",1057056,"Passade",345,168,177,0.48695652173913,347,172,175,0.495677233429395,0.0180150197514072,0.248694091941715,0.733290888306877
1,"Schleswig-Holstein",1057057,"Plön, Stadt",8655,4100,4555,0.473714615829001,12795,8351,4444,0.652676826885502,0.0180150197514072,0.248694091941715,0.733290888306877
1,"Schleswig-Holstein",1057058,"Pohnsdorf",461,228,233,0.494577006507592,471,234,237,0.496815286624204,0.0180150197514072,0.248694091941715,0.733290888306877
1,"Schleswig-Holstein",1057059,"Postfeld",458,232,226,0.506550218340611,457,225,232,0.492341356673961,0.0180150197514072,0.248694091941715,0.733290888306877
1,"Schleswig-Holstein",1057060,"Prasdorf",447,225,222,0.503355704697987,465,234,231,0.503225806451613,0.0180150197514072,0.248694091941715,0.733290888306877
1,"Schleswig-Holstein",1057062,"Preetz, Stadt",15445,7327,8118,0.474393007445775,15782,7492,8290,0.474718033202382,0.0180150197514072,0.248694091941715,0.733290888306877
1,"Schleswig-Holstein",1057063,"Probsteierhagen",2105,1057,1048,0.502137767220903,2132,1060,1072,0.49718574108818,0.0180150197514072,0.248694091941715,0.733290888306877
1,"Schleswig-Holstein",1057065,"Rantzau",337,174,163,0.516320474777448,316,162,154,0.512658227848101,0.0180150197514072,0.248694091941715,0.733290888306877
1,"Schleswig-Holstein",1057066,"Rastorf",847,418,429,0.493506493506494,862,427,435,0.495359628770302,0.0180150197514072,0.248694091941715,0.733290888306877
1,"Schleswig-Holstein",1057067,"Rathjensdorf",506,256,250,0.505928853754941,526,265,261,0.503802281368821,0.0180150197514072,0.248694091941715,0.733290888306877
1,"Schleswig-Holstein",1057068,"Rendswühren",798,390,408,0.488721804511278,789,385,404,0.487959442332066,0.0180150197514072,0.248694091941715,0.733290888306877
1,"Schleswig-Holstein",1057069,"Ruhwinkel",956,475,481,0.496861924686192,1022,511,511,0.5,0.0180150197514072,0.248694091941715,0.733290888306877
1,"Schleswig-Holstein",1057070,"Schellhorn",1530,727,803,0.47516339869281,1604,760,844,0.473815461346633,0.0180150197514072,0.248694091941715,0.733290888306877
1,"Schleswig-Holstein",1057071,"Schillsdorf",882,428,454,0.485260770975057,891,445,446,0.499438832772166,0.0180150197514072,0.248694091941715,0.733290888306877
1,"Schleswig-Holstein",1057072,"Schlesen",505,240,265,0.475247524752475,518,235,283,0.453667953667954,0.0180150197514072,0.248694091941715,0.733290888306877
1,"Schleswig-Holstein",1057073,"Schönberg (Holstein)",6052,2858,3194,0.472240581625909,6677,3246,3431,0.486146472966901,0.0180150197514072,0.248694091941715,0.733290888306877
1,"Schleswig-Holstein",1057074,"Schönkirchen",6243,3038,3205,0.486625020022425,6229,3018,3211,0.484507946700915,0.0180150197514072,0.248694091941715,0.733290888306877
1,"Schleswig-Holstein",1057076,"Schwartbuck",808,393,415,0.486386138613861,811,394,417,0.485819975339088,0.0180150197514072,0.248694091941715,0.733290888306877
1,"Schleswig-Holstein",1057077,"Selent",1344,659,685,0.490327380952381,1327,648,679,0.488319517709118,0.0180150197514072,0.248694091941715,0.733290888306877
1,"Schleswig-Holstein",1057078,"Stakendorf",460,224,236,0.48695652173913,451,218,233,0.483370288248337,0.0180150197514072,0.248694091941715,0.733290888306877
1,"Schleswig-Holstein",1057079,"Stein",816,396,420,0.485294117647059,816,398,418,0.487745098039216,0.0180150197514072,0.248694091941715,0.733290888306877
1,"Schleswig-Holstein",1057080,"Stolpe",1293,634,659,0.490332559938128,1320,657,663,0.497727272727273,0.0180150197514072,0.248694091941715,0.733290888306877
1,"Schleswig-Holstein",1057081,"Stoltenberg",310,149,161,0.480645161290323,310,144,166,0.464516129032258,0.0180150197514072,0.248694091941715,0.733290888306877
1,"Schleswig-Holstein",1057082,"Tröndel",392,192,200,0.489795918367347,411,209,202,0.508515815085158,0.0180150197514072,0.248694091941715,0.733290888306877
1,"Schleswig-Holstein",1057083,"Tasdorf",363,180,183,0.495867768595041,356,176,180,0.49438202247191,0.0180150197514072,0.248694091941715,0.733290888306877
1,"Schleswig-Holstein",1057084,"Wahlstorf",498,248,250,0.497991967871486,500,238,262,0.476,0.0180150197514072,0.248694091941715,0.733290888306877
1,"Schleswig-Holstein",1057085,"Wankendorf",2905,1408,1497,0.484681583476764,2815,1354,1461,0.480994671403197,0.0180150197514072,0.248694091941715,0.733290888306877
1,"Schleswig-Holstein",1057086,"Warnau",364,178,186,0.489010989010989,355,180,175,0.507042253521127,0.0180150197514072,0.248694091941715,0.733290888306877
1,"Schleswig-Holstein",1057087,"Wendtorf",1027,523,504,0.509250243427459,1098,557,541,0.507285974499089,0.0180150197514072,0.248694091941715,0.733290888306877
1,"Schleswig-Holstein",1057088,"Wisch",692,346,346,0.5,738,371,367,0.502710027100271,0.0180150197514072,0.248694091941715,0.733290888306877
1,"Schleswig-Holstein",1057089,"Wittmoldt",173,83,90,0.479768786127168,182,86,96,0.472527472527473,0.0180150197514072,0.248694091941715,0.733290888306877
1,"Schleswig-Holstein",1057090,"Fargau-Pratjau",763,390,373,0.511140235910878,768,394,374,0.513020833333333,0.0180150197514072,0.248694091941715,0.733290888306877
1,"Schleswig-Holstein",1057091,"Schwentinental, Stadt",13511,6479,7032,0.479535193546,13511,6477,7034,0.479387166012878,0.0180150197514072,0.248694091941715,0.733290888306877
1,"Schleswig-Holstein",1058001,"Achterwehr",971,494,477,0.50875386199794,920,455,465,0.494565217391304,0.0180150197514072,0.248694091941715,0.733290888306877
1,"Schleswig-Holstein",1058003,"Alt Duvenstedt",1854,942,912,0.508090614886731,1856,927,929,0.499461206896552,0.0180150197514072,0.248694091941715,0.733290888306877
1,"Schleswig-Holstein",1058004,"Altenhof",301,164,137,0.54485049833887,301,166,135,0.551495016611296,0.0180150197514072,0.248694091941715,0.733290888306877
1,"Schleswig-Holstein",1058005,"Altenholz",9835,4775,5060,0.485510930350788,9950,4816,5134,0.484020100502513,0.0180150197514072,0.248694091941715,0.733290888306877
1,"Schleswig-Holstein",1058007,"Arpsdorf",274,147,127,0.536496350364963,272,150,122,0.551470588235294,0.0180150197514072,0.248694091941715,0.733290888306877
1,"Schleswig-Holstein",1058008,"Ascheffel",1005,512,493,0.509452736318408,970,498,472,0.51340206185567,0.0180150197514072,0.248694091941715,0.733290888306877
1,"Schleswig-Holstein",1058009,"Aukrug",3744,1812,1932,0.483974358974359,3635,1787,1848,0.491609353507565,0.0180150197514072,0.248694091941715,0.733290888306877
1,"Schleswig-Holstein",1058010,"Bargstall",142,72,70,0.507042253521127,147,74,73,0.503401360544218,0.0180150197514072,0.248694091941715,0.733290888306877
1,"Schleswig-Holstein",1058011,"Bargstedt",717,357,360,0.497907949790795,735,365,370,0.496598639455782,0.0180150197514072,0.248694091941715,0.733290888306877
1,"Schleswig-Holstein",1058012,"Barkelsby",1455,724,731,0.497594501718213,1436,700,736,0.487465181058496,0.0180150197514072,0.248694091941715,0.733290888306877
1,"Schleswig-Holstein",1058013,"Beldorf",291,143,148,0.491408934707904,294,145,149,0.493197278911565,0.0180150197514072,0.248694091941715,0.733290888306877
1,"Schleswig-Holstein",1058014,"Bendorf",462,227,235,0.491341991341991,439,217,222,0.494305239179954,0.0180150197514072,0.248694091941715,0.733290888306877
1,"Schleswig-Holstein",1058015,"Beringstedt",720,374,346,0.519444444444444,725,388,337,0.535172413793103,0.0180150197514072,0.248694091941715,0.733290888306877
1,"Schleswig-Holstein",1058016,"Bissee",176,84,92,0.477272727272727,176,85,91,0.482954545454545,0.0180150197514072,0.248694091941715,0.733290888306877
1,"Schleswig-Holstein",1058018,"Blumenthal",700,355,345,0.507142857142857,656,336,320,0.51219512195122,0.0180150197514072,0.248694091941715,0.733290888306877
1,"Schleswig-Holstein",1058019,"Böhnhusen",313,150,163,0.479233226837061,336,166,170,0.494047619047619,0.0180150197514072,0.248694091941715,0.733290888306877
1,"Schleswig-Holstein",1058021,"Bokel",669,338,331,0.505231689088191,670,338,332,0.504477611940298,0.0180150197514072,0.248694091941715,0.733290888306877
1,"Schleswig-Holstein",1058022,"Bordesholm",7494,3637,3857,0.485321590605818,7323,3573,3750,0.487914789020893,0.0180150197514072,0.248694091941715,0.733290888306877
1,"Schleswig-Holstein",1058023,"Borgdorf-Seedorf",397,187,210,0.47103274559194,406,195,211,0.480295566502463,0.0180150197514072,0.248694091941715,0.733290888306877
1,"Schleswig-Holstein",1058024,"Borgstedt",1346,645,701,0.479197622585438,1315,663,652,0.504182509505703,0.0180150197514072,0.248694091941715,0.733290888306877
1,"Schleswig-Holstein",1058025,"Bornholt",173,93,80,0.53757225433526,182,95,87,0.521978021978022,0.0180150197514072,0.248694091941715,0.733290888306877
1,"Schleswig-Holstein",1058026,"Bovenau",1101,545,556,0.495004541326067,1067,539,528,0.505154639175258,0.0180150197514072,0.248694091941715,0.733290888306877
1,"Schleswig-Holstein",1058027,"Brammer",397,195,202,0.491183879093199,399,196,203,0.491228070175439,0.0180150197514072,0.248694091941715,0.733290888306877
1,"Schleswig-Holstein",1058028,"Bredenbek",1390,675,715,0.485611510791367,1375,663,712,0.482181818181818,0.0180150197514072,0.248694091941715,0.733290888306877
1,"Schleswig-Holstein",1058029,"Breiholz",1399,708,691,0.506075768406004,1393,702,691,0.503948312993539,0.0180150197514072,0.248694091941715,0.733290888306877
1,"Schleswig-Holstein",1058030,"Brekendorf",996,518,478,0.520080321285141,996,520,476,0.522088353413655,0.0180150197514072,0.248694091941715,0.733290888306877
1,"Schleswig-Holstein",1058031,"Brinjahe",126,63,63,0.5,124,63,61,0.508064516129032,0.0180150197514072,0.248694091941715,0.733290888306877
1,"Schleswig-Holstein",1058032,"Brodersby",703,355,348,0.5049786628734,748,382,366,0.510695187165775,0.0180150197514072,0.248694091941715,0.733290888306877
1,"Schleswig-Holstein",1058033,"Brügge",1024,527,497,0.5146484375,1028,525,503,0.510700389105058,0.0180150197514072,0.248694091941715,0.733290888306877
1,"Schleswig-Holstein",1058034,"Büdelsdorf, Stadt",10031,4825,5206,0.481008872495265,10120,4894,5226,0.483596837944664,0.0180150197514072,0.248694091941715,0.733290888306877
1,"Schleswig-Holstein",1058035,"Bünsdorf",640,318,322,0.496875,628,319,309,0.50796178343949,0.0180150197514072,0.248694091941715,0.733290888306877
1,"Schleswig-Holstein",1058036,"Christiansholm",229,122,107,0.532751091703057,229,120,109,0.524017467248908,0.0180150197514072,0.248694091941715,0.733290888306877
1,"Schleswig-Holstein",1058037,"Dänischenhagen",3942,1949,1993,0.494419076610857,3620,1794,1826,0.495580110497238,0.0180150197514072,0.248694091941715,0.733290888306877
1,"Schleswig-Holstein",1058038,"Dätgen",536,265,271,0.494402985074627,574,294,280,0.51219512195122,0.0180150197514072,0.248694091941715,0.733290888306877
1,"Schleswig-Holstein",1058039,"Damendorf",417,207,210,0.496402877697842,412,204,208,0.495145631067961,0.0180150197514072,0.248694091941715,0.733290888306877
1,"Schleswig-Holstein",1058040,"Damp",1455,686,769,0.471477663230241,1550,752,798,0.485161290322581,0.0180150197514072,0.248694091941715,0.733290888306877
1,"Schleswig-Holstein",1058042,"Dörphof",705,354,351,0.502127659574468,720,357,363,0.495833333333333,0.0180150197514072,0.248694091941715,0.733290888306877
1,"Schleswig-Holstein",1058043,"Eckernförde, Stadt",21836,10452,11384,0.478659095072358,22442,10980,11462,0.489261206666073,0.0180150197514072,0.248694091941715,0.733290888306877
1,"Schleswig-Holstein",1058044,"Ehndorf",663,342,321,0.515837104072398,661,346,315,0.523449319213313,0.0180150197514072,0.248694091941715,0.733290888306877
1,"Schleswig-Holstein",1058045,"Eisendorf",291,144,147,0.494845360824742,304,155,149,0.509868421052632,0.0180150197514072,0.248694091941715,0.733290888306877
1,"Schleswig-Holstein",1058046,"Ellerdorf",512,263,249,0.513671875,511,265,246,0.518590998043053,0.0180150197514072,0.248694091941715,0.733290888306877
1,"Schleswig-Holstein",1058047,"Elsdorf-Westermühlen",1677,843,834,0.502683363148479,1678,824,854,0.491060786650775,0.0180150197514072,0.248694091941715,0.733290888306877
1,"Schleswig-Holstein",1058048,"Embühren",231,112,119,0.484848484848485,229,105,124,0.458515283842795,0.0180150197514072,0.248694091941715,0.733290888306877
1,"Schleswig-Holstein",1058049,"Emkendorf",1416,741,675,0.523305084745763,1418,733,685,0.516925246826516,0.0180150197514072,0.248694091941715,0.733290888306877
1,"Schleswig-Holstein",1058050,"Felde",2072,1028,1044,0.496138996138996,2130,1110,1020,0.52112676056338,0.0180150197514072,0.248694091941715,0.733290888306877
1,"Schleswig-Holstein",1058051,"Felm",1105,539,566,0.487782805429864,1072,523,549,0.487873134328358,0.0180150197514072,0.248694091941715,0.733290888306877
1,"Schleswig-Holstein",1058052,"Fleckeby",2108,1010,1098,0.479127134724858,1889,891,998,0.471678136580201,0.0180150197514072,0.248694091941715,0.733290888306877
1,"Schleswig-Holstein",1058053,"Flintbek",7372,3571,3801,0.484400434074878,7335,3568,3767,0.486434901158828,0.0180150197514072,0.248694091941715,0.733290888306877
1,"Schleswig-Holstein",1058054,"Fockbek",6300,2993,3307,0.475079365079365,6213,2934,3279,0.472235634958957,0.0180150197514072,0.248694091941715,0.733290888306877
1,"Schleswig-Holstein",1058055,"Friedrichsgraben",61,33,28,0.540983606557377,60,37,23,0.616666666666667,0.0180150197514072,0.248694091941715,0.733290888306877
1,"Schleswig-Holstein",1058056,"Friedrichsholm",425,213,212,0.501176470588235,415,212,203,0.510843373493976,0.0180150197514072,0.248694091941715,0.733290888306877
1,"Schleswig-Holstein",1058057,"Gammelby",544,272,272,0.5,562,282,280,0.501779359430605,0.0180150197514072,0.248694091941715,0.733290888306877
1,"Schleswig-Holstein",1058058,"Gettorf",6994,3453,3541,0.493708893337146,6820,3377,3443,0.495161290322581,0.0180150197514072,0.248694091941715,0.733290888306877
1,"Schleswig-Holstein",1058059,"Gnutz",1197,614,583,0.512949039264829,1166,599,567,0.513722126929674,0.0180150197514072,0.248694091941715,0.733290888306877
1,"Schleswig-Holstein",1058061,"Gokels",600,283,317,0.471666666666667,614,298,316,0.485342019543974,0.0180150197514072,0.248694091941715,0.733290888306877
1,"Schleswig-Holstein",1058062,"Grauel",252,121,131,0.48015873015873,253,121,132,0.478260869565217,0.0180150197514072,0.248694091941715,0.733290888306877
1,"Schleswig-Holstein",1058063,"Grevenkrug",225,118,107,0.524444444444444,240,148,92,0.616666666666667,0.0180150197514072,0.248694091941715,0.733290888306877
1,"Schleswig-Holstein",1058064,"Groß Buchwald",354,179,175,0.505649717514124,352,174,178,0.494318181818182,0.0180150197514072,0.248694091941715,0.733290888306877
1,"Schleswig-Holstein",1058065,"Groß Vollstedt",960,484,476,0.504166666666667,968,489,479,0.505165289256198,0.0180150197514072,0.248694091941715,0.733290888306877
1,"Schleswig-Holstein",1058066,"Groß Wittensee",1150,592,558,0.514782608695652,1117,573,544,0.512981199641898,0.0180150197514072,0.248694091941715,0.733290888306877
1,"Schleswig-Holstein",1058067,"Güby",725,361,364,0.497931034482759,856,450,406,0.525700934579439,0.0180150197514072,0.248694091941715,0.733290888306877
1,"Schleswig-Holstein",1058068,"Haale",533,277,256,0.519699812382739,514,265,249,0.51556420233463,0.0180150197514072,0.248694091941715,0.733290888306877
1,"Schleswig-Holstein",1058069,"Haby",535,275,260,0.514018691588785,562,289,273,0.51423487544484,0.0180150197514072,0.248694091941715,0.733290888306877
1,"Schleswig-Holstein",1058070,"Hamdorf",1253,635,618,0.506783719074222,1257,641,616,0.50994431185362,0.0180150197514072,0.248694091941715,0.733290888306877
1,"Schleswig-Holstein",1058071,"Hamweddel",472,241,231,0.510593220338983,478,243,235,0.50836820083682,0.0180150197514072,0.248694091941715,0.733290888306877
1,"Schleswig-Holstein",1058072,"Hanerau-Hademarschen",3036,1484,1552,0.488801054018445,3000,1467,1533,0.489,0.0180150197514072,0.248694091941715,0.733290888306877
1,"Schleswig-Holstein",1058073,"Haßmoor",274,139,135,0.507299270072993,291,157,134,0.539518900343643,0.0180150197514072,0.248694091941715,0.733290888306877
1,"Schleswig-Holstein",1058074,"Heinkenborstel",137,68,69,0.496350364963504,139,68,71,0.489208633093525,0.0180150197514072,0.248694091941715,0.733290888306877
1,"Schleswig-Holstein",1058075,"Hörsten",54,24,30,0.444444444444444,56,28,28,0.5,0.0180150197514072,0.248694091941715,0.733290888306877
1,"Schleswig-Holstein",1058076,"Hoffeld",149,73,76,0.48993288590604,170,80,90,0.470588235294118,0.0180150197514072,0.248694091941715,0.733290888306877
1,"Schleswig-Holstein",1058077,"Hohenwestedt",5047,2427,2620,0.48087973053299,4952,2359,2593,0.476373182552504,0.0180150197514072,0.248694091941715,0.733290888306877
1,"Schleswig-Holstein",1058078,"Hohn",2440,1232,1208,0.504918032786885,2375,1192,1183,0.501894736842105,0.0180150197514072,0.248694091941715,0.733290888306877
1,"Schleswig-Holstein",1058080,"Holtsee",1261,636,625,0.50436161776368,1334,646,688,0.484257871064468,0.0180150197514072,0.248694091941715,0.733290888306877
1,"Schleswig-Holstein",1058081,"Holzbunge",342,171,171,0.5,335,165,170,0.492537313432836,0.0180150197514072,0.248694091941715,0.733290888306877
1,"Schleswig-Holstein",1058082,"Holzdorf",869,449,420,0.51668584579977,878,453,425,0.515945330296128,0.0180150197514072,0.248694091941715,0.733290888306877
1,"Schleswig-Holstein",1058083,"Hütten",205,105,100,0.51219512195122,209,105,104,0.502392344497608,0.0180150197514072,0.248694091941715,0.733290888306877
1,"Schleswig-Holstein",1058084,"Hummelfeld",287,132,155,0.45993031358885,287,131,156,0.456445993031359,0.0180150197514072,0.248694091941715,0.733290888306877
1,"Schleswig-Holstein",1058085,"Jahrsdorf",267,133,134,0.49812734082397,267,134,133,0.50187265917603,0.0180150197514072,0.248694091941715,0.733290888306877
1,"Schleswig-Holstein",1058086,"Jevenstedt",3245,1614,1631,0.497380585516179,3225,1593,1632,0.493953488372093,0.0180150197514072,0.248694091941715,0.733290888306877
1,"Schleswig-Holstein",1058087,"Karby",592,281,311,0.474662162162162,531,249,282,0.468926553672316,0.0180150197514072,0.248694091941715,0.733290888306877
1,"Schleswig-Holstein",1058088,"Klein Wittensee",196,94,102,0.479591836734694,194,90,104,0.463917525773196,0.0180150197514072,0.248694091941715,0.733290888306877
1,"Schleswig-Holstein",1058089,"Königshügel",161,77,84,0.478260869565217,166,80,86,0.481927710843373,0.0180150197514072,0.248694091941715,0.733290888306877
1,"Schleswig-Holstein",1058090,"Kosel",1414,696,718,0.492220650636492,1322,631,691,0.477307110438729,0.0180150197514072,0.248694091941715,0.733290888306877
1,"Schleswig-Holstein",1058091,"Krogaspe",443,238,205,0.5372460496614,443,241,202,0.544018058690745,0.0180150197514072,0.248694091941715,0.733290888306877
1,"Schleswig-Holstein",1058092,"Kronshagen",11785,5527,6258,0.468985999151464,12134,5663,6471,0.466705126091973,0.0180150197514072,0.248694091941715,0.733290888306877
1,"Schleswig-Holstein",1058093,"Krummwisch",673,354,319,0.526002971768202,696,375,321,0.538793103448276,0.0180150197514072,0.248694091941715,0.733290888306877
1,"Schleswig-Holstein",1058094,"Langwedel",1502,757,745,0.503994673768309,1407,705,702,0.501066098081023,0.0180150197514072,0.248694091941715,0.733290888306877
1,"Schleswig-Holstein",1058096,"Lindau",1258,653,605,0.519077901430843,1251,655,596,0.523581135091926,0.0180150197514072,0.248694091941715,0.733290888306877
1,"Schleswig-Holstein",1058097,"Lohe-Föhrden",500,276,224,0.552,613,388,225,0.632952691680261,0.0180150197514072,0.248694091941715,0.733290888306877
1,"Schleswig-Holstein",1058098,"Loop",179,89,90,0.497206703910615,162,78,84,0.481481481481481,0.0180150197514072,0.248694091941715,0.733290888306877
1,"Schleswig-Holstein",1058099,"Loose",751,380,371,0.505992010652463,764,387,377,0.506544502617801,0.0180150197514072,0.248694091941715,0.733290888306877
1,"Schleswig-Holstein",1058100,"Lütjenwestedt",576,293,283,0.508680555555556,592,298,294,0.503378378378378,0.0180150197514072,0.248694091941715,0.733290888306877
1,"Schleswig-Holstein",1058101,"Luhnstedt",428,209,219,0.488317757009346,424,199,225,0.469339622641509,0.0180150197514072,0.248694091941715,0.733290888306877
1,"Schleswig-Holstein",1058102,"Goosefeld",749,378,371,0.504672897196262,772,393,379,0.509067357512953,0.0180150197514072,0.248694091941715,0.733290888306877
1,"Schleswig-Holstein",1058103,"Meezen",360,179,181,0.497222222222222,372,185,187,0.497311827956989,0.0180150197514072,0.248694091941715,0.733290888306877
1,"Schleswig-Holstein",1058104,"Melsdorf",1723,860,863,0.499129425420778,1744,869,875,0.498279816513761,0.0180150197514072,0.248694091941715,0.733290888306877
1,"Schleswig-Holstein",1058105,"Mielkendorf",1363,673,690,0.493763756419663,1327,660,667,0.497362471740769,0.0180150197514072,0.248694091941715,0.733290888306877
1,"Schleswig-Holstein",1058106,"Mörel",248,133,115,0.536290322580645,264,144,120,0.545454545454545,0.0180150197514072,0.248694091941715,0.733290888306877
1,"Schleswig-Holstein",1058107,"Molfsee",4764,2263,2501,0.475020990764064,4790,2296,2494,0.479331941544885,0.0180150197514072,0.248694091941715,0.733290888306877
1,"Schleswig-Holstein",1058108,"Mühbrook",536,263,273,0.490671641791045,534,263,271,0.49250936329588,0.0180150197514072,0.248694091941715,0.733290888306877
1,"Schleswig-Holstein",1058109,"Negenharrie",353,173,180,0.490084985835694,346,167,179,0.482658959537572,0.0180150197514072,0.248694091941715,0.733290888306877
1,"Schleswig-Holstein",1058110,"Neudorf-Bornstein",1047,507,540,0.484240687679083,1080,526,554,0.487037037037037,0.0180150197514072,0.248694091941715,0.733290888306877
1,"Schleswig-Holstein",1058111,"Neu Duvenstedt",120,58,62,0.483333333333333,132,68,64,0.515151515151515,0.0180150197514072,0.248694091941715,0.733290888306877
1,"Schleswig-Holstein",1058112,"Neuwittenbek",1184,581,603,0.490709459459459,1220,626,594,0.513114754098361,0.0180150197514072,0.248694091941715,0.733290888306877
1,"Schleswig-Holstein",1058113,"Nienborstel",593,312,281,0.526138279932546,599,318,281,0.530884808013356,0.0180150197514072,0.248694091941715,0.733290888306877
1,"Schleswig-Holstein",1058115,"Nindorf",621,313,308,0.50402576489533,655,325,330,0.49618320610687,0.0180150197514072,0.248694091941715,0.733290888306877
1,"Schleswig-Holstein",1058116,"Noer",858,429,429,0.5,823,405,418,0.492102065613609,0.0180150197514072,0.248694091941715,0.733290888306877
1,"Schleswig-Holstein",1058117,"Nortorf, Stadt",6626,3223,3403,0.48641714458195,6186,3042,3144,0.491755577109602,0.0180150197514072,0.248694091941715,0.733290888306877
1,"Schleswig-Holstein",1058118,"Nübbel",1557,809,748,0.519588953114965,1578,834,744,0.52851711026616,0.0180150197514072,0.248694091941715,0.733290888306877
1,"Schleswig-Holstein",1058119,"Oldenbüttel",284,151,133,0.53169014084507,286,157,129,0.548951048951049,0.0180150197514072,0.248694091941715,0.733290888306877
1,"Schleswig-Holstein",1058120,"Oldenhütten",152,74,78,0.486842105263158,146,70,76,0.479452054794521,0.0180150197514072,0.248694091941715,0.733290888306877
1,"Schleswig-Holstein",1058121,"Osdorf",2369,1178,1191,0.497256226255804,2376,1184,1192,0.498316498316498,0.0180150197514072,0.248694091941715,0.733290888306877
1,"Schleswig-Holstein",1058122,"Ostenfeld (Rendsburg)",549,283,266,0.515482695810565,540,285,255,0.527777777777778,0.0180150197514072,0.248694091941715,0.733290888306877
1,"Schleswig-Holstein",1058123,"Osterby",924,460,464,0.497835497835498,923,466,457,0.504875406283857,0.0180150197514072,0.248694091941715,0.733290888306877
1,"Schleswig-Holstein",1058124,"Osterrönfeld",5150,2559,2591,0.496893203883495,5112,2559,2553,0.500586854460094,0.0180150197514072,0.248694091941715,0.733290888306877
1,"Schleswig-Holstein",1058125,"Osterstedt",643,321,322,0.499222395023328,637,316,321,0.49607535321821,0.0180150197514072,0.248694091941715,0.733290888306877
1,"Schleswig-Holstein",1058126,"Ottendorf",866,401,465,0.463048498845266,845,396,449,0.468639053254438,0.0180150197514072,0.248694091941715,0.733290888306877
1,"Schleswig-Holstein",1058127,"Owschlag",3624,1823,1801,0.5030353200883,3624,1843,1781,0.50855408388521,0.0180150197514072,0.248694091941715,0.733290888306877
1,"Schleswig-Holstein",1058128,"Padenstedt",1558,764,794,0.490372272143774,1521,753,768,0.495069033530572,0.0180150197514072,0.248694091941715,0.733290888306877
1,"Schleswig-Holstein",1058129,"Prinzenmoor",195,99,96,0.507692307692308,193,102,91,0.528497409326425,0.0180150197514072,0.248694091941715,0.733290888306877
1,"Schleswig-Holstein",1058130,"Quarnbek",1757,847,910,0.48207171314741,1788,852,936,0.476510067114094,0.0180150197514072,0.248694091941715,0.733290888306877
1,"Schleswig-Holstein",1058131,"Rade b. Hohenwestedt",86,46,40,0.534883720930233,88,44,44,0.5,0.0180150197514072,0.248694091941715,0.733290888306877
1,"Schleswig-Holstein",1058132,"Rade b. Rendsburg",219,110,109,0.502283105022831,228,107,121,0.469298245614035,0.0180150197514072,0.248694091941715,0.733290888306877
1,"Schleswig-Holstein",1058133,"Reesdorf",149,75,74,0.503355704697987,152,76,76,0.5,0.0180150197514072,0.248694091941715,0.733290888306877
1,"Schleswig-Holstein",1058134,"Remmels",432,213,219,0.493055555555556,428,212,216,0.495327102803738,0.0180150197514072,0.248694091941715,0.733290888306877
1,"Schleswig-Holstein",1058135,"Rendsburg, Stadt",27519,13276,14243,0.482430320869218,28077,13673,14404,0.486982227445952,0.0180150197514072,0.248694091941715,0.733290888306877
1,"Schleswig-Holstein",1058136,"Rickert",1099,534,565,0.48589626933576,1081,523,558,0.483811285846439,0.0180150197514072,0.248694091941715,0.733290888306877
1,"Schleswig-Holstein",1058137,"Rieseby",2625,1275,1350,0.485714285714286,2452,1214,1238,0.49510603588907,0.0180150197514072,0.248694091941715,0.733290888306877
1,"Schleswig-Holstein",1058138,"Rodenbek",490,228,262,0.46530612244898,478,222,256,0.464435146443515,0.0180150197514072,0.248694091941715,0.733290888306877
1,"Schleswig-Holstein",1058139,"Rumohr",808,408,400,0.504950495049505,753,382,371,0.50730411686587,0.0180150197514072,0.248694091941715,0.733290888306877
1,"Schleswig-Holstein",1058140,"Schacht-Audorf",4487,2177,2310,0.485179407176287,4450,2163,2287,0.486067415730337,0.0180150197514072,0.248694091941715,0.733290888306877
1,"Schleswig-Holstein",1058141,"Schierensee",403,200,203,0.496277915632754,392,188,204,0.479591836734694,0.0180150197514072,0.248694091941715,0.733290888306877
1,"Schleswig-Holstein",1058142,"Schinkel",1014,519,495,0.511834319526627,1017,524,493,0.515240904621436,0.0180150197514072,0.248694091941715,0.733290888306877
1,"Schleswig-Holstein",1058143,"Schmalstede",262,141,121,0.538167938931298,272,149,123,0.547794117647059,0.0180150197514072,0.248694091941715,0.733290888306877
1,"Schleswig-Holstein",1058144,"Schönbek",186,92,94,0.494623655913978,167,84,83,0.502994011976048,0.0180150197514072,0.248694091941715,0.733290888306877
1,"Schleswig-Holstein",1058145,"Schönhorst",333,161,172,0.483483483483483,318,156,162,0.490566037735849,0.0180150197514072,0.248694091941715,0.733290888306877
1,"Schleswig-Holstein",1058146,"Schülldorf",667,340,327,0.509745127436282,682,342,340,0.501466275659824,0.0180150197514072,0.248694091941715,0.733290888306877
1,"Schleswig-Holstein",1058147,"Schülp b. Nortorf",777,376,401,0.483912483912484,837,414,423,0.494623655913978,0.0180150197514072,0.248694091941715,0.733290888306877
1,"Schleswig-Holstein",1058148,"Schülp b. Rendsburg",1128,545,583,0.483156028368794,1094,527,567,0.481718464351005,0.0180150197514072,0.248694091941715,0.733290888306877
1,"Schleswig-Holstein",1058150,"Schwedeneck",2888,1451,1437,0.502423822714681,2936,1483,1453,0.505108991825613,0.0180150197514072,0.248694091941715,0.733290888306877
1,"Schleswig-Holstein",1058151,"Seefeld",376,183,193,0.486702127659574,363,170,193,0.46831955922865,0.0180150197514072,0.248694091941715,0.733290888306877
1,"Schleswig-Holstein",1058152,"Sehestedt",832,405,427,0.486778846153846,842,411,431,0.48812351543943,0.0180150197514072,0.248694091941715,0.733290888306877
1,"Schleswig-Holstein",1058153,"Sören",189,86,103,0.455026455026455,197,89,108,0.451776649746193,0.0180150197514072,0.248694091941715,0.733290888306877
1,"Schleswig-Holstein",1058154,"Sophienhamm",343,160,183,0.466472303206997,344,163,181,0.473837209302326,0.0180150197514072,0.248694091941715,0.733290888306877
1,"Schleswig-Holstein",1058155,"Stafstedt",345,173,172,0.501449275362319,332,174,158,0.524096385542169,0.0180150197514072,0.248694091941715,0.733290888306877
1,"Schleswig-Holstein",1058156,"Steenfeld",387,208,179,0.537467700258398,392,211,181,0.538265306122449,0.0180150197514072,0.248694091941715,0.733290888306877
1,"Schleswig-Holstein",1058157,"Strande",1530,724,806,0.473202614379085,1494,707,787,0.473226238286479,0.0180150197514072,0.248694091941715,0.733290888306877
1,"Schleswig-Holstein",1058158,"Tackesdorf",72,38,34,0.527777777777778,85,42,43,0.494117647058824,0.0180150197514072,0.248694091941715,0.733290888306877
1,"Schleswig-Holstein",1058159,"Tappendorf",340,180,160,0.529411764705882,345,180,165,0.521739130434783,0.0180150197514072,0.248694091941715,0.733290888306877
1,"Schleswig-Holstein",1058160,"Techelsdorf",149,79,70,0.530201342281879,149,78,71,0.523489932885906,0.0180150197514072,0.248694091941715,0.733290888306877
1,"Schleswig-Holstein",1058161,"Thaden",265,137,128,0.516981132075472,267,138,129,0.51685393258427,0.0180150197514072,0.248694091941715,0.733290888306877
1,"Schleswig-Holstein",1058162,"Thumby",462,236,226,0.510822510822511,454,220,234,0.484581497797357,0.0180150197514072,0.248694091941715,0.733290888306877
1,"Schleswig-Holstein",1058163,"Timmaspe",1104,537,567,0.486413043478261,1127,542,585,0.48092280390417,0.0180150197514072,0.248694091941715,0.733290888306877
1,"Schleswig-Holstein",1058164,"Todenbüttel",1025,519,506,0.506341463414634,1063,545,518,0.512699905926623,0.0180150197514072,0.248694091941715,0.733290888306877
1,"Schleswig-Holstein",1058165,"Tüttendorf",1091,555,536,0.508707607699358,1142,583,559,0.510507880910683,0.0180150197514072,0.248694091941715,0.733290888306877
1,"Schleswig-Holstein",1058166,"Waabs",1404,678,726,0.482905982905983,1413,686,727,0.48549186128804,0.0180150197514072,0.248694091941715,0.733290888306877
1,"Schleswig-Holstein",1058167,"Wapelfeld",313,151,162,0.482428115015974,321,154,167,0.479750778816199,0.0180150197514072,0.248694091941715,0.733290888306877
1,"Schleswig-Holstein",1058168,"Warder",612,309,303,0.504901960784314,614,289,325,0.470684039087948,0.0180150197514072,0.248694091941715,0.733290888306877
1,"Schleswig-Holstein",1058169,"Wasbek",2219,1099,1120,0.495268138801262,2197,1093,1104,0.497496586253983,0.0180150197514072,0.248694091941715,0.733290888306877
1,"Schleswig-Holstein",1058170,"Wattenbek",2912,1407,1505,0.483173076923077,2929,1422,1507,0.485489928303175,0.0180150197514072,0.248694091941715,0.733290888306877
1,"Schleswig-Holstein",1058171,"Westensee",1521,727,794,0.477975016436555,1559,751,808,0.481719050673509,0.0180150197514072,0.248694091941715,0.733290888306877
1,"Schleswig-Holstein",1058172,"Westerrönfeld",4901,2379,2522,0.485411140583554,4940,2414,2526,0.488663967611336,0.0180150197514072,0.248694091941715,0.733290888306877
1,"Schleswig-Holstein",1058173,"Windeby",1052,511,541,0.48574144486692,1068,525,543,0.491573033707865,0.0180150197514072,0.248694091941715,0.733290888306877
1,"Schleswig-Holstein",1058174,"Winnemark",505,252,253,0.499009900990099,524,255,269,0.486641221374046,0.0180150197514072,0.248694091941715,0.733290888306877
1,"Schleswig-Holstein",1058175,"Ahlefeld-Bistensee",488,228,260,0.467213114754098,483,233,250,0.4824016563147,0.0180150197514072,0.248694091941715,0.733290888306877
1,"Schleswig-Holstein",1059001,"Alt Bennebek",366,197,169,0.538251366120219,350,192,158,0.548571428571429,0.0180150197514072,0.248694091941715,0.733290888306877
1,"Schleswig-Holstein",1059002,"Arnis, Stadt",321,156,165,0.485981308411215,273,149,124,0.545787545787546,0.0180150197514072,0.248694091941715,0.733290888306877
1,"Schleswig-Holstein",1059005,"Bergenhusen",713,372,341,0.521739130434783,674,350,324,0.519287833827893,0.0180150197514072,0.248694091941715,0.733290888306877
1,"Schleswig-Holstein",1059006,"Böel",749,382,367,0.510013351134846,733,373,360,0.508867667121419,0.0180150197514072,0.248694091941715,0.733290888306877
1,"Schleswig-Holstein",1059008,"Böklund",1470,723,747,0.491836734693878,1409,688,721,0.488289567068843,0.0180150197514072,0.248694091941715,0.733290888306877
1,"Schleswig-Holstein",1059009,"Börm",751,397,354,0.528628495339547,736,392,344,0.532608695652174,0.0180150197514072,0.248694091941715,0.733290888306877
1,"Schleswig-Holstein",1059010,"Bollingstedt",1475,746,729,0.505762711864407,1471,737,734,0.501019714479946,0.0180150197514072,0.248694091941715,0.733290888306877
1,"Schleswig-Holstein",1059011,"Boren",745,386,359,0.518120805369128,746,376,370,0.50402144772118,0.0180150197514072,0.248694091941715,0.733290888306877
1,"Schleswig-Holstein",1059012,"Borgwedel",707,330,377,0.466760961810467,725,338,387,0.466206896551724,0.0180150197514072,0.248694091941715,0.733290888306877
1,"Schleswig-Holstein",1059014,"Brebel",381,197,184,0.517060367454068,397,208,189,0.523929471032746,0.0180150197514072,0.248694091941715,0.733290888306877
1,"Schleswig-Holstein",1059016,"Brodersby",529,257,272,0.485822306238185,483,240,243,0.496894409937888,0.0180150197514072,0.248694091941715,0.733290888306877
1,"Schleswig-Holstein",1059018,"Busdorf",2026,1003,1023,0.495064165844028,2018,1013,1005,0.501982160555005,0.0180150197514072,0.248694091941715,0.733290888306877
1,"Schleswig-Holstein",1059019,"Dannewerk",1134,562,572,0.495590828924162,1140,555,585,0.486842105263158,0.0180150197514072,0.248694091941715,0.733290888306877
1,"Schleswig-Holstein",1059020,"Dörpstedt",548,288,260,0.525547445255474,546,284,262,0.52014652014652,0.0180150197514072,0.248694091941715,0.733290888306877
1,"Schleswig-Holstein",1059021,"Dollrottfeld",263,142,121,0.539923954372624,269,150,119,0.557620817843866,0.0180150197514072,0.248694091941715,0.733290888306877
1,"Schleswig-Holstein",1059022,"Ekenis",206,107,99,0.519417475728155,207,103,104,0.497584541062802,0.0180150197514072,0.248694091941715,0.733290888306877
1,"Schleswig-Holstein",1059023,"Ellingstedt",831,417,414,0.501805054151625,824,413,411,0.50121359223301,0.0180150197514072,0.248694091941715,0.733290888306877
1,"Schleswig-Holstein",1059024,"Erfde",1946,959,987,0.492805755395683,1955,952,1003,0.48695652173913,0.0180150197514072,0.248694091941715,0.733290888306877
1,"Schleswig-Holstein",1059026,"Fahrdorf",2470,1184,1286,0.479352226720648,2472,1182,1290,0.478155339805825,0.0180150197514072,0.248694091941715,0.733290888306877
1,"Schleswig-Holstein",1059032,"Geltorf",376,183,193,0.486702127659574,397,182,215,0.458438287153652,0.0180150197514072,0.248694091941715,0.733290888306877
1,"Schleswig-Holstein",1059033,"Goltoft",233,125,108,0.536480686695279,235,125,110,0.531914893617021,0.0180150197514072,0.248694091941715,0.733290888306877
1,"Schleswig-Holstein",1059034,"Grödersby",232,101,131,0.435344827586207,245,110,135,0.448979591836735,0.0180150197514072,0.248694091941715,0.733290888306877
1,"Schleswig-Holstein",1059035,"Groß Rheide",914,466,448,0.509846827133479,927,462,465,0.498381877022654,0.0180150197514072,0.248694091941715,0.733290888306877
1,"Schleswig-Holstein",1059037,"Havetoft",909,430,479,0.473047304730473,881,422,459,0.47900113507378,0.0180150197514072,0.248694091941715,0.733290888306877
1,"Schleswig-Holstein",1059038,"Havetoftloit",921,456,465,0.495114006514658,943,461,482,0.488865323435843,0.0180150197514072,0.248694091941715,0.733290888306877
1,"Schleswig-Holstein",1059039,"Hollingstedt",1009,503,506,0.498513379583746,1005,508,497,0.50547263681592,0.0180150197514072,0.248694091941715,0.733290888306877
1,"Schleswig-Holstein",1059041,"Hüsby",772,374,398,0.484455958549223,789,385,404,0.487959442332066,0.0180150197514072,0.248694091941715,0.733290888306877
1,"Schleswig-Holstein",1059042,"Idstedt",857,419,438,0.488914819136523,847,409,438,0.482880755608028,0.0180150197514072,0.248694091941715,0.733290888306877
1,"Schleswig-Holstein",1059043,"Jagel",954,482,472,0.505241090146751,963,488,475,0.5067497403946,0.0180150197514072,0.248694091941715,0.733290888306877
1,"Schleswig-Holstein",1059044,"Jübek",2629,1290,1339,0.490680867249905,2608,1297,1311,0.497315950920245,0.0180150197514072,0.248694091941715,0.733290888306877
1,"Schleswig-Holstein",1059045,"Kappeln, Stadt",8878,4283,4595,0.48242847488173,9628,4924,4704,0.511425010386373,0.0180150197514072,0.248694091941715,0.733290888306877
1,"Schleswig-Holstein",1059047,"Kiesby",207,101,106,0.48792270531401,192,95,97,0.494791666666667,0.0180150197514072,0.248694091941715,0.733290888306877
1,"Schleswig-Holstein",1059049,"Klappholz",514,243,271,0.472762645914397,514,240,274,0.466926070038911,0.0180150197514072,0.248694091941715,0.733290888306877
1,"Schleswig-Holstein",1059050,"Klein Bennebek",526,275,251,0.522813688212928,534,286,248,0.535580524344569,0.0180150197514072,0.248694091941715,0.733290888306877
1,"Schleswig-Holstein",1059051,"Klein Rheide",327,178,149,0.54434250764526,316,179,137,0.566455696202532,0.0180150197514072,0.248694091941715,0.733290888306877
1,"Schleswig-Holstein",1059053,"Kropp",6058,2965,3093,0.489435457246616,6400,3225,3175,0.50390625,0.0180150197514072,0.248694091941715,0.733290888306877
1,"Schleswig-Holstein",1059055,"Loit",265,135,130,0.509433962264151,259,135,124,0.521235521235521,0.0180150197514072,0.248694091941715,0.733290888306877
1,"Schleswig-Holstein",1059056,"Lottorf",228,106,122,0.464912280701754,232,107,125,0.461206896551724,0.0180150197514072,0.248694091941715,0.733290888306877
1,"Schleswig-Holstein",1059057,"Lürschau",1117,560,557,0.501342882721576,1127,567,560,0.503105590062112,0.0180150197514072,0.248694091941715,0.733290888306877
1,"Schleswig-Holstein",1059058,"Meggerdorf",703,351,352,0.499288762446657,672,339,333,0.504464285714286,0.0180150197514072,0.248694091941715,0.733290888306877
1,"Schleswig-Holstein",1059060,"Mohrkirch",1023,520,503,0.50830889540567,992,517,475,0.52116935483871,0.0180150197514072,0.248694091941715,0.733290888306877
1,"Schleswig-Holstein",1059062,"Neuberend",1096,538,558,0.490875912408759,1126,557,569,0.494671403197158,0.0180150197514072,0.248694091941715,0.733290888306877
1,"Schleswig-Holstein",1059063,"Norderbrarup",635,314,321,0.494488188976378,622,302,320,0.485530546623794,0.0180150197514072,0.248694091941715,0.733290888306877
1,"Schleswig-Holstein",1059064,"Norderstapel",832,440,392,0.528846153846154,808,419,389,0.518564356435644,0.0180150197514072,0.248694091941715,0.733290888306877
1,"Schleswig-Holstein",1059065,"Nottfeld",145,80,65,0.551724137931034,139,81,58,0.58273381294964,0.0180150197514072,0.248694091941715,0.733290888306877
1,"Schleswig-Holstein",1059067,"Oersberg",317,158,159,0.498422712933754,338,166,172,0.49112426035503,0.0180150197514072,0.248694091941715,0.733290888306877
1,"Schleswig-Holstein",1059068,"Rabenkirchen-Faulück",643,343,300,0.53343701399689,634,336,298,0.529968454258675,0.0180150197514072,0.248694091941715,0.733290888306877
1,"Schleswig-Holstein",1059069,"Rüde",360,194,166,0.538888888888889,366,201,165,0.549180327868853,0.0180150197514072,0.248694091941715,0.733290888306877
1,"Schleswig-Holstein",1059070,"Rügge",241,117,124,0.485477178423237,239,123,116,0.514644351464435,0.0180150197514072,0.248694091941715,0.733290888306877
1,"Schleswig-Holstein",1059071,"Satrup",3648,1767,1881,0.484375,3691,1768,1923,0.479002980222162,0.0180150197514072,0.248694091941715,0.733290888306877
1,"Schleswig-Holstein",1059072,"Saustrup",210,108,102,0.514285714285714,207,108,99,0.521739130434783,0.0180150197514072,0.248694091941715,0.733290888306877
1,"Schleswig-Holstein",1059073,"Schaalby",1645,822,823,0.499696048632219,1633,804,829,0.492345376607471,0.0180150197514072,0.248694091941715,0.733290888306877
1,"Schleswig-Holstein",1059074,"Scheggerott",378,200,178,0.529100529100529,361,194,167,0.537396121883656,0.0180150197514072,0.248694091941715,0.733290888306877
1,"Schleswig-Holstein",1059075,"Schleswig, Stadt",23812,11457,12355,0.481143961028053,24133,11578,12555,0.479758007707289,0.0180150197514072,0.248694091941715,0.733290888306877
1,"Schleswig-Holstein",1059076,"Schnarup-Thumby",578,305,273,0.527681660899654,578,304,274,0.525951557093426,0.0180150197514072,0.248694091941715,0.733290888306877
1,"Schleswig-Holstein",1059077,"Schuby",2559,1273,1286,0.497459945291129,2528,1266,1262,0.500791139240506,0.0180150197514072,0.248694091941715,0.733290888306877
1,"Schleswig-Holstein",1059078,"Selk",858,424,434,0.494172494172494,857,428,429,0.499416569428238,0.0180150197514072,0.248694091941715,0.733290888306877
1,"Schleswig-Holstein",1059079,"Silberstedt",2189,1134,1055,0.518044769301051,2204,1152,1052,0.522686025408348,0.0180150197514072,0.248694091941715,0.733290888306877
1,"Schleswig-Holstein",1059080,"Steinfeld",754,365,389,0.484084880636605,736,354,382,0.480978260869565,0.0180150197514072,0.248694091941715,0.733290888306877
1,"Schleswig-Holstein",1059081,"Stolk",819,424,395,0.517704517704518,810,400,410,0.493827160493827,0.0180150197514072,0.248694091941715,0.733290888306877
1,"Schleswig-Holstein",1059082,"Struxdorf",652,348,304,0.533742331288344,663,351,312,0.529411764705882,0.0180150197514072,0.248694091941715,0.733290888306877
1,"Schleswig-Holstein",1059083,"Süderbrarup",4126,1972,2154,0.477944740668929,3902,1859,2043,0.476422347514095,0.0180150197514072,0.248694091941715,0.733290888306877
1,"Schleswig-Holstein",1059084,"Süderfahrenstedt",498,246,252,0.493975903614458,492,239,253,0.485772357723577,0.0180150197514072,0.248694091941715,0.733290888306877
1,"Schleswig-Holstein",1059085,"Süderstapel",1046,504,542,0.481835564053537,1047,511,536,0.488061127029608,0.0180150197514072,0.248694091941715,0.733290888306877
1,"Schleswig-Holstein",1059086,"Taarstedt",879,442,437,0.502844141069397,876,457,419,0.521689497716895,0.0180150197514072,0.248694091941715,0.733290888306877
1,"Schleswig-Holstein",1059087,"Tetenhusen",945,473,472,0.5005291005291,929,463,466,0.498385360602799,0.0180150197514072,0.248694091941715,0.733290888306877
1,"Schleswig-Holstein",1059088,"Tielen",294,146,148,0.496598639455782,285,142,143,0.498245614035088,0.0180150197514072,0.248694091941715,0.733290888306877
1,"Schleswig-Holstein",1059090,"Tolk",1053,532,521,0.505223171889839,1014,510,504,0.502958579881657,0.0180150197514072,0.248694091941715,0.733290888306877
1,"Schleswig-Holstein",1059092,"Treia",1508,756,752,0.50132625994695,1431,717,714,0.50104821802935,0.0180150197514072,0.248694091941715,0.733290888306877
1,"Schleswig-Holstein",1059093,"Ülsby",435,207,228,0.475862068965517,451,212,239,0.470066518847007,0.0180150197514072,0.248694091941715,0.733290888306877
1,"Schleswig-Holstein",1059094,"Ulsnis",685,350,335,0.510948905109489,674,341,333,0.50593471810089,0.0180150197514072,0.248694091941715,0.733290888306877
1,"Schleswig-Holstein",1059095,"Wagersrott",249,130,119,0.522088353413655,250,137,113,0.548,0.0180150197514072,0.248694091941715,0.733290888306877
1,"Schleswig-Holstein",1059096,"Wohlde",512,269,243,0.525390625,496,254,242,0.512096774193548,0.0180150197514072,0.248694091941715,0.733290888306877
1,"Schleswig-Holstein",1059097,"Twedt",513,250,263,0.487329434697856,499,242,257,0.48496993987976,0.0180150197514072,0.248694091941715,0.733290888306877
1,"Schleswig-Holstein",1059098,"Nübel",1366,710,656,0.519765739385066,1380,736,644,0.533333333333333,0.0180150197514072,0.248694091941715,0.733290888306877
1,"Schleswig-Holstein",1059101,"Tastrup",423,206,217,0.486997635933806,412,202,210,0.490291262135922,0.0180150197514072,0.248694091941715,0.733290888306877
1,"Schleswig-Holstein",1059102,"Ahneby",220,109,111,0.495454545454545,212,99,113,0.466981132075472,0.0180150197514072,0.248694091941715,0.733290888306877
1,"Schleswig-Holstein",1059103,"Ausacker",522,261,261,0.5,496,249,247,0.502016129032258,0.0180150197514072,0.248694091941715,0.733290888306877
1,"Schleswig-Holstein",1059105,"Böxlund",101,58,43,0.574257425742574,108,58,50,0.537037037037037,0.0180150197514072,0.248694091941715,0.733290888306877
1,"Schleswig-Holstein",1059106,"Dollerup",1024,515,509,0.5029296875,1012,494,518,0.488142292490119,0.0180150197514072,0.248694091941715,0.733290888306877
1,"Schleswig-Holstein",1059107,"Eggebek",2218,1113,1105,0.50180342651037,2557,1363,1194,0.533046538912788,0.0180150197514072,0.248694091941715,0.733290888306877
1,"Schleswig-Holstein",1059109,"Esgrus",788,379,409,0.480964467005076,761,363,398,0.47700394218134,0.0180150197514072,0.248694091941715,0.733290888306877
1,"Schleswig-Holstein",1059112,"Gelting",1958,919,1039,0.469356486210419,1876,893,983,0.476012793176972,0.0180150197514072,0.248694091941715,0.733290888306877
1,"Schleswig-Holstein",1059113,"Glücksburg (Ostsee), Stadt",5810,2735,3075,0.470740103270224,5864,2782,3082,0.474420190995907,0.0180150197514072,0.248694091941715,0.733290888306877
1,"Schleswig-Holstein",1059115,"Großenwiehe",2885,1462,1423,0.506759098786828,2828,1439,1389,0.508840169731259,0.0180150197514072,0.248694091941715,0.733290888306877
1,"Schleswig-Holstein",1059116,"Großsolt",1812,889,923,0.490618101545254,1834,903,931,0.49236641221374,0.0180150197514072,0.248694091941715,0.733290888306877
1,"Schleswig-Holstein",1059118,"Grundhof",852,429,423,0.503521126760563,872,448,424,0.513761467889908,0.0180150197514072,0.248694091941715,0.733290888306877
1,"Schleswig-Holstein",1059120,"Harrislee",10905,5251,5654,0.481522237505731,11470,5610,5860,0.489102005231037,0.0180150197514072,0.248694091941715,0.733290888306877
1,"Schleswig-Holstein",1059121,"Hasselberg",895,464,431,0.518435754189944,880,468,412,0.531818181818182,0.0180150197514072,0.248694091941715,0.733290888306877
1,"Schleswig-Holstein",1059123,"Hörup",649,332,317,0.5115562403698,628,325,303,0.517515923566879,0.0180150197514072,0.248694091941715,0.733290888306877
1,"Schleswig-Holstein",1059124,"Holt",189,96,93,0.507936507936508,191,98,93,0.513089005235602,0.0180150197514072,0.248694091941715,0.733290888306877
1,"Schleswig-Holstein",1059126,"Hürup",1232,616,616,0.5,1158,562,596,0.485319516407599,0.0180150197514072,0.248694091941715,0.733290888306877
1,"Schleswig-Holstein",1059127,"Husby",2295,1134,1161,0.494117647058824,2271,1136,1135,0.500220167327169,0.0180150197514072,0.248694091941715,0.733290888306877
1,"Schleswig-Holstein",1059128,"Janneby",418,203,215,0.485645933014354,441,213,228,0.482993197278912,0.0180150197514072,0.248694091941715,0.733290888306877
1,"Schleswig-Holstein",1059129,"Jardelund",322,172,150,0.53416149068323,324,178,146,0.549382716049383,0.0180150197514072,0.248694091941715,0.733290888306877
1,"Schleswig-Holstein",1059131,"Jerrishoe",960,469,491,0.488541666666667,963,454,509,0.471443406022845,0.0180150197514072,0.248694091941715,0.733290888306877
1,"Schleswig-Holstein",1059132,"Jörl",742,389,353,0.524258760107817,808,418,390,0.517326732673267,0.0180150197514072,0.248694091941715,0.733290888306877
1,"Schleswig-Holstein",1059136,"Kronsgaard",243,116,127,0.477366255144033,231,98,133,0.424242424242424,0.0180150197514072,0.248694091941715,0.733290888306877
1,"Schleswig-Holstein",1059137,"Langballig",1598,778,820,0.486858573216521,1510,750,760,0.496688741721854,0.0180150197514072,0.248694091941715,0.733290888306877
1,"Schleswig-Holstein",1059138,"Langstedt",1029,495,534,0.481049562682216,1050,510,540,0.485714285714286,0.0180150197514072,0.248694091941715,0.733290888306877
1,"Schleswig-Holstein",1059141,"Maasbüll",722,368,354,0.509695290858726,706,353,353,0.5,0.0180150197514072,0.248694091941715,0.733290888306877
1,"Schleswig-Holstein",1059142,"Maasholm",641,316,325,0.492979719188768,639,312,327,0.488262910798122,0.0180150197514072,0.248694091941715,0.733290888306877
1,"Schleswig-Holstein",1059143,"Medelby",879,446,433,0.507394766780432,878,443,435,0.504555808656036,0.0180150197514072,0.248694091941715,0.733290888306877
1,"Schleswig-Holstein",1059144,"Meyn",699,364,335,0.520743919885551,688,357,331,0.518895348837209,0.0180150197514072,0.248694091941715,0.733290888306877
1,"Schleswig-Holstein",1059145,"Munkbrarup",1097,558,539,0.508659981768459,1088,555,533,0.510110294117647,0.0180150197514072,0.248694091941715,0.733290888306877
1,"Schleswig-Holstein",1059147,"Nieby",144,64,80,0.444444444444444,206,92,114,0.446601941747573,0.0180150197514072,0.248694091941715,0.733290888306877
1,"Schleswig-Holstein",1059148,"Niesgrau",613,308,305,0.502446982055465,578,288,290,0.498269896193772,0.0180150197514072,0.248694091941715,0.733290888306877
1,"Schleswig-Holstein",1059149,"Nordhackstedt",485,249,236,0.51340206185567,475,245,230,0.515789473684211,0.0180150197514072,0.248694091941715,0.733290888306877
1,"Schleswig-Holstein",1059151,"Osterby",312,156,156,0.5,339,166,173,0.489675516224189,0.0180150197514072,0.248694091941715,0.733290888306877
1,"Schleswig-Holstein",1059152,"Pommerby",163,85,78,0.521472392638037,161,82,79,0.509316770186335,0.0180150197514072,0.248694091941715,0.733290888306877
1,"Schleswig-Holstein",1059153,"Quern",1296,657,639,0.506944444444444,1289,645,644,0.500387897595035,0.0180150197514072,0.248694091941715,0.733290888306877
1,"Schleswig-Holstein",1059154,"Rabel",631,325,306,0.515055467511886,637,327,310,0.513343799058085,0.0180150197514072,0.248694091941715,0.733290888306877
1,"Schleswig-Holstein",1059155,"Rabenholz",288,137,151,0.475694444444444,291,141,150,0.484536082474227,0.0180150197514072,0.248694091941715,0.733290888306877
1,"Schleswig-Holstein",1059157,"Ringsberg",532,266,266,0.5,509,244,265,0.479371316306483,0.0180150197514072,0.248694091941715,0.733290888306877
1,"Schleswig-Holstein",1059158,"Schafflund",2467,1213,1254,0.491690312119984,2379,1166,1213,0.490121899957966,0.0180150197514072,0.248694091941715,0.733290888306877
1,"Schleswig-Holstein",1059159,"Sieverstedt",1653,841,812,0.508771929824561,1655,843,812,0.509365558912387,0.0180150197514072,0.248694091941715,0.733290888306877
1,"Schleswig-Holstein",1059161,"Sörup",4314,2153,2161,0.499072786277237,4157,2074,2083,0.49891748857349,0.0180150197514072,0.248694091941715,0.733290888306877
1,"Schleswig-Holstein",1059162,"Sollerup",487,242,245,0.496919917864476,485,243,242,0.501030927835052,0.0180150197514072,0.248694091941715,0.733290888306877
1,"Schleswig-Holstein",1059163,"Stangheck",227,117,110,0.515418502202643,220,115,105,0.522727272727273,0.0180150197514072,0.248694091941715,0.733290888306877
1,"Schleswig-Holstein",1059164,"Steinberg",856,423,433,0.494158878504673,900,452,448,0.502222222222222,0.0180150197514072,0.248694091941715,0.733290888306877
1,"Schleswig-Holstein",1059165,"Steinbergkirche",1500,747,753,0.498,1349,671,678,0.497405485544848,0.0180150197514072,0.248694091941715,0.733290888306877
1,"Schleswig-Holstein",1059167,"Sterup",1383,673,710,0.486623282718727,1365,682,683,0.4996336996337,0.0180150197514072,0.248694091941715,0.733290888306877
1,"Schleswig-Holstein",1059168,"Stoltebüll",769,382,387,0.496749024707412,806,406,400,0.503722084367246,0.0180150197514072,0.248694091941715,0.733290888306877
1,"Schleswig-Holstein",1059169,"Süderhackstedt",343,193,150,0.56268221574344,341,191,150,0.560117302052786,0.0180150197514072,0.248694091941715,0.733290888306877
1,"Schleswig-Holstein",1059171,"Tarp",5148,2490,2658,0.483682983682984,5500,2870,2630,0.521818181818182,0.0180150197514072,0.248694091941715,0.733290888306877
1,"Schleswig-Holstein",1059173,"Wallsbüll",891,440,451,0.493827160493827,887,438,449,0.49379932356257,0.0180150197514072,0.248694091941715,0.733290888306877
1,"Schleswig-Holstein",1059174,"Wanderup",2166,1091,1075,0.503693444136657,2253,1148,1105,0.509542831779849,0.0180150197514072,0.248694091941715,0.733290888306877
1,"Schleswig-Holstein",1059176,"Wees",2246,1097,1149,0.488423864648264,2253,1120,1133,0.497114957833999,0.0180150197514072,0.248694091941715,0.733290888306877
1,"Schleswig-Holstein",1059177,"Weesby",469,235,234,0.501066098081023,485,244,241,0.503092783505155,0.0180150197514072,0.248694091941715,0.733290888306877
1,"Schleswig-Holstein",1059178,"Westerholz",766,365,401,0.476501305483029,763,356,407,0.466579292267366,0.0180150197514072,0.248694091941715,0.733290888306877
1,"Schleswig-Holstein",1059179,"Lindewitt",2002,1005,997,0.501998001998002,2110,1079,1031,0.511374407582938,0.0180150197514072,0.248694091941715,0.733290888306877
1,"Schleswig-Holstein",1059182,"Freienwill",1556,762,794,0.489717223650386,1509,753,756,0.499005964214712,0.0180150197514072,0.248694091941715,0.733290888306877
1,"Schleswig-Holstein",1059183,"Handewitt",10801,5362,5439,0.496435515230071,10867,5412,5455,0.498021533081807,0.0180150197514072,0.248694091941715,0.733290888306877
1,"Schleswig-Holstein",1059184,"Oeversee",3322,1662,1660,0.500301023479831,3300,1669,1631,0.505757575757576,0.0180150197514072,0.248694091941715,0.733290888306877
1,"Schleswig-Holstein",1060002,"Alveslohe",2600,1314,1286,0.505384615384615,2570,1316,1254,0.512062256809338,0.0180150197514072,0.248694091941715,0.733290888306877
1,"Schleswig-Holstein",1060003,"Armstedt",395,191,204,0.483544303797468,413,200,213,0.484261501210654,0.0180150197514072,0.248694091941715,0.733290888306877
1,"Schleswig-Holstein",1060004,"Bad Bramstedt, Stadt",13631,6654,6977,0.488152006455873,13835,6764,7071,0.488904951210697,0.0180150197514072,0.248694091941715,0.733290888306877
1,"Schleswig-Holstein",1060005,"Bad Segeberg, Stadt",16534,7776,8758,0.470303616789646,15713,7335,8378,0.466810920893528,0.0180150197514072,0.248694091941715,0.733290888306877
1,"Schleswig-Holstein",1060006,"Bahrenhof",200,100,100,0.5,202,107,95,0.52970297029703,0.0180150197514072,0.248694091941715,0.733290888306877
1,"Schleswig-Holstein",1060007,"Bark",1001,522,479,0.521478521478521,1016,523,493,0.514763779527559,0.0180150197514072,0.248694091941715,0.733290888306877
1,"Schleswig-Holstein",1060008,"Bebensee",626,300,326,0.479233226837061,631,300,331,0.475435816164818,0.0180150197514072,0.248694091941715,0.733290888306877
1,"Schleswig-Holstein",1060009,"Bimöhlen",932,503,429,0.539699570815451,978,529,449,0.540899795501023,0.0180150197514072,0.248694091941715,0.733290888306877
1,"Schleswig-Holstein",1060010,"Blunk",619,323,296,0.521809369951535,599,311,288,0.519198664440735,0.0180150197514072,0.248694091941715,0.733290888306877
1,"Schleswig-Holstein",1060011,"Boostedt",4570,2224,2346,0.486652078774617,4592,2263,2329,0.492813588850174,0.0180150197514072,0.248694091941715,0.733290888306877
1,"Schleswig-Holstein",1060012,"Bornhöved",3361,1673,1688,0.497768521273431,3407,1684,1723,0.494276489580276,0.0180150197514072,0.248694091941715,0.733290888306877
1,"Schleswig-Holstein",1060013,"Borstel",118,60,58,0.508474576271186,129,66,63,0.511627906976744,0.0180150197514072,0.248694091941715,0.733290888306877
1,"Schleswig-Holstein",1060015,"Bühnsdorf",345,180,165,0.521739130434783,341,175,166,0.513196480938416,0.0180150197514072,0.248694091941715,0.733290888306877
1,"Schleswig-Holstein",1060016,"Daldorf",648,333,315,0.513888888888889,653,333,320,0.509954058192956,0.0180150197514072,0.248694091941715,0.733290888306877
1,"Schleswig-Holstein",1060017,"Damsdorf",236,117,119,0.495762711864407,238,119,119,0.5,0.0180150197514072,0.248694091941715,0.733290888306877
1,"Schleswig-Holstein",1060018,"Dreggers",59,31,28,0.525423728813559,53,28,25,0.528301886792453,0.0180150197514072,0.248694091941715,0.733290888306877
1,"Schleswig-Holstein",1060019,"Ellerau",5837,2821,3016,0.483296213808463,5884,2843,3041,0.483174711080897,0.0180150197514072,0.248694091941715,0.733290888306877
1,"Schleswig-Holstein",1060020,"Fahrenkrug",1527,771,756,0.504911591355599,1558,793,765,0.508985879332478,0.0180150197514072,0.248694091941715,0.733290888306877
1,"Schleswig-Holstein",1060021,"Föhrden-Barl",298,153,145,0.513422818791946,292,148,144,0.506849315068493,0.0180150197514072,0.248694091941715,0.733290888306877
1,"Schleswig-Holstein",1060022,"Fredesdorf",381,199,182,0.522309711286089,377,199,178,0.527851458885942,0.0180150197514072,0.248694091941715,0.733290888306877
1,"Schleswig-Holstein",1060023,"Fuhlendorf",422,206,216,0.488151658767773,404,210,194,0.51980198019802,0.0180150197514072,0.248694091941715,0.733290888306877
1,"Schleswig-Holstein",1060024,"Geschendorf",534,253,281,0.473782771535581,538,254,284,0.472118959107807,0.0180150197514072,0.248694091941715,0.733290888306877
1,"Schleswig-Holstein",1060025,"Glasau",919,467,452,0.508161044613711,917,467,450,0.509269356597601,0.0180150197514072,0.248694091941715,0.733290888306877
1,"Schleswig-Holstein",1060026,"Gönnebek",490,245,245,0.5,470,231,239,0.491489361702128,0.0180150197514072,0.248694091941715,0.733290888306877
1,"Schleswig-Holstein",1060027,"Großenaspe",2800,1374,1426,0.490714285714286,2802,1384,1418,0.493932905067809,0.0180150197514072,0.248694091941715,0.733290888306877
1,"Schleswig-Holstein",1060028,"Groß Kummerfeld",1959,973,986,0.496681980602348,2016,986,1030,0.489087301587302,0.0180150197514072,0.248694091941715,0.733290888306877
1,"Schleswig-Holstein",1060029,"Groß Niendorf",660,338,322,0.512121212121212,669,349,320,0.521674140508221,0.0180150197514072,0.248694091941715,0.733290888306877
1,"Schleswig-Holstein",1060030,"Groß Rönnau",590,301,289,0.510169491525424,599,298,301,0.497495826377296,0.0180150197514072,0.248694091941715,0.733290888306877
1,"Schleswig-Holstein",1060031,"Hagen",460,239,221,0.519565217391304,408,211,197,0.517156862745098,0.0180150197514072,0.248694091941715,0.733290888306877
1,"Schleswig-Holstein",1060033,"Hardebek",465,239,226,0.513978494623656,466,238,228,0.510729613733906,0.0180150197514072,0.248694091941715,0.733290888306877
1,"Schleswig-Holstein",1060034,"Hartenholm",1779,891,888,0.500843170320405,1780,912,868,0.512359550561798,0.0180150197514072,0.248694091941715,0.733290888306877
1,"Schleswig-Holstein",1060035,"Hasenkrug",352,178,174,0.505681818181818,345,176,169,0.510144927536232,0.0180150197514072,0.248694091941715,0.733290888306877
1,"Schleswig-Holstein",1060036,"Hasenmoor",698,352,346,0.504297994269341,725,379,346,0.522758620689655,0.0180150197514072,0.248694091941715,0.733290888306877
1,"Schleswig-Holstein",1060037,"Heidmoor",322,156,166,0.484472049689441,326,160,166,0.49079754601227,0.0180150197514072,0.248694091941715,0.733290888306877
1,"Schleswig-Holstein",1060038,"Heidmühlen",713,334,379,0.468443197755961,716,335,381,0.467877094972067,0.0180150197514072,0.248694091941715,0.733290888306877
1,"Schleswig-Holstein",1060039,"Henstedt-Ulzburg",26990,13428,13562,0.497517599110782,27510,13645,13865,0.496001454016721,0.0180150197514072,0.248694091941715,0.733290888306877
1,"Schleswig-Holstein",1060040,"Hitzhusen",1280,646,634,0.5046875,1316,667,649,0.506838905775076,0.0180150197514072,0.248694091941715,0.733290888306877
1,"Schleswig-Holstein",1060041,"Högersdorf",408,210,198,0.514705882352941,394,204,190,0.517766497461929,0.0180150197514072,0.248694091941715,0.733290888306877
1,"Schleswig-Holstein",1060042,"Hüttblek",364,182,182,0.5,366,187,179,0.510928961748634,0.0180150197514072,0.248694091941715,0.733290888306877
1,"Schleswig-Holstein",1060043,"Itzstedt",2365,1190,1175,0.503171247357294,2232,1124,1108,0.503584229390681,0.0180150197514072,0.248694091941715,0.733290888306877
1,"Schleswig-Holstein",1060044,"Kaltenkirchen, Stadt",19747,9664,10083,0.489390793538259,20104,9881,10223,0.491494230003979,0.0180150197514072,0.248694091941715,0.733290888306877
1,"Schleswig-Holstein",1060045,"Kattendorf",868,438,430,0.504608294930876,855,435,420,0.508771929824561,0.0180150197514072,0.248694091941715,0.733290888306877
1,"Schleswig-Holstein",1060046,"Kayhude",1143,561,582,0.490813648293963,1120,557,563,0.497321428571429,0.0180150197514072,0.248694091941715,0.733290888306877
1,"Schleswig-Holstein",1060047,"Kisdorf",3731,1844,1887,0.494237469847226,3749,1867,1882,0.497999466524407,0.0180150197514072,0.248694091941715,0.733290888306877
1,"Schleswig-Holstein",1060048,"Klein Gladebrügge",569,276,293,0.48506151142355,566,289,277,0.510600706713781,0.0180150197514072,0.248694091941715,0.733290888306877
1,"Schleswig-Holstein",1060049,"Klein Rönnau",1512,725,787,0.479497354497354,1505,728,777,0.483720930232558,0.0180150197514072,0.248694091941715,0.733290888306877
1,"Schleswig-Holstein",1060050,"Krems II",421,218,203,0.517814726840855,428,223,205,0.521028037383178,0.0180150197514072,0.248694091941715,0.733290888306877
1,"Schleswig-Holstein",1060051,"Kükels",452,232,220,0.513274336283186,439,233,206,0.530751708428246,0.0180150197514072,0.248694091941715,0.733290888306877
1,"Schleswig-Holstein",1060052,"Latendorf",586,299,287,0.510238907849829,585,294,291,0.502564102564103,0.0180150197514072,0.248694091941715,0.733290888306877
1,"Schleswig-Holstein",1060053,"Leezen",1749,859,890,0.491137793024585,1712,842,870,0.491822429906542,0.0180150197514072,0.248694091941715,0.733290888306877
1,"Schleswig-Holstein",1060054,"Lentföhrden",2377,1199,1178,0.504417332772402,2372,1194,1178,0.503372681281619,0.0180150197514072,0.248694091941715,0.733290888306877
1,"Schleswig-Holstein",1060056,"Mönkloh",239,120,119,0.502092050209205,242,116,126,0.479338842975207,0.0180150197514072,0.248694091941715,0.733290888306877
1,"Schleswig-Holstein",1060057,"Mözen",430,219,211,0.509302325581395,439,228,211,0.519362186788155,0.0180150197514072,0.248694091941715,0.733290888306877
1,"Schleswig-Holstein",1060058,"Nahe",2370,1189,1181,0.50168776371308,2438,1214,1224,0.497949138638228,0.0180150197514072,0.248694091941715,0.733290888306877
1,"Schleswig-Holstein",1060059,"Negernbötel",1001,494,507,0.493506493506494,1065,521,544,0.489201877934272,0.0180150197514072,0.248694091941715,0.733290888306877
1,"Schleswig-Holstein",1060060,"Nehms",562,290,272,0.516014234875445,565,293,272,0.51858407079646,0.0180150197514072,0.248694091941715,0.733290888306877
1,"Schleswig-Holstein",1060061,"Neuengörs",780,391,389,0.501282051282051,789,395,394,0.50063371356147,0.0180150197514072,0.248694091941715,0.733290888306877
1,"Schleswig-Holstein",1060062,"Neversdorf",699,350,349,0.50071530758226,737,364,373,0.493894165535957,0.0180150197514072,0.248694091941715,0.733290888306877
1,"Schleswig-Holstein",1060063,"Norderstedt, Stadt",74094,35536,38558,0.479606985720841,72436,34919,37517,0.482066928046828,0.0180150197514072,0.248694091941715,0.733290888306877
1,"Schleswig-Holstein",1060064,"Nützen",1161,600,561,0.516795865633075,1200,609,591,0.5075,0.0180150197514072,0.248694091941715,0.733290888306877
1,"Schleswig-Holstein",1060065,"Oering",1302,671,631,0.515360983102919,1301,664,637,0.510376633358955,0.0180150197514072,0.248694091941715,0.733290888306877
1,"Schleswig-Holstein",1060066,"Oersdorf",832,431,401,0.518028846153846,855,442,413,0.516959064327485,0.0180150197514072,0.248694091941715,0.733290888306877
1,"Schleswig-Holstein",1060067,"Pronstorf",1639,805,834,0.491153142159854,1698,813,885,0.478798586572438,0.0180150197514072,0.248694091941715,0.733290888306877
1,"Schleswig-Holstein",1060068,"Rickling",3219,1684,1535,0.523143833488661,3195,1672,1523,0.523317683881064,0.0180150197514072,0.248694091941715,0.733290888306877
1,"Schleswig-Holstein",1060069,"Rohlstorf",1201,592,609,0.492922564529559,1206,606,600,0.502487562189055,0.0180150197514072,0.248694091941715,0.733290888306877
1,"Schleswig-Holstein",1060070,"Schackendorf",786,410,376,0.521628498727735,839,442,397,0.526817640047676,0.0180150197514072,0.248694091941715,0.733290888306877
1,"Schleswig-Holstein",1060071,"Schieren",287,147,140,0.51219512195122,284,145,139,0.51056338028169,0.0180150197514072,0.248694091941715,0.733290888306877
1,"Schleswig-Holstein",1060072,"Schmalensee",453,222,231,0.490066225165563,465,231,234,0.496774193548387,0.0180150197514072,0.248694091941715,0.733290888306877
1,"Schleswig-Holstein",1060073,"Schmalfeld",1884,950,934,0.504246284501062,1897,977,920,0.515023721665788,0.0180150197514072,0.248694091941715,0.733290888306877
1,"Schleswig-Holstein",1060074,"Schwissel",249,125,124,0.502008032128514,252,124,128,0.492063492063492,0.0180150197514072,0.248694091941715,0.733290888306877
1,"Schleswig-Holstein",1060075,"Seedorf",2167,1045,1122,0.482233502538071,2196,1054,1142,0.479963570127505,0.0180150197514072,0.248694091941715,0.733290888306877
1,"Schleswig-Holstein",1060076,"Seth",1945,992,953,0.510025706940874,1933,995,938,0.514743921365753,0.0180150197514072,0.248694091941715,0.733290888306877
1,"Schleswig-Holstein",1060077,"Sievershütten",1174,573,601,0.488074957410562,1180,575,605,0.48728813559322,0.0180150197514072,0.248694091941715,0.733290888306877
1,"Schleswig-Holstein",1060079,"Stipsdorf",210,119,91,0.566666666666667,223,138,85,0.618834080717489,0.0180150197514072,0.248694091941715,0.733290888306877
1,"Schleswig-Holstein",1060080,"Stocksee",408,213,195,0.522058823529412,430,227,203,0.527906976744186,0.0180150197514072,0.248694091941715,0.733290888306877
1,"Schleswig-Holstein",1060081,"Strukdorf",254,125,129,0.492125984251969,249,125,124,0.502008032128514,0.0180150197514072,0.248694091941715,0.733290888306877
1,"Schleswig-Holstein",1060082,"Struvenhütten",1015,521,494,0.513300492610837,1050,543,507,0.517142857142857,0.0180150197514072,0.248694091941715,0.733290888306877
1,"Schleswig-Holstein",1060084,"Stuvenborn",871,445,426,0.510907003444317,897,461,436,0.513935340022297,0.0180150197514072,0.248694091941715,0.733290888306877
1,"Schleswig-Holstein",1060085,"Sülfeld",3226,1580,1646,0.489770613763174,3387,1663,1724,0.490994980808975,0.0180150197514072,0.248694091941715,0.733290888306877
1,"Schleswig-Holstein",1060086,"Tarbek",163,83,80,0.50920245398773,163,88,75,0.539877300613497,0.0180150197514072,0.248694091941715,0.733290888306877
1,"Schleswig-Holstein",1060087,"Tensfeld",734,348,386,0.474114441416894,707,344,363,0.486562942008487,0.0180150197514072,0.248694091941715,0.733290888306877
1,"Schleswig-Holstein",1060088,"Todesfelde",1024,529,495,0.5166015625,1024,532,492,0.51953125,0.0180150197514072,0.248694091941715,0.733290888306877
1,"Schleswig-Holstein",1060089,"Trappenkamp",5078,2512,2566,0.494682946041749,5001,2496,2505,0.499100179964007,0.0180150197514072,0.248694091941715,0.733290888306877
1,"Schleswig-Holstein",1060090,"Travenhorst",220,100,120,0.454545454545455,201,92,109,0.45771144278607,0.0180150197514072,0.248694091941715,0.733290888306877
1,"Schleswig-Holstein",1060091,"Traventhal",497,258,239,0.519114688128773,497,255,242,0.51307847082495,0.0180150197514072,0.248694091941715,0.733290888306877
1,"Schleswig-Holstein",1060092,"Wahlstedt, Stadt",9317,4543,4774,0.487603305785124,9210,4497,4713,0.488273615635179,0.0180150197514072,0.248694091941715,0.733290888306877
1,"Schleswig-Holstein",1060093,"Wakendorf I",427,206,221,0.482435597189696,416,197,219,0.473557692307692,0.0180150197514072,0.248694091941715,0.733290888306877
1,"Schleswig-Holstein",1060094,"Wakendorf II",1368,655,713,0.478801169590643,1393,674,719,0.483847810480976,0.0180150197514072,0.248694091941715,0.733290888306877
1,"Schleswig-Holstein",1060095,"Weddelbrook",1032,507,525,0.491279069767442,1041,505,536,0.485110470701249,0.0180150197514072,0.248694091941715,0.733290888306877
1,"Schleswig-Holstein",1060096,"Weede",1027,518,509,0.504381694255112,1028,522,506,0.507782101167315,0.0180150197514072,0.248694091941715,0.733290888306877
1,"Schleswig-Holstein",1060097,"Wensin",853,419,434,0.491207502930832,818,398,420,0.486552567237164,0.0180150197514072,0.248694091941715,0.733290888306877
1,"Schleswig-Holstein",1060098,"Westerrade",475,243,232,0.511578947368421,464,233,231,0.502155172413793,0.0180150197514072,0.248694091941715,0.733290888306877
1,"Schleswig-Holstein",1060099,"Wiemersdorf",1554,769,785,0.494851994851995,1562,777,785,0.497439180537772,0.0180150197514072,0.248694091941715,0.733290888306877
1,"Schleswig-Holstein",1060100,"Winsen",423,219,204,0.517730496453901,386,215,171,0.55699481865285,0.0180150197514072,0.248694091941715,0.733290888306877
1,"Schleswig-Holstein",1060101,"Wittenborn",848,445,403,0.524764150943396,832,440,392,0.528846153846154,0.0180150197514072,0.248694091941715,0.733290888306877
1,"Schleswig-Holstein",1061001,"Aasbüttel",118,67,51,0.567796610169492,109,66,43,0.605504587155963,0.0180150197514072,0.248694091941715,0.733290888306877
1,"Schleswig-Holstein",1061002,"Aebtissinwisch",61,37,24,0.60655737704918,60,39,21,0.65,0.0180150197514072,0.248694091941715,0.733290888306877
1,"Schleswig-Holstein",1061003,"Agethorst",206,101,105,0.490291262135922,199,107,92,0.537688442211055,0.0180150197514072,0.248694091941715,0.733290888306877
1,"Schleswig-Holstein",1061004,"Altenmoor",238,120,118,0.504201680672269,259,130,129,0.501930501930502,0.0180150197514072,0.248694091941715,0.733290888306877
1,"Schleswig-Holstein",1061005,"Auufer",146,71,75,0.486301369863014,140,70,70,0.5,0.0180150197514072,0.248694091941715,0.733290888306877
1,"Schleswig-Holstein",1061006,"Bahrenfleth",576,297,279,0.515625,600,322,278,0.536666666666667,0.0180150197514072,0.248694091941715,0.733290888306877
1,"Schleswig-Holstein",1061007,"Beidenfleth",850,425,425,0.5,875,455,420,0.52,0.0180150197514072,0.248694091941715,0.733290888306877
1,"Schleswig-Holstein",1061008,"Bekdorf",106,54,52,0.509433962264151,100,47,53,0.47,0.0180150197514072,0.248694091941715,0.733290888306877
1,"Schleswig-Holstein",1061010,"Bekmünde",157,73,84,0.464968152866242,164,76,88,0.463414634146341,0.0180150197514072,0.248694091941715,0.733290888306877
1,"Schleswig-Holstein",1061011,"Besdorf",248,133,115,0.536290322580645,241,130,111,0.539419087136929,0.0180150197514072,0.248694091941715,0.733290888306877
1,"Schleswig-Holstein",1061012,"Blomesche Wildnis",660,327,333,0.495454545454545,669,331,338,0.494768310911809,0.0180150197514072,0.248694091941715,0.733290888306877
1,"Schleswig-Holstein",1061013,"Bokelrehm",148,79,69,0.533783783783784,143,77,66,0.538461538461538,0.0180150197514072,0.248694091941715,0.733290888306877
1,"Schleswig-Holstein",1061014,"Bokhorst",151,83,68,0.549668874172185,126,63,63,0.5,0.0180150197514072,0.248694091941715,0.733290888306877
1,"Schleswig-Holstein",1061015,"Borsfleth",767,391,376,0.509778357235984,778,390,388,0.501285347043702,0.0180150197514072,0.248694091941715,0.733290888306877
1,"Schleswig-Holstein",1061016,"Breitenberg",347,171,176,0.492795389048991,373,187,186,0.501340482573727,0.0180150197514072,0.248694091941715,0.733290888306877
1,"Schleswig-Holstein",1061017,"Breitenburg",942,465,477,0.493630573248408,979,504,475,0.514811031664964,0.0180150197514072,0.248694091941715,0.733290888306877
1,"Schleswig-Holstein",1061018,"Brokdorf",1000,511,489,0.511,980,490,490,0.5,0.0180150197514072,0.248694091941715,0.733290888306877
1,"Schleswig-Holstein",1061019,"Brokstedt",2098,1051,1047,0.50095328884652,2127,1067,1060,0.501645510108134,0.0180150197514072,0.248694091941715,0.733290888306877
1,"Schleswig-Holstein",1061020,"Büttel",36,18,18,0.5,36,21,15,0.583333333333333,0.0180150197514072,0.248694091941715,0.733290888306877
1,"Schleswig-Holstein",1061021,"Christinenthal",59,27,32,0.457627118644068,49,22,27,0.448979591836735,0.0180150197514072,0.248694091941715,0.733290888306877
1,"Schleswig-Holstein",1061022,"Dägeling",1029,521,508,0.506316812439261,1018,503,515,0.494106090373281,0.0180150197514072,0.248694091941715,0.733290888306877
1,"Schleswig-Holstein",1061023,"Dammfleth",297,154,143,0.518518518518518,292,148,144,0.506849315068493,0.0180150197514072,0.248694091941715,0.733290888306877
1,"Schleswig-Holstein",1061024,"Drage",250,132,118,0.528,253,136,117,0.537549407114625,0.0180150197514072,0.248694091941715,0.733290888306877
1,"Schleswig-Holstein",1061025,"Ecklak",327,163,164,0.498470948012232,307,150,157,0.488599348534202,0.0180150197514072,0.248694091941715,0.733290888306877
1,"Schleswig-Holstein",1061026,"Elskop",155,80,75,0.516129032258065,155,79,76,0.509677419354839,0.0180150197514072,0.248694091941715,0.733290888306877
1,"Schleswig-Holstein",1061027,"Engelbrechtsche Wildnis",918,514,404,0.559912854030501,915,493,422,0.53879781420765,0.0180150197514072,0.248694091941715,0.733290888306877
1,"Schleswig-Holstein",1061028,"Fitzbek",364,183,181,0.502747252747253,367,184,183,0.501362397820163,0.0180150197514072,0.248694091941715,0.733290888306877
1,"Schleswig-Holstein",1061029,"Glückstadt, Stadt",11137,5391,5746,0.484062135224926,11478,5733,5745,0.499477260846837,0.0180150197514072,0.248694091941715,0.733290888306877
1,"Schleswig-Holstein",1061030,"Grevenkop",320,167,153,0.521875,334,178,156,0.532934131736527,0.0180150197514072,0.248694091941715,0.733290888306877
1,"Schleswig-Holstein",1061031,"Gribbohm",452,243,209,0.537610619469027,443,232,211,0.523702031602709,0.0180150197514072,0.248694091941715,0.733290888306877
1,"Schleswig-Holstein",1061033,"Hadenfeld",136,74,62,0.544117647058823,125,65,60,0.52,0.0180150197514072,0.248694091941715,0.733290888306877
1,"Schleswig-Holstein",1061034,"Heiligenstedten",1558,745,813,0.478177150192555,1608,769,839,0.478233830845771,0.0180150197514072,0.248694091941715,0.733290888306877
1,"Schleswig-Holstein",1061035,"Heiligenstedtenerkamp",727,357,370,0.491059147180193,711,352,359,0.49507735583685,0.0180150197514072,0.248694091941715,0.733290888306877
1,"Schleswig-Holstein",1061036,"Hennstedt",588,298,290,0.506802721088435,591,304,287,0.514382402707276,0.0180150197514072,0.248694091941715,0.733290888306877
1,"Schleswig-Holstein",1061037,"Herzhorn",1077,561,516,0.520891364902507,1052,551,501,0.523764258555133,0.0180150197514072,0.248694091941715,0.733290888306877
1,"Schleswig-Holstein",1061038,"Hingstheide",77,43,34,0.558441558441558,71,39,32,0.549295774647887,0.0180150197514072,0.248694091941715,0.733290888306877
1,"Schleswig-Holstein",1061039,"Hodorf",224,117,107,0.522321428571429,217,114,103,0.525345622119816,0.0180150197514072,0.248694091941715,0.733290888306877
1,"Schleswig-Holstein",1061040,"Hohenaspe",2016,1012,1004,0.501984126984127,2032,1024,1008,0.503937007874016,0.0180150197514072,0.248694091941715,0.733290888306877
1,"Schleswig-Holstein",1061041,"Hohenfelde",906,449,457,0.495584988962472,900,436,464,0.484444444444444,0.0180150197514072,0.248694091941715,0.733290888306877
1,"Schleswig-Holstein",1061042,"Hohenlockstedt",6084,2964,3120,0.487179487179487,6012,2949,3063,0.490518962075848,0.0180150197514072,0.248694091941715,0.733290888306877
1,"Schleswig-Holstein",1061043,"Holstenniendorf",420,208,212,0.495238095238095,416,207,209,0.497596153846154,0.0180150197514072,0.248694091941715,0.733290888306877
1,"Schleswig-Holstein",1061044,"Horst (Holstein)",5324,2600,2724,0.488354620586026,5249,2561,2688,0.487902457610974,0.0180150197514072,0.248694091941715,0.733290888306877
1,"Schleswig-Holstein",1061045,"Huje",260,130,130,0.5,251,125,126,0.49800796812749,0.0180150197514072,0.248694091941715,0.733290888306877
1,"Schleswig-Holstein",1061046,"Itzehoe, Stadt",30964,14570,16394,0.470546441028291,32405,15550,16855,0.479864218484802,0.0180150197514072,0.248694091941715,0.733290888306877
1,"Schleswig-Holstein",1061047,"Kaaks",425,208,217,0.489411764705882,414,204,210,0.492753623188406,0.0180150197514072,0.248694091941715,0.733290888306877
1,"Schleswig-Holstein",1061048,"Kaisborstel",78,36,42,0.461538461538462,77,35,42,0.454545454545455,0.0180150197514072,0.248694091941715,0.733290888306877
1,"Schleswig-Holstein",1061049,"Kellinghusen, Stadt",7810,3821,3989,0.489244558258643,7792,3795,3997,0.487037987679671,0.0180150197514072,0.248694091941715,0.733290888306877
1,"Schleswig-Holstein",1061050,"Kiebitzreihe",2194,1085,1109,0.494530537830447,2187,1076,1111,0.491998171010517,0.0180150197514072,0.248694091941715,0.733290888306877
1,"Schleswig-Holstein",1061052,"Kleve",579,290,289,0.500863557858377,563,287,276,0.509769094138544,0.0180150197514072,0.248694091941715,0.733290888306877
1,"Schleswig-Holstein",1061053,"Kollmoor",36,17,19,0.472222222222222,33,15,18,0.454545454545455,0.0180150197514072,0.248694091941715,0.733290888306877
1,"Schleswig-Holstein",1061054,"Krempdorf",245,123,122,0.502040816326531,263,131,132,0.498098859315589,0.0180150197514072,0.248694091941715,0.733290888306877
1,"Schleswig-Holstein",1061055,"Krempe, Stadt",2373,1150,1223,0.484618626211547,2374,1150,1224,0.48441449031171,0.0180150197514072,0.248694091941715,0.733290888306877
1,"Schleswig-Holstein",1061056,"Kremperheide",2453,1215,1238,0.495311863024868,2462,1211,1251,0.491876523151909,0.0180150197514072,0.248694091941715,0.733290888306877
1,"Schleswig-Holstein",1061057,"Krempermoor",528,273,255,0.517045454545455,537,274,263,0.51024208566108,0.0180150197514072,0.248694091941715,0.733290888306877
1,"Schleswig-Holstein",1061058,"Kronsmoor",186,94,92,0.505376344086022,183,89,94,0.486338797814208,0.0180150197514072,0.248694091941715,0.733290888306877
1,"Schleswig-Holstein",1061059,"Krummendiek",77,42,35,0.545454545454545,79,43,36,0.544303797468354,0.0180150197514072,0.248694091941715,0.733290888306877
1,"Schleswig-Holstein",1061060,"Kudensee",140,66,74,0.471428571428571,143,72,71,0.503496503496504,0.0180150197514072,0.248694091941715,0.733290888306877
1,"Schleswig-Holstein",1061061,"Lägerdorf",2596,1289,1307,0.49653312788906,2553,1271,1282,0.497845671758715,0.0180150197514072,0.248694091941715,0.733290888306877
1,"Schleswig-Holstein",1061062,"Landrecht",130,64,66,0.492307692307692,135,63,72,0.466666666666667,0.0180150197514072,0.248694091941715,0.733290888306877
1,"Schleswig-Holstein",1061063,"Landscheide",249,128,121,0.514056224899598,224,118,106,0.526785714285714,0.0180150197514072,0.248694091941715,0.733290888306877
1,"Schleswig-Holstein",1061064,"Lockstedt",176,85,91,0.482954545454545,183,94,89,0.513661202185792,0.0180150197514072,0.248694091941715,0.733290888306877
1,"Schleswig-Holstein",1061065,"Lohbarbek",698,367,331,0.525787965616046,731,385,346,0.526675786593707,0.0180150197514072,0.248694091941715,0.733290888306877
1,"Schleswig-Holstein",1061066,"Looft",379,196,183,0.517150395778364,374,192,182,0.513368983957219,0.0180150197514072,0.248694091941715,0.733290888306877
1,"Schleswig-Holstein",1061067,"Mehlbek",449,221,228,0.492204899777283,439,218,221,0.496583143507973,0.0180150197514072,0.248694091941715,0.733290888306877
1,"Schleswig-Holstein",1061068,"Moordiek",116,58,58,0.5,110,52,58,0.472727272727273,0.0180150197514072,0.248694091941715,0.733290888306877
1,"Schleswig-Holstein",1061070,"Moorhusen",84,47,37,0.55952380952381,73,41,32,0.561643835616438,0.0180150197514072,0.248694091941715,0.733290888306877
1,"Schleswig-Holstein",1061071,"Mühlenbarbek",321,155,166,0.482866043613707,322,159,163,0.493788819875776,0.0180150197514072,0.248694091941715,0.733290888306877
1,"Schleswig-Holstein",1061072,"Münsterdorf",1921,925,996,0.481520041644977,1941,935,1006,0.481710458526533,0.0180150197514072,0.248694091941715,0.733290888306877
1,"Schleswig-Holstein",1061073,"Neuenbrook",657,327,330,0.497716894977169,655,330,325,0.50381679389313,0.0180150197514072,0.248694091941715,0.733290888306877
1,"Schleswig-Holstein",1061074,"Neuendorf b. Elmshorn",882,438,444,0.496598639455782,899,444,455,0.493882091212458,0.0180150197514072,0.248694091941715,0.733290888306877
1,"Schleswig-Holstein",1061076,"Nienbüttel",129,69,60,0.534883720930233,135,76,59,0.562962962962963,0.0180150197514072,0.248694091941715,0.733290888306877
1,"Schleswig-Holstein",1061077,"Nortorf",893,440,453,0.492721164613662,839,419,420,0.499404052443385,0.0180150197514072,0.248694091941715,0.733290888306877
1,"Schleswig-Holstein",1061078,"Nutteln",257,125,132,0.486381322957198,265,129,136,0.486792452830189,0.0180150197514072,0.248694091941715,0.733290888306877
1,"Schleswig-Holstein",1061079,"Oelixdorf",1472,736,736,0.5,1637,937,700,0.572388515577276,0.0180150197514072,0.248694091941715,0.733290888306877
1,"Schleswig-Holstein",1061080,"Oeschebüttel",170,80,90,0.470588235294118,182,91,91,0.5,0.0180150197514072,0.248694091941715,0.733290888306877
1,"Schleswig-Holstein",1061081,"Oldenborstel",131,66,65,0.50381679389313,116,60,56,0.517241379310345,0.0180150197514072,0.248694091941715,0.733290888306877
1,"Schleswig-Holstein",1061082,"Oldendorf",1112,549,563,0.493705035971223,1132,556,576,0.491166077738516,0.0180150197514072,0.248694091941715,0.733290888306877
1,"Schleswig-Holstein",1061083,"Ottenbüttel",750,388,362,0.517333333333333,745,389,356,0.522147651006711,0.0180150197514072,0.248694091941715,0.733290888306877
1,"Schleswig-Holstein",1061084,"Peissen",301,147,154,0.488372093023256,287,142,145,0.494773519163763,0.0180150197514072,0.248694091941715,0.733290888306877
1,"Schleswig-Holstein",1061085,"Pöschendorf",266,134,132,0.503759398496241,269,137,132,0.509293680297398,0.0180150197514072,0.248694091941715,0.733290888306877
1,"Schleswig-Holstein",1061086,"Poyenberg",398,200,198,0.50251256281407,383,195,188,0.509138381201044,0.0180150197514072,0.248694091941715,0.733290888306877
1,"Schleswig-Holstein",1061087,"Puls",603,314,289,0.520729684908789,607,320,287,0.527182866556837,0.0180150197514072,0.248694091941715,0.733290888306877
1,"Schleswig-Holstein",1061088,"Quarnstedt",445,209,236,0.469662921348315,429,207,222,0.482517482517482,0.0180150197514072,0.248694091941715,0.733290888306877
1,"Schleswig-Holstein",1061089,"Rade",103,53,50,0.514563106796116,101,48,53,0.475247524752475,0.0180150197514072,0.248694091941715,0.733290888306877
1,"Schleswig-Holstein",1061091,"Reher",775,405,370,0.52258064516129,758,389,369,0.513192612137203,0.0180150197514072,0.248694091941715,0.733290888306877
1,"Schleswig-Holstein",1061092,"Rethwisch",590,297,293,0.503389830508475,576,284,292,0.493055555555556,0.0180150197514072,0.248694091941715,0.733290888306877
1,"Schleswig-Holstein",1061093,"Rosdorf",366,175,191,0.478142076502732,351,159,192,0.452991452991453,0.0180150197514072,0.248694091941715,0.733290888306877
1,"Schleswig-Holstein",1061095,"Sankt Margarethen",880,456,424,0.518181818181818,929,504,425,0.542518837459634,0.0180150197514072,0.248694091941715,0.733290888306877
1,"Schleswig-Holstein",1061096,"Sarlhusen",481,245,236,0.509355509355509,503,252,251,0.500994035785288,0.0180150197514072,0.248694091941715,0.733290888306877
1,"Schleswig-Holstein",1061097,"Schenefeld",2414,1202,1212,0.497928748964375,2406,1190,1216,0.494596841230258,0.0180150197514072,0.248694091941715,0.733290888306877
1,"Schleswig-Holstein",1061098,"Schlotfeld",227,111,116,0.488986784140969,228,112,116,0.491228070175439,0.0180150197514072,0.248694091941715,0.733290888306877
1,"Schleswig-Holstein",1061099,"Siezbüttel",64,34,30,0.53125,60,34,26,0.566666666666667,0.0180150197514072,0.248694091941715,0.733290888306877
1,"Schleswig-Holstein",1061100,"Silzen",157,76,81,0.484076433121019,164,85,79,0.518292682926829,0.0180150197514072,0.248694091941715,0.733290888306877
1,"Schleswig-Holstein",1061101,"Sommerland",812,421,391,0.518472906403941,813,418,395,0.514145141451415,0.0180150197514072,0.248694091941715,0.733290888306877
1,"Schleswig-Holstein",1061102,"Stördorf",128,69,59,0.5390625,127,69,58,0.543307086614173,0.0180150197514072,0.248694091941715,0.733290888306877
1,"Schleswig-Holstein",1061103,"Störkathen",96,46,50,0.479166666666667,101,52,49,0.514851485148515,0.0180150197514072,0.248694091941715,0.733290888306877
1,"Schleswig-Holstein",1061104,"Süderau",743,370,373,0.497981157469717,756,386,370,0.510582010582011,0.0180150197514072,0.248694091941715,0.733290888306877
1,"Schleswig-Holstein",1061105,"Vaale",1241,621,620,0.500402900886382,1219,605,614,0.49630844954881,0.0180150197514072,0.248694091941715,0.733290888306877
1,"Schleswig-Holstein",1061106,"Vaalermoor",160,79,81,0.49375,148,76,72,0.513513513513513,0.0180150197514072,0.248694091941715,0.733290888306877
1,"Schleswig-Holstein",1061107,"Wacken",1835,906,929,0.493732970027248,1797,882,915,0.490818030050083,0.0180150197514072,0.248694091941715,0.733290888306877
1,"Schleswig-Holstein",1061108,"Warringholz",293,151,142,0.515358361774744,291,150,141,0.515463917525773,0.0180150197514072,0.248694091941715,0.733290888306877
1,"Schleswig-Holstein",1061109,"Westermoor",400,194,206,0.485,390,190,200,0.487179487179487,0.0180150197514072,0.248694091941715,0.733290888306877
1,"Schleswig-Holstein",1061110,"Wewelsfleth",1451,772,679,0.532046864231564,1473,810,663,0.54989816700611,0.0180150197514072,0.248694091941715,0.733290888306877
1,"Schleswig-Holstein",1061111,"Wiedenborstel",12,5,7,0.416666666666667,9,3,6,0.333333333333333,0.0180150197514072,0.248694091941715,0.733290888306877
1,"Schleswig-Holstein",1061112,"Willenscharen",159,78,81,0.490566037735849,146,66,80,0.452054794520548,0.0180150197514072,0.248694091941715,0.733290888306877
1,"Schleswig-Holstein",1061113,"Wilster, Stadt",4441,2180,2261,0.49088043233506,4464,2212,2252,0.495519713261649,0.0180150197514072,0.248694091941715,0.733290888306877
1,"Schleswig-Holstein",1061114,"Winseldorf",319,161,158,0.504702194357367,308,159,149,0.516233766233766,0.0180150197514072,0.248694091941715,0.733290888306877
1,"Schleswig-Holstein",1061115,"Wittenbergen",164,90,74,0.548780487804878,174,92,82,0.528735632183908,0.0180150197514072,0.248694091941715,0.733290888306877
1,"Schleswig-Holstein",1061116,"Wrist",2422,1210,1212,0.499587118084228,2435,1223,1212,0.502258726899384,0.0180150197514072,0.248694091941715,0.733290888306877
1,"Schleswig-Holstein",1061117,"Wulfsmoor",389,199,190,0.511568123393316,392,195,197,0.497448979591837,0.0180150197514072,0.248694091941715,0.733290888306877
1,"Schleswig-Holstein",1061118,"Kollmar",1703,865,838,0.5079271873165,1705,863,842,0.506158357771261,0.0180150197514072,0.248694091941715,0.733290888306877
1,"Schleswig-Holstein",1061119,"Neuendorf-Sachsenbande",485,255,230,0.525773195876289,469,253,216,0.539445628997868,0.0180150197514072,0.248694091941715,0.733290888306877
1,"Schleswig-Holstein",1062001,"Ahrensburg, Stadt",31327,14712,16615,0.469626839467552,31242,14727,16515,0.471384674476666,0.0180150197514072,0.248694091941715,0.733290888306877
1,"Schleswig-Holstein",1062003,"Badendorf",781,379,402,0.48527528809219,759,377,382,0.496706192358366,0.0180150197514072,0.248694091941715,0.733290888306877
1,"Schleswig-Holstein",1062004,"Bad Oldesloe, Stadt",24337,11718,12619,0.481489090684965,24461,11811,12650,0.482850251420629,0.0180150197514072,0.248694091941715,0.733290888306877
1,"Schleswig-Holstein",1062005,"Bargfeld-Stegen",2852,1440,1412,0.504908835904628,2942,1495,1447,0.508157715839565,0.0180150197514072,0.248694091941715,0.733290888306877
1,"Schleswig-Holstein",1062006,"Bargteheide, Stadt",15281,7297,7984,0.477521104639749,15428,7374,8054,0.477962146746176,0.0180150197514072,0.248694091941715,0.733290888306877
1,"Schleswig-Holstein",1062008,"Barnitz",843,438,405,0.519572953736655,823,427,396,0.518833535844471,0.0180150197514072,0.248694091941715,0.733290888306877
1,"Schleswig-Holstein",1062009,"Barsbüttel",11852,5747,6105,0.484897063786703,12434,6126,6308,0.492681357567959,0.0180150197514072,0.248694091941715,0.733290888306877
1,"Schleswig-Holstein",1062011,"Braak",923,473,450,0.512459371614301,846,426,420,0.50354609929078,0.0180150197514072,0.248694091941715,0.733290888306877
1,"Schleswig-Holstein",1062014,"Delingsdorf",2165,1098,1067,0.50715935334873,2194,1110,1084,0.505925250683683,0.0180150197514072,0.248694091941715,0.733290888306877
1,"Schleswig-Holstein",1062016,"Elmenhorst",2509,1251,1258,0.498605021921084,2514,1246,1268,0.495624502784407,0.0180150197514072,0.248694091941715,0.733290888306877
1,"Schleswig-Holstein",1062018,"Glinde, Stadt",17027,8293,8734,0.487049979444412,17398,8459,8939,0.486205310955282,0.0180150197514072,0.248694091941715,0.733290888306877
1,"Schleswig-Holstein",1062019,"Grabau",785,376,409,0.478980891719745,788,382,406,0.484771573604061,0.0180150197514072,0.248694091941715,0.733290888306877
1,"Schleswig-Holstein",1062020,"Grande",632,315,317,0.498417721518987,681,335,346,0.491923641703377,0.0180150197514072,0.248694091941715,0.733290888306877
1,"Schleswig-Holstein",1062021,"Grönwohld",1343,668,675,0.497393894266567,1357,680,677,0.501105379513633,0.0180150197514072,0.248694091941715,0.733290888306877
1,"Schleswig-Holstein",1062022,"Großensee",1653,809,844,0.489413188142771,1736,871,865,0.501728110599078,0.0180150197514072,0.248694091941715,0.733290888306877
1,"Schleswig-Holstein",1062023,"Großhansdorf",9236,4302,4934,0.465786054569078,9231,4312,4919,0.467121655291951,0.0180150197514072,0.248694091941715,0.733290888306877
1,"Schleswig-Holstein",1062025,"Hamberge",1499,753,746,0.502334889926618,1461,735,726,0.503080082135524,0.0180150197514072,0.248694091941715,0.733290888306877
1,"Schleswig-Holstein",1062026,"Hamfelde",473,232,241,0.490486257928118,481,249,232,0.517671517671518,0.0180150197514072,0.248694091941715,0.733290888306877
1,"Schleswig-Holstein",1062027,"Hammoor",1184,584,600,0.493243243243243,1218,588,630,0.482758620689655,0.0180150197514072,0.248694091941715,0.733290888306877
1,"Schleswig-Holstein",1062031,"Heidekamp",463,230,233,0.496760259179266,461,231,230,0.501084598698482,0.0180150197514072,0.248694091941715,0.733290888306877
1,"Schleswig-Holstein",1062032,"Heilshoop",577,271,306,0.469670710571924,590,282,308,0.477966101694915,0.0180150197514072,0.248694091941715,0.733290888306877
1,"Schleswig-Holstein",1062033,"Hohenfelde",53,26,27,0.490566037735849,47,26,21,0.553191489361702,0.0180150197514072,0.248694091941715,0.733290888306877
1,"Schleswig-Holstein",1062035,"Hoisdorf",3506,1735,1771,0.494865944095836,3382,1686,1696,0.498521584861029,0.0180150197514072,0.248694091941715,0.733290888306877
1,"Schleswig-Holstein",1062036,"Jersbek",1730,850,880,0.491329479768786,1777,888,889,0.499718626899268,0.0180150197514072,0.248694091941715,0.733290888306877
1,"Schleswig-Holstein",1062039,"Klein Wesenberg",743,359,384,0.483176312247645,762,362,400,0.4750656167979,0.0180150197514072,0.248694091941715,0.733290888306877
1,"Schleswig-Holstein",1062040,"Köthel",328,169,159,0.515243902439024,313,153,160,0.488817891373802,0.0180150197514072,0.248694091941715,0.733290888306877
1,"Schleswig-Holstein",1062045,"Lütjensee",3254,1517,1737,0.46619545175169,3213,1479,1734,0.46031746031746,0.0180150197514072,0.248694091941715,0.733290888306877
1,"Schleswig-Holstein",1062046,"Meddewade",785,395,390,0.503184713375796,767,391,376,0.509778357235984,0.0180150197514072,0.248694091941715,0.733290888306877
1,"Schleswig-Holstein",1062048,"Mönkhagen",652,323,329,0.495398773006135,624,302,322,0.483974358974359,0.0180150197514072,0.248694091941715,0.733290888306877
1,"Schleswig-Holstein",1062050,"Neritz",315,153,162,0.485714285714286,311,151,160,0.485530546623794,0.0180150197514072,0.248694091941715,0.733290888306877
1,"Schleswig-Holstein",1062051,"Nienwohld",463,225,238,0.485961123110151,463,229,234,0.494600431965443,0.0180150197514072,0.248694091941715,0.733290888306877
1,"Schleswig-Holstein",1062053,"Oststeinbek",8615,4211,4404,0.488798607080673,8662,4236,4426,0.489032555991688,0.0180150197514072,0.248694091941715,0.733290888306877
1,"Schleswig-Holstein",1062056,"Pölitz",1165,597,568,0.51244635193133,1190,623,567,0.523529411764706,0.0180150197514072,0.248694091941715,0.733290888306877
1,"Schleswig-Holstein",1062058,"Rausdorf",222,112,110,0.504504504504504,228,115,113,0.504385964912281,0.0180150197514072,0.248694091941715,0.733290888306877
1,"Schleswig-Holstein",1062059,"Rehhorst",701,350,351,0.499286733238231,682,346,336,0.50733137829912,0.0180150197514072,0.248694091941715,0.733290888306877
1,"Schleswig-Holstein",1062060,"Reinbek, Stadt",26203,12749,13454,0.486547341907415,25813,12604,13209,0.488281098671212,0.0180150197514072,0.248694091941715,0.733290888306877
1,"Schleswig-Holstein",1062061,"Reinfeld (Holstein), Stadt",8716,4288,4428,0.491968793024323,8553,4208,4345,0.491991114228925,0.0180150197514072,0.248694091941715,0.733290888306877
1,"Schleswig-Holstein",1062062,"Rethwisch",1087,538,549,0.494940202391904,1042,530,512,0.508637236084453,0.0180150197514072,0.248694091941715,0.733290888306877
1,"Schleswig-Holstein",1062065,"Rümpel",1301,636,665,0.488854727132975,1296,653,643,0.503858024691358,0.0180150197514072,0.248694091941715,0.733290888306877
1,"Schleswig-Holstein",1062069,"Siek",2204,1102,1102,0.5,2062,1044,1018,0.506304558680892,0.0180150197514072,0.248694091941715,0.733290888306877
1,"Schleswig-Holstein",1062071,"Stapelfeld",1653,818,835,0.494857834240774,1579,792,787,0.501583280557315,0.0180150197514072,0.248694091941715,0.733290888306877
1,"Schleswig-Holstein",1062076,"Tangstedt",6280,3120,3160,0.496815286624204,6332,3181,3151,0.502368919772584,0.0180150197514072,0.248694091941715,0.733290888306877
1,"Schleswig-Holstein",1062078,"Todendorf",1143,572,571,0.500437445319335,1130,569,561,0.50353982300885,0.0180150197514072,0.248694091941715,0.733290888306877
1,"Schleswig-Holstein",1062081,"Tremsbüttel",1925,968,957,0.502857142857143,1941,974,967,0.501803194229778,0.0180150197514072,0.248694091941715,0.733290888306877
1,"Schleswig-Holstein",1062082,"Trittau",8035,3833,4202,0.477037958929683,7832,3759,4073,0.479954034729316,0.0180150197514072,0.248694091941715,0.733290888306877
1,"Schleswig-Holstein",1062083,"Westerau",773,383,390,0.495472186287193,776,394,382,0.507731958762887,0.0180150197514072,0.248694091941715,0.733290888306877
1,"Schleswig-Holstein",1062086,"Witzhave",1398,702,696,0.502145922746781,1426,709,717,0.497194950911641,0.0180150197514072,0.248694091941715,0.733290888306877
1,"Schleswig-Holstein",1062087,"Zarpen",1448,713,735,0.492403314917127,1429,718,711,0.502449265220434,0.0180150197514072,0.248694091941715,0.733290888306877
1,"Schleswig-Holstein",1062088,"Brunsbek",1708,839,869,0.491217798594848,1648,818,830,0.496359223300971,0.0180150197514072,0.248694091941715,0.733290888306877
1,"Schleswig-Holstein",1062089,"Lasbek",1197,585,612,0.488721804511278,1175,582,593,0.49531914893617,0.0180150197514072,0.248694091941715,0.733290888306877
1,"Schleswig-Holstein",1062090,"Ammersbek",9722,4786,4936,0.492285537955153,9442,4657,4785,0.493221775047659,0.0180150197514072,0.248694091941715,0.733290888306877
1,"Schleswig-Holstein",1062091,"Steinburg",2590,1302,1288,0.502702702702703,2501,1248,1253,0.499000399840064,0.0180150197514072,0.248694091941715,0.733290888306877
1,"Schleswig-Holstein",1062092,"Travenbrück",1731,894,837,0.516464471403813,1708,878,830,0.514051522248244,0.0180150197514072,0.248694091941715,0.733290888306877
1,"Schleswig-Holstein",1062093,"Feldhorst",592,299,293,0.505067567567568,591,305,286,0.516074450084602,0.0180150197514072,0.248694091941715,0.733290888306877
1,"Schleswig-Holstein",1062094,"Wesenberg",1396,705,691,0.505014326647565,1350,695,655,0.514814814814815,0.0180150197514072,0.248694091941715,0.733290888306877
2,"Hamburg",2000000,"Hamburg, Freie und Hansestadt",1718187,832587,885600,0.484572983033861,1798836,880972,917864,0.48974559103776,0.00114365736958805,0.149095577080173,0.849760765550239
3,"Niedersachsen",3101000,"Braunschweig, Stadt",243829,119194,124635,0.488842590504001,250556,123934,126622,0.494635929692364,0.0181416918634609,0.320561556335495,0.661296751801044
3,"Niedersachsen",3102000,"Salzgitter, Stadt",98588,48089,50499,0.487777417129874,101750,49935,51815,0.490761670761671,0.0181416918634609,0.320561556335495,0.661296751801044
3,"Niedersachsen",3103000,"Wolfsburg, Stadt",120889,59342,61547,0.490880063529353,122583,60370,62213,0.492482644412357,0.0181416918634609,0.320561556335495,0.661296751801044
3,"Niedersachsen",3151001,"Adenbüttel",1762,894,868,0.507377979568672,1767,902,865,0.510469722693831,0.0181416918634609,0.320561556335495,0.661296751801044
3,"Niedersachsen",3151002,"Barwedel",1045,541,504,0.517703349282297,1088,548,540,0.503676470588235,0.0181416918634609,0.320561556335495,0.661296751801044
3,"Niedersachsen",3151003,"Bergfeld",895,443,452,0.494972067039106,897,441,456,0.491638795986622,0.0181416918634609,0.320561556335495,0.661296751801044
3,"Niedersachsen",3151004,"Bokensdorf",980,497,483,0.507142857142857,941,483,458,0.513283740701381,0.0181416918634609,0.320561556335495,0.661296751801044
3,"Niedersachsen",3151005,"Brome, Flecken",3196,1576,1620,0.493116395494368,3220,1584,1636,0.491925465838509,0.0181416918634609,0.320561556335495,0.661296751801044
3,"Niedersachsen",3151006,"Calberlah",5024,2507,2517,0.499004777070064,5056,2527,2529,0.499802215189873,0.0181416918634609,0.320561556335495,0.661296751801044
3,"Niedersachsen",3151007,"Dedelstorf",1292,643,649,0.497678018575851,1513,759,754,0.501652346331791,0.0181416918634609,0.320561556335495,0.661296751801044
3,"Niedersachsen",3151008,"Ehra-Lessien",1645,801,844,0.48693009118541,1638,811,827,0.495115995115995,0.0181416918634609,0.320561556335495,0.661296751801044
3,"Niedersachsen",3151009,"Gifhorn, Stadt",41183,20249,20934,0.491683461622514,41555,20584,20971,0.495343520635303,0.0181416918634609,0.320561556335495,0.661296751801044
3,"Niedersachsen",3151010,"Groß Oesingen",1898,978,920,0.515279241306639,1862,956,906,0.513426423200859,0.0181416918634609,0.320561556335495,0.661296751801044
3,"Niedersachsen",3151011,"Hankensbüttel",4328,2154,2174,0.497689463955638,4298,2131,2167,0.495812005583993,0.0181416918634609,0.320561556335495,0.661296751801044
3,"Niedersachsen",3151012,"Hillerse",2494,1244,1250,0.498797113071371,2509,1262,1247,0.502989238740534,0.0181416918634609,0.320561556335495,0.661296751801044
3,"Niedersachsen",3151013,"Isenbüttel",6326,3202,3124,0.506165033196333,6232,3114,3118,0.499679075738126,0.0181416918634609,0.320561556335495,0.661296751801044
3,"Niedersachsen",3151014,"Jembke",1872,921,951,0.491987179487179,1959,987,972,0.503828483920367,0.0181416918634609,0.320561556335495,0.661296751801044
3,"Niedersachsen",3151015,"Leiferde",4292,2108,2184,0.491146318732526,4274,2109,2165,0.493448759943847,0.0181416918634609,0.320561556335495,0.661296751801044
3,"Niedersachsen",3151016,"Meine",8211,4019,4192,0.489465351357934,8193,4020,4173,0.490662760893446,0.0181416918634609,0.320561556335495,0.661296751801044
3,"Niedersachsen",3151017,"Meinersen",8215,4082,4133,0.496895922093731,8130,4051,4079,0.498277982779828,0.0181416918634609,0.320561556335495,0.661296751801044
3,"Niedersachsen",3151018,"Müden (Aller)",5431,2707,2724,0.498434910697846,5603,2805,2798,0.500624665357844,0.0181416918634609,0.320561556335495,0.661296751801044
3,"Niedersachsen",3151019,"Obernholz",915,457,458,0.499453551912568,909,458,451,0.503850385038504,0.0181416918634609,0.320561556335495,0.661296751801044
3,"Niedersachsen",3151020,"Osloß",1898,964,934,0.507903055848261,1906,981,925,0.514690451206716,0.0181416918634609,0.320561556335495,0.661296751801044
3,"Niedersachsen",3151021,"Parsau",1833,939,894,0.51227495908347,1842,956,886,0.51900108577633,0.0181416918634609,0.320561556335495,0.661296751801044
3,"Niedersachsen",3151022,"Ribbesbüttel",2090,1061,1029,0.507655502392344,2119,1084,1035,0.511562057574327,0.0181416918634609,0.320561556335495,0.661296751801044
3,"Niedersachsen",3151023,"Rötgesbüttel",2233,1119,1114,0.501119570085087,2280,1147,1133,0.503070175438596,0.0181416918634609,0.320561556335495,0.661296751801044
3,"Niedersachsen",3151024,"Rühen",4862,2488,2374,0.5117235705471,4891,2497,2394,0.510529544060519,0.0181416918634609,0.320561556335495,0.661296751801044
3,"Niedersachsen",3151025,"Sassenburg",10784,5396,5388,0.500370919881306,10940,5483,5457,0.501188299817185,0.0181416918634609,0.320561556335495,0.661296751801044
3,"Niedersachsen",3151026,"Schönewörde",904,431,473,0.476769911504425,900,435,465,0.483333333333333,0.0181416918634609,0.320561556335495,0.661296751801044
3,"Niedersachsen",3151027,"Schwülper",6837,3332,3505,0.487348252157379,6814,3343,3471,0.490607572644555,0.0181416918634609,0.320561556335495,0.661296751801044
3,"Niedersachsen",3151028,"Sprakensehl",1260,639,621,0.507142857142857,1295,653,642,0.504247104247104,0.0181416918634609,0.320561556335495,0.661296751801044
3,"Niedersachsen",3151029,"Steinhorst",1289,639,650,0.495733126454616,1338,651,687,0.486547085201794,0.0181416918634609,0.320561556335495,0.661296751801044
3,"Niedersachsen",3151030,"Tappenbeck",1351,655,696,0.484826054774241,1358,661,697,0.486745213549337,0.0181416918634609,0.320561556335495,0.661296751801044
3,"Niedersachsen",3151031,"Tiddische",1266,632,634,0.499210110584518,1285,639,646,0.49727626459144,0.0181416918634609,0.320561556335495,0.661296751801044
3,"Niedersachsen",3151032,"Tülau",1513,750,763,0.495703899537343,1515,764,751,0.504290429042904,0.0181416918634609,0.320561556335495,0.661296751801044
3,"Niedersachsen",3151033,"Ummern",1554,808,746,0.51994851994852,1545,801,744,0.518446601941748,0.0181416918634609,0.320561556335495,0.661296751801044
3,"Niedersachsen",3151034,"Vordorf",3082,1555,1527,0.504542504866969,3180,1597,1583,0.502201257861635,0.0181416918634609,0.320561556335495,0.661296751801044
3,"Niedersachsen",3151035,"Wagenhoff",1135,571,564,0.503083700440529,1130,562,568,0.497345132743363,0.0181416918634609,0.320561556335495,0.661296751801044
3,"Niedersachsen",3151036,"Wahrenholz",3641,1810,1831,0.497116176874485,3655,1815,1840,0.496580027359781,0.0181416918634609,0.320561556335495,0.661296751801044
3,"Niedersachsen",3151037,"Wasbüttel",1864,938,926,0.503218884120172,1863,929,934,0.498658078368223,0.0181416918634609,0.320561556335495,0.661296751801044
3,"Niedersachsen",3151038,"Wesendorf",5024,2454,2570,0.488455414012739,4998,2441,2557,0.488395358143257,0.0181416918634609,0.320561556335495,0.661296751801044
3,"Niedersachsen",3151039,"Weyhausen",2491,1238,1253,0.496989160979526,2587,1281,1306,0.49516814843448,0.0181416918634609,0.320561556335495,0.661296751801044
3,"Niedersachsen",3151040,"Wittingen, Stadt",11640,5764,5876,0.495189003436426,11603,5840,5763,0.503318107386021,0.0181416918634609,0.320561556335495,0.661296751801044
3,"Niedersachsen",3151041,"Didderse",1310,653,657,0.498473282442748,1322,660,662,0.499243570347958,0.0181416918634609,0.320561556335495,0.661296751801044
3,"Niedersachsen",3152001,"Adelebsen, Flecken",6563,3242,3321,0.493981410940119,6449,3202,3247,0.496511086990231,0.0181416918634609,0.320561556335495,0.661296751801044
3,"Niedersachsen",3152002,"Bilshausen",2348,1185,1163,0.504684838160136,2348,1181,1167,0.502981260647359,0.0181416918634609,0.320561556335495,0.661296751801044
3,"Niedersachsen",3152003,"Bodensee",835,430,405,0.514970059880239,767,398,369,0.51890482398957,0.0181416918634609,0.320561556335495,0.661296751801044
3,"Niedersachsen",3152004,"Bovenden, Flecken",13255,6475,6780,0.488494907582045,13381,6536,6845,0.488453777744563,0.0181416918634609,0.320561556335495,0.661296751801044
3,"Niedersachsen",3152005,"Bühren",567,277,290,0.488536155202822,527,250,277,0.47438330170778,0.0181416918634609,0.320561556335495,0.661296751801044
3,"Niedersachsen",3152006,"Dransfeld, Stadt",4293,2102,2191,0.489634288376427,4010,1933,2077,0.482044887780549,0.0181416918634609,0.320561556335495,0.661296751801044
3,"Niedersachsen",3152007,"Duderstadt, Stadt",21209,10319,10890,0.486538733556509,21609,10586,11023,0.489888472395761,0.0181416918634609,0.320561556335495,0.661296751801044
3,"Niedersachsen",3152008,"Ebergötzen",1945,954,991,0.490488431876607,1790,854,936,0.477094972067039,0.0181416918634609,0.320561556335495,0.661296751801044
3,"Niedersachsen",3152009,"Friedland",7529,3770,3759,0.500730508699694,11395,5460,5935,0.479157525230364,0.0181416918634609,0.320561556335495,0.661296751801044
3,"Niedersachsen",3152010,"Gieboldehausen, Flecken",4140,2041,2099,0.492995169082126,3944,1940,2004,0.491886409736308,0.0181416918634609,0.320561556335495,0.661296751801044
3,"Niedersachsen",3152011,"Gleichen",9145,4528,4617,0.49513395297977,9163,4562,4601,0.497871876023137,0.0181416918634609,0.320561556335495,0.661296751801044
3,"Niedersachsen",3152012,"Göttingen, Stadt",116052,55758,60294,0.480457036500879,121364,58864,62500,0.485020269602188,0.0181416918634609,0.320561556335495,0.661296751801044
3,"Niedersachsen",3152013,"Jühnde",1021,515,506,0.504407443682664,1062,535,527,0.50376647834275,0.0181416918634609,0.320561556335495,0.661296751801044
3,"Niedersachsen",3152014,"Krebeck",1088,540,548,0.496323529411765,1116,567,549,0.508064516129032,0.0181416918634609,0.320561556335495,0.661296751801044
3,"Niedersachsen",3152015,"Landolfshausen",1087,539,548,0.495860165593376,1132,552,580,0.487632508833922,0.0181416918634609,0.320561556335495,0.661296751801044
3,"Niedersachsen",3152016,"Hann. Münden, Stadt",23785,11440,12345,0.480975404666807,24390,11902,12488,0.487986879868799,0.0181416918634609,0.320561556335495,0.661296751801044
3,"Niedersachsen",3152017,"Niemetal",1524,770,754,0.505249343832021,1596,821,775,0.514411027568922,0.0181416918634609,0.320561556335495,0.661296751801044
3,"Niedersachsen",3152018,"Obernfeld",961,484,477,0.503642039542144,972,492,480,0.506172839506173,0.0181416918634609,0.320561556335495,0.661296751801044
3,"Niedersachsen",3152019,"Rhumspringe",1884,954,930,0.506369426751592,1883,964,919,0.511949017525226,0.0181416918634609,0.320561556335495,0.661296751801044
3,"Niedersachsen",3152020,"Rollshausen",864,437,427,0.505787037037037,901,459,442,0.509433962264151,0.0181416918634609,0.320561556335495,0.661296751801044
3,"Niedersachsen",3152021,"Rosdorf",11721,5820,5901,0.496544663424622,12005,6016,5989,0.501124531445231,0.0181416918634609,0.320561556335495,0.661296751801044
3,"Niedersachsen",3152022,"Rüdershausen",871,426,445,0.489092996555683,868,420,448,0.483870967741935,0.0181416918634609,0.320561556335495,0.661296751801044
3,"Niedersachsen",3152023,"Scheden",1915,975,940,0.509138381201044,1963,996,967,0.507386653082017,0.0181416918634609,0.320561556335495,0.661296751801044
3,"Niedersachsen",3152024,"Seeburg",1620,810,810,0.5,1601,801,800,0.500312304809494,0.0181416918634609,0.320561556335495,0.661296751801044
3,"Niedersachsen",3152025,"Seulingen",1377,677,700,0.491648511256354,1369,669,700,0.488677867056245,0.0181416918634609,0.320561556335495,0.661296751801044
3,"Niedersachsen",3152026,"Staufenberg",7998,3907,4091,0.48849712428107,8080,3963,4117,0.490470297029703,0.0181416918634609,0.320561556335495,0.661296751801044
3,"Niedersachsen",3152027,"Waake",1313,642,671,0.488956587966489,1390,680,710,0.489208633093525,0.0181416918634609,0.320561556335495,0.661296751801044
3,"Niedersachsen",3152028,"Wollbrandshausen",652,308,344,0.47239263803681,612,293,319,0.478758169934641,0.0181416918634609,0.320561556335495,0.661296751801044
3,"Niedersachsen",3152029,"Wollershausen",463,251,212,0.542116630669546,479,243,236,0.507306889352818,0.0181416918634609,0.320561556335495,0.661296751801044
3,"Niedersachsen",3153001,"Altenau, Bergstadt",1615,804,811,0.497832817337461,1770,891,879,0.503389830508475,0.0181416918634609,0.320561556335495,0.661296751801044
3,"Niedersachsen",3153002,"Bad Harzburg, Stadt",21965,10040,11925,0.457090826314591,21813,10074,11739,0.461834685737863,0.0181416918634609,0.320561556335495,0.661296751801044
3,"Niedersachsen",3153004,"Clausthal-Zellerfeld, Bergstadt",12798,7161,5637,0.559540553211439,14840,8815,6025,0.59400269541779,0.0181416918634609,0.320561556335495,0.661296751801044
3,"Niedersachsen",3153005,"Goslar, Stadt",40700,19384,21316,0.476265356265356,40704,19639,21065,0.482483294025157,0.0181416918634609,0.320561556335495,0.661296751801044
3,"Niedersachsen",3153006,"Hahausen",817,416,401,0.509179926560588,841,425,416,0.505350772889417,0.0181416918634609,0.320561556335495,0.661296751801044
3,"Niedersachsen",3153007,"Langelsheim, Stadt",11973,5862,6111,0.489601603608118,12105,5965,6140,0.492771581990913,0.0181416918634609,0.320561556335495,0.661296751801044
3,"Niedersachsen",3153008,"Liebenburg",8465,4197,4268,0.495806261075015,8620,4241,4379,0.49199535962877,0.0181416918634609,0.320561556335495,0.661296751801044
3,"Niedersachsen",3153009,"Lutter am Barenberge, Flecken",2449,1179,1270,0.481420988158432,2290,1100,1190,0.480349344978166,0.0181416918634609,0.320561556335495,0.661296751801044
3,"Niedersachsen",3153011,"Schulenberg im Oberharz",259,132,127,0.50965250965251,276,133,143,0.481884057971014,0.0181416918634609,0.320561556335495,0.661296751801044
3,"Niedersachsen",3153012,"Seesen, Stadt",19739,9519,10220,0.482243274735296,20034,9710,10324,0.484676050713787,0.0181416918634609,0.320561556335495,0.661296751801044
3,"Niedersachsen",3153013,"Vienenburg, Stadt",10668,5218,5450,0.489126359205099,10557,5114,5443,0.484417921758075,0.0181416918634609,0.320561556335495,0.661296751801044
3,"Niedersachsen",3153014,"Wallmoden",965,489,476,0.506735751295337,967,493,474,0.509824198552223,0.0181416918634609,0.320561556335495,0.661296751801044
3,"Niedersachsen",3153015,"Wildemann, Bergstadt",946,464,482,0.490486257928118,1014,492,522,0.485207100591716,0.0181416918634609,0.320561556335495,0.661296751801044
3,"Niedersachsen",3153016,"Braunlage, Stadt",6216,3029,3187,0.487290862290862,6280,3061,3219,0.487420382165605,0.0181416918634609,0.320561556335495,0.661296751801044
3,"Niedersachsen",3154001,"Bahrdorf",1898,960,938,0.505795574288725,1959,994,965,0.507401735579377,0.0181416918634609,0.320561556335495,0.661296751801044
3,"Niedersachsen",3154002,"Beierstedt",412,199,213,0.483009708737864,406,194,212,0.477832512315271,0.0181416918634609,0.320561556335495,0.661296751801044
3,"Niedersachsen",3154003,"Büddenstedt",2642,1284,1358,0.485995457986374,2709,1327,1382,0.48984865263935,0.0181416918634609,0.320561556335495,0.661296751801044
3,"Niedersachsen",3154004,"Danndorf",2118,1066,1052,0.503305004721435,2106,1055,1051,0.500949667616334,0.0181416918634609,0.320561556335495,0.661296751801044
3,"Niedersachsen",3154005,"Frellstedt",831,434,397,0.522262334536703,826,435,391,0.526634382566586,0.0181416918634609,0.320561556335495,0.661296751801044
3,"Niedersachsen",3154006,"Gevensleben",665,339,326,0.509774436090226,658,330,328,0.501519756838906,0.0181416918634609,0.320561556335495,0.661296751801044
3,"Niedersachsen",3154007,"Grafhorst",995,485,510,0.487437185929648,982,482,500,0.490835030549898,0.0181416918634609,0.320561556335495,0.661296751801044
3,"Niedersachsen",3154008,"Grasleben",2467,1201,1266,0.486826104580462,2441,1187,1254,0.48627611634576,0.0181416918634609,0.320561556335495,0.661296751801044
3,"Niedersachsen",3154009,"Groß Twülpstedt",2575,1315,1260,0.510679611650485,2620,1336,1284,0.509923664122137,0.0181416918634609,0.320561556335495,0.661296751801044
3,"Niedersachsen",3154010,"Helmstedt, Stadt",23084,11083,12001,0.480116097730029,23686,11469,12217,0.484210081904923,0.0181416918634609,0.320561556335495,0.661296751801044
3,"Niedersachsen",3154011,"Ingeleben",394,194,200,0.49238578680203,407,199,208,0.488943488943489,0.0181416918634609,0.320561556335495,0.661296751801044
3,"Niedersachsen",3154012,"Jerxheim",1179,545,634,0.46225614927905,1140,519,621,0.455263157894737,0.0181416918634609,0.320561556335495,0.661296751801044
3,"Niedersachsen",3154013,"Königslutter am Elm, Stadt",15579,7619,7960,0.489055780216959,15666,7695,7971,0.491191114515511,0.0181416918634609,0.320561556335495,0.661296751801044
3,"Niedersachsen",3154014,"Lehre",11520,5712,5808,0.495833333333333,11466,5788,5678,0.504796790511076,0.0181416918634609,0.320561556335495,0.661296751801044
3,"Niedersachsen",3154015,"Mariental",892,438,454,0.491031390134529,977,485,492,0.496417604912999,0.0181416918634609,0.320561556335495,0.661296751801044
3,"Niedersachsen",3154016,"Querenhorst",525,266,259,0.506666666666667,536,274,262,0.511194029850746,0.0181416918634609,0.320561556335495,0.661296751801044
3,"Niedersachsen",3154017,"Räbke",678,341,337,0.502949852507375,683,338,345,0.494875549048316,0.0181416918634609,0.320561556335495,0.661296751801044
3,"Niedersachsen",3154018,"Rennau",684,344,340,0.502923976608187,707,358,349,0.506364922206506,0.0181416918634609,0.320561556335495,0.661296751801044
3,"Niedersachsen",3154019,"Schöningen, Stadt",11542,5666,5876,0.490902789811125,11847,5836,6011,0.492614163923356,0.0181416918634609,0.320561556335495,0.661296751801044
3,"Niedersachsen",3154020,"Söllingen",668,329,339,0.49251497005988,656,325,331,0.495426829268293,0.0181416918634609,0.320561556335495,0.661296751801044
3,"Niedersachsen",3154021,"Süpplingen",1701,841,860,0.494415049970606,1739,847,892,0.487061529614721,0.0181416918634609,0.320561556335495,0.661296751801044
3,"Niedersachsen",3154022,"Süpplingenburg",651,329,322,0.505376344086022,656,333,323,0.507621951219512,0.0181416918634609,0.320561556335495,0.661296751801044
3,"Niedersachsen",3154023,"Twieflingen",743,373,370,0.502018842530283,736,371,365,0.504076086956522,0.0181416918634609,0.320561556335495,0.661296751801044
3,"Niedersachsen",3154024,"Velpke",4596,2274,2322,0.494778067885117,4565,2252,2313,0.493318729463308,0.0181416918634609,0.320561556335495,0.661296751801044
3,"Niedersachsen",3154025,"Warberg",885,448,437,0.506214689265537,854,425,429,0.497658079625293,0.0181416918634609,0.320561556335495,0.661296751801044
3,"Niedersachsen",3154026,"Wolsdorf",995,502,493,0.504522613065327,1034,519,515,0.501934235976789,0.0181416918634609,0.320561556335495,0.661296751801044
3,"Niedersachsen",3155001,"Bad Gandersheim, Stadt",9998,4849,5149,0.48499699939988,10235,4922,5313,0.480898876404494,0.0181416918634609,0.320561556335495,0.661296751801044
3,"Niedersachsen",3155002,"Bodenfelde, Flecken",3304,1654,1650,0.500605326876513,3285,1649,1636,0.501978691019787,0.0181416918634609,0.320561556335495,0.661296751801044
3,"Niedersachsen",3155003,"Dassel, Stadt",10151,5006,5145,0.493153383903064,10022,4925,5097,0.491418878467372,0.0181416918634609,0.320561556335495,0.661296751801044
3,"Niedersachsen",3155004,"Einbeck, Stadt",25301,12196,13105,0.482036283150864,26239,12757,13482,0.486184686916422,0.0181416918634609,0.320561556335495,0.661296751801044
3,"Niedersachsen",3155005,"Hardegsen, Stadt",7891,3865,4026,0.489798504625523,7997,3911,4086,0.489058396898837,0.0181416918634609,0.320561556335495,0.661296751801044
3,"Niedersachsen",3155006,"Kalefeld",6692,3343,3349,0.499551703526599,6735,3386,3349,0.502746844840386,0.0181416918634609,0.320561556335495,0.661296751801044
3,"Niedersachsen",3155007,"Katlenburg-Lindau",7267,3638,3629,0.500619237649649,7181,3592,3589,0.500208884556469,0.0181416918634609,0.320561556335495,0.661296751801044
3,"Niedersachsen",3155008,"Kreiensen",6720,3315,3405,0.493303571428571,6846,3356,3490,0.490213263219398,0.0181416918634609,0.320561556335495,0.661296751801044
3,"Niedersachsen",3155009,"Moringen, Stadt",7233,3707,3526,0.512512097331674,7184,3641,3543,0.506820712694877,0.0181416918634609,0.320561556335495,0.661296751801044
3,"Niedersachsen",3155010,"Nörten-Hardenberg, Flecken",8196,4068,4128,0.496339677891654,8246,4092,4154,0.496240601503759,0.0181416918634609,0.320561556335495,0.661296751801044
3,"Niedersachsen",3155011,"Northeim, Stadt",29087,14084,15003,0.484202564719634,29145,14132,15013,0.48488591525133,0.0181416918634609,0.320561556335495,0.661296751801044
3,"Niedersachsen",3155012,"Uslar, Stadt",14676,7162,7514,0.488007631507223,14543,7091,7452,0.487588530564533,0.0181416918634609,0.320561556335495,0.661296751801044
3,"Niedersachsen",3156001,"Bad Grund (Harz), Bergstadt",2430,1205,1225,0.495884773662551,2336,1162,1174,0.497431506849315,0.0181416918634609,0.320561556335495,0.661296751801044
3,"Niedersachsen",3156002,"Bad Lauterberg im Harz, Stadt",10919,5187,5732,0.475043502152212,11080,5249,5831,0.473736462093863,0.0181416918634609,0.320561556335495,0.661296751801044
3,"Niedersachsen",3156003,"Bad Sachsa, Stadt",7619,3626,3993,0.475915474471715,7634,3652,3982,0.478386167146974,0.0181416918634609,0.320561556335495,0.661296751801044
3,"Niedersachsen",3156004,"Badenhausen",1889,974,915,0.51561672842774,1886,983,903,0.521208907741251,0.0181416918634609,0.320561556335495,0.661296751801044
3,"Niedersachsen",3156005,"Eisdorf",1709,848,861,0.496196606202458,1706,838,868,0.491207502930832,0.0181416918634609,0.320561556335495,0.661296751801044
3,"Niedersachsen",3156006,"Elbingerode",486,237,249,0.487654320987654,417,205,212,0.491606714628297,0.0181416918634609,0.320561556335495,0.661296751801044
3,"Niedersachsen",3156007,"Gittelde, Flecken",1926,959,967,0.497923156801661,1910,956,954,0.500523560209424,0.0181416918634609,0.320561556335495,0.661296751801044
3,"Niedersachsen",3156008,"Hattorf am Harz",4175,2012,2163,0.481916167664671,4177,2019,2158,0.483361264065118,0.0181416918634609,0.320561556335495,0.661296751801044
3,"Niedersachsen",3156009,"Herzberg am Harz, Stadt",13367,6472,6895,0.484177451933867,13573,6616,6957,0.487438296618286,0.0181416918634609,0.320561556335495,0.661296751801044
3,"Niedersachsen",3156010,"Hörden am Harz",1049,522,527,0.497616777883699,1078,534,544,0.495361781076067,0.0181416918634609,0.320561556335495,0.661296751801044
3,"Niedersachsen",3156011,"Osterode am Harz, Stadt",22868,11155,11713,0.487799545216022,22987,11159,11828,0.485448296863445,0.0181416918634609,0.320561556335495,0.661296751801044
3,"Niedersachsen",3156012,"Walkenried",2317,1111,1206,0.479499352611135,2252,1090,1162,0.484014209591474,0.0181416918634609,0.320561556335495,0.661296751801044
3,"Niedersachsen",3156013,"Wieda",1382,713,669,0.515918958031838,1341,702,639,0.523489932885906,0.0181416918634609,0.320561556335495,0.661296751801044
3,"Niedersachsen",3156014,"Windhausen",1003,497,506,0.495513459621137,986,482,504,0.488843813387424,0.0181416918634609,0.320561556335495,0.661296751801044
3,"Niedersachsen",3156015,"Wulften am Harz",1928,957,971,0.496369294605809,1934,957,977,0.49482936918304,0.0181416918634609,0.320561556335495,0.661296751801044
3,"Niedersachsen",3156016,"Zorge",1105,523,582,0.473303167420814,1073,499,574,0.465051258154706,0.0181416918634609,0.320561556335495,0.661296751801044
3,"Niedersachsen",3157001,"Edemissen",12350,6077,6273,0.492064777327935,12339,6062,6277,0.491287786692601,0.0181416918634609,0.320561556335495,0.661296751801044
3,"Niedersachsen",3157002,"Hohenhameln",9049,4490,4559,0.496187424024754,9265,4711,4554,0.508472746896924,0.0181416918634609,0.320561556335495,0.661296751801044
3,"Niedersachsen",3157003,"Ilsede",11459,5553,5906,0.484597259795794,11766,5751,6015,0.488781234064253,0.0181416918634609,0.320561556335495,0.661296751801044
3,"Niedersachsen",3157004,"Lahstedt",10155,5034,5121,0.495716395864106,10233,5082,5151,0.496628554676048,0.0181416918634609,0.320561556335495,0.661296751801044
3,"Niedersachsen",3157005,"Lengede",12684,6343,6341,0.500078839482813,12859,6417,6442,0.499027918189595,0.0181416918634609,0.320561556335495,0.661296751801044
3,"Niedersachsen",3157006,"Peine, Stadt",48480,23612,24868,0.487046204620462,48558,23707,24851,0.488220272663619,0.0181416918634609,0.320561556335495,0.661296751801044
3,"Niedersachsen",3157007,"Vechelde",16026,7854,8172,0.490078622238862,16028,7871,8157,0.491078113301722,0.0181416918634609,0.320561556335495,0.661296751801044
3,"Niedersachsen",3157008,"Wendeburg",9962,4843,5119,0.486147359967878,10027,4932,5095,0.491871945746485,0.0181416918634609,0.320561556335495,0.661296751801044
3,"Niedersachsen",3158002,"Baddeckenstedt",3067,1498,1569,0.488425171177046,2891,1406,1485,0.486336907644414,0.0181416918634609,0.320561556335495,0.661296751801044
3,"Niedersachsen",3158004,"Burgdorf",2403,1193,1210,0.496462754889721,2314,1160,1154,0.501296456352636,0.0181416918634609,0.320561556335495,0.661296751801044
3,"Niedersachsen",3158005,"Cramme",943,468,475,0.496288441145281,952,474,478,0.497899159663866,0.0181416918634609,0.320561556335495,0.661296751801044
3,"Niedersachsen",3158006,"Cremlingen",12899,6340,6559,0.491510969842623,12831,6287,6544,0.489985192112852,0.0181416918634609,0.320561556335495,0.661296751801044
3,"Niedersachsen",3158007,"Dahlum",696,351,345,0.504310344827586,722,372,350,0.515235457063712,0.0181416918634609,0.320561556335495,0.661296751801044
3,"Niedersachsen",3158008,"Denkte",3026,1461,1565,0.482815598149372,3023,1466,1557,0.484948726430698,0.0181416918634609,0.320561556335495,0.661296751801044
3,"Niedersachsen",3158009,"Dettum",1158,562,596,0.485319516407599,1174,574,600,0.488926746166951,0.0181416918634609,0.320561556335495,0.661296751801044
3,"Niedersachsen",3158010,"Dorstadt",676,341,335,0.504437869822485,668,327,341,0.489520958083832,0.0181416918634609,0.320561556335495,0.661296751801044
3,"Niedersachsen",3158011,"Elbe",1598,773,825,0.483729662077597,1649,806,843,0.488781079442086,0.0181416918634609,0.320561556335495,0.661296751801044
3,"Niedersachsen",3158012,"Erkerode",968,493,475,0.509297520661157,1000,498,502,0.498,0.0181416918634609,0.320561556335495,0.661296751801044
3,"Niedersachsen",3158013,"Evessen",1279,647,632,0.505863956215794,1297,649,648,0.500385505011565,0.0181416918634609,0.320561556335495,0.661296751801044
3,"Niedersachsen",3158014,"Flöthe",1170,579,591,0.494871794871795,1181,589,592,0.498729889923793,0.0181416918634609,0.320561556335495,0.661296751801044
3,"Niedersachsen",3158015,"Gielde",792,391,401,0.493686868686869,829,399,430,0.481302774427021,0.0181416918634609,0.320561556335495,0.661296751801044
3,"Niedersachsen",3158016,"Haverlah",1611,799,812,0.495965238981999,1558,775,783,0.497432605905006,0.0181416918634609,0.320561556335495,0.661296751801044
3,"Niedersachsen",3158017,"Hedeper",515,260,255,0.504854368932039,540,274,266,0.507407407407407,0.0181416918634609,0.320561556335495,0.661296751801044
3,"Niedersachsen",3158018,"Heere",1209,601,608,0.497105045492142,1155,577,578,0.4995670995671,0.0181416918634609,0.320561556335495,0.661296751801044
3,"Niedersachsen",3158019,"Heiningen",678,350,328,0.51622418879056,664,340,324,0.512048192771084,0.0181416918634609,0.320561556335495,0.661296751801044
3,"Niedersachsen",3158020,"Hornburg, Stadt",2413,1211,1202,0.501864898466639,2452,1223,1229,0.498776508972268,0.0181416918634609,0.320561556335495,0.661296751801044
3,"Niedersachsen",3158021,"Kissenbrück",1767,873,894,0.494057724957555,1770,873,897,0.493220338983051,0.0181416918634609,0.320561556335495,0.661296751801044
3,"Niedersachsen",3158022,"Kneitlingen",841,422,419,0.501783590963139,823,426,397,0.517618469015796,0.0181416918634609,0.320561556335495,0.661296751801044
3,"Niedersachsen",3158023,"Ohrum",613,309,304,0.504078303425775,583,299,284,0.512864493996569,0.0181416918634609,0.320561556335495,0.661296751801044
3,"Niedersachsen",3158024,"Remlingen",1855,940,915,0.506738544474393,1813,921,892,0.507997793712079,0.0181416918634609,0.320561556335495,0.661296751801044
3,"Niedersachsen",3158025,"Roklum",461,232,229,0.503253796095445,460,232,228,0.504347826086956,0.0181416918634609,0.320561556335495,0.661296751801044
3,"Niedersachsen",3158026,"Schladen",5041,2418,2623,0.479666732791113,4993,2417,2576,0.484077708792309,0.0181416918634609,0.320561556335495,0.661296751801044
3,"Niedersachsen",3158027,"Schöppenstedt, Stadt",5445,2629,2816,0.482828282828283,5319,2566,2753,0.482421507802218,0.0181416918634609,0.320561556335495,0.661296751801044
3,"Niedersachsen",3158028,"Sehlde",929,462,467,0.497308934337998,912,455,457,0.49890350877193,0.0181416918634609,0.320561556335495,0.661296751801044
3,"Niedersachsen",3158029,"Semmenstedt",657,339,318,0.515981735159817,649,334,315,0.514637904468413,0.0181416918634609,0.320561556335495,0.661296751801044
3,"Niedersachsen",3158030,"Sickte",5899,2935,2964,0.497541956263774,5792,2902,2890,0.50103591160221,0.0181416918634609,0.320561556335495,0.661296751801044
3,"Niedersachsen",3158031,"Uehrde",922,459,463,0.497830802603037,947,474,473,0.500527983104541,0.0181416918634609,0.320561556335495,0.661296751801044
3,"Niedersachsen",3158032,"Vahlberg",773,408,365,0.527813712807245,781,400,381,0.512163892445583,0.0181416918634609,0.320561556335495,0.661296751801044
3,"Niedersachsen",3158033,"Veltheim (Ohe)",978,483,495,0.493865030674847,1045,525,520,0.502392344497608,0.0181416918634609,0.320561556335495,0.661296751801044
3,"Niedersachsen",3158034,"Werlaburgdorf",770,372,398,0.483116883116883,739,375,364,0.50744248985115,0.0181416918634609,0.320561556335495,0.661296751801044
3,"Niedersachsen",3158035,"Winnigstedt",735,383,352,0.52108843537415,761,403,358,0.529566360052562,0.0181416918634609,0.320561556335495,0.661296751801044
3,"Niedersachsen",3158036,"Wittmar",1200,611,589,0.509166666666667,1208,605,603,0.500827814569536,0.0181416918634609,0.320561556335495,0.661296751801044
3,"Niedersachsen",3158037,"Wolfenbüttel, Stadt",51581,25038,26543,0.485411294856633,53353,25957,27396,0.486514347834236,0.0181416918634609,0.320561556335495,0.661296751801044
3,"Niedersachsen",3158038,"Börßum",2857,1406,1451,0.492124606230312,2791,1370,1421,0.490863489788606,0.0181416918634609,0.320561556335495,0.661296751801044
3,"Niedersachsen",3241001,"Hannover, Landeshauptstadt",509485,245220,264265,0.481309557690609,525875,254872,271003,0.48466270501545,0.0181416918634609,0.320561556335495,0.661296751801044
3,"Niedersachsen",3241002,"Barsinghausen, Stadt",33062,16074,16988,0.486177484725667,33512,16268,17244,0.48543805204106,0.0181416918634609,0.320561556335495,0.661296751801044
3,"Niedersachsen",3241003,"Burgdorf, Stadt",28863,13808,15055,0.478397948931158,29833,14311,15522,0.479703683840043,0.0181416918634609,0.320561556335495,0.661296751801044
3,"Niedersachsen",3241004,"Burgwedel, Stadt",20301,9593,10708,0.47253829860598,20456,9688,10768,0.473601877199844,0.0181416918634609,0.320561556335495,0.661296751801044
3,"Niedersachsen",3241005,"Garbsen, Stadt",59516,28892,30624,0.485449290946972,61652,29974,31678,0.486180496983066,0.0181416918634609,0.320561556335495,0.661296751801044
3,"Niedersachsen",3241006,"Gehrden, Stadt",14211,6860,7351,0.482724649919077,14607,7023,7584,0.480796878209078,0.0181416918634609,0.320561556335495,0.661296751801044
3,"Niedersachsen",3241007,"Hemmingen, Stadt",18434,8933,9501,0.484593685580992,18676,8965,9711,0.480027843221247,0.0181416918634609,0.320561556335495,0.661296751801044
3,"Niedersachsen",3241008,"Isernhagen",22742,11102,11640,0.488171664761235,22990,11141,11849,0.484602000869943,0.0181416918634609,0.320561556335495,0.661296751801044
3,"Niedersachsen",3241009,"Laatzen, Stadt",39090,18634,20456,0.476694806855973,40413,19419,20994,0.480513696087893,0.0181416918634609,0.320561556335495,0.661296751801044
3,"Niedersachsen",3241010,"Langenhagen, Stadt",51045,24747,26298,0.484807522774023,53003,25804,27199,0.486840367526366,0.0181416918634609,0.320561556335495,0.661296751801044
3,"Niedersachsen",3241011,"Lehrte, Stadt",42668,20993,21675,0.492008062248055,43248,21282,21966,0.492092119866815,0.0181416918634609,0.320561556335495,0.661296751801044
3,"Niedersachsen",3241012,"Neustadt am Rübenberge, Stadt",43516,21424,22092,0.492324662193216,45008,22344,22664,0.496445076430857,0.0181416918634609,0.320561556335495,0.661296751801044
3,"Niedersachsen",3241013,"Pattensen, Stadt",13750,6678,7072,0.485672727272727,13944,6829,7115,0.489744693057946,0.0181416918634609,0.320561556335495,0.661296751801044
3,"Niedersachsen",3241014,"Ronnenberg, Stadt",23241,11267,11974,0.484789811109677,23304,11370,11934,0.487899073120494,0.0181416918634609,0.320561556335495,0.661296751801044
3,"Niedersachsen",3241015,"Seelze, Stadt",31940,15581,16359,0.487820914214152,32939,16200,16739,0.491818209417408,0.0181416918634609,0.320561556335495,0.661296751801044
3,"Niedersachsen",3241016,"Sehnde, Stadt",23021,11586,11435,0.503279614265236,23032,11570,11462,0.502344564084752,0.0181416918634609,0.320561556335495,0.661296751801044
3,"Niedersachsen",3241017,"Springe, Stadt",28473,13771,14702,0.483651178309275,29055,14178,14877,0.487971089313371,0.0181416918634609,0.320561556335495,0.661296751801044
3,"Niedersachsen",3241018,"Uetze",19880,9786,10094,0.492253521126761,20091,9914,10177,0.493454780747598,0.0181416918634609,0.320561556335495,0.661296751801044
3,"Niedersachsen",3241019,"Wedemark",28356,13725,14631,0.484024545069827,29182,14218,14964,0.487218148173532,0.0181416918634609,0.320561556335495,0.661296751801044
3,"Niedersachsen",3241020,"Wennigsen (Deister)",13955,6800,7155,0.487280544607668,14099,6835,7264,0.484786155046457,0.0181416918634609,0.320561556335495,0.661296751801044
3,"Niedersachsen",3241021,"Wunstorf, Stadt",40670,19716,20954,0.484779936070814,41048,19958,21090,0.486211264860651,0.0181416918634609,0.320561556335495,0.661296751801044
3,"Niedersachsen",3251001,"Affinghausen",843,420,423,0.498220640569395,837,411,426,0.491039426523298,0.0181416918634609,0.320561556335495,0.661296751801044
3,"Niedersachsen",3251002,"Asendorf",2910,1440,1470,0.494845360824742,2994,1491,1503,0.497995991983968,0.0181416918634609,0.320561556335495,0.661296751801044
3,"Niedersachsen",3251003,"Bahrenborstel",1095,543,552,0.495890410958904,1170,601,569,0.513675213675214,0.0181416918634609,0.320561556335495,0.661296751801044
3,"Niedersachsen",3251004,"Barenburg, Flecken",1259,648,611,0.514694201747419,1263,644,619,0.509897070467142,0.0181416918634609,0.320561556335495,0.661296751801044
3,"Niedersachsen",3251005,"Barnstorf, Flecken",6059,2997,3062,0.494636078560819,5871,2872,2999,0.489184125361949,0.0181416918634609,0.320561556335495,0.661296751801044
3,"Niedersachsen",3251006,"Barver",1025,527,498,0.514146341463415,1024,524,500,0.51171875,0.0181416918634609,0.320561556335495,0.661296751801044
3,"Niedersachsen",3251007,"Bassum, Stadt",15520,7648,7872,0.492783505154639,15818,7869,7949,0.497471235301555,0.0181416918634609,0.320561556335495,0.661296751801044
3,"Niedersachsen",3251008,"Borstel",1278,623,655,0.487480438184664,1321,636,685,0.481453444360333,0.0181416918634609,0.320561556335495,0.661296751801044
3,"Niedersachsen",3251009,"Brockum",1022,483,539,0.472602739726027,1058,496,562,0.468809073724008,0.0181416918634609,0.320561556335495,0.661296751801044
3,"Niedersachsen",3251011,"Dickel",474,236,238,0.49789029535865,496,247,249,0.497983870967742,0.0181416918634609,0.320561556335495,0.661296751801044
3,"Niedersachsen",3251012,"Diepholz, Stadt",15917,7696,8221,0.483508198781177,16709,8273,8436,0.495122389131606,0.0181416918634609,0.320561556335495,0.661296751801044
3,"Niedersachsen",3251013,"Drebber",2854,1422,1432,0.498248072880168,2864,1441,1423,0.503142458100559,0.0181416918634609,0.320561556335495,0.661296751801044
3,"Niedersachsen",3251014,"Drentwede",996,503,493,0.505020080321285,997,510,487,0.511534603811434,0.0181416918634609,0.320561556335495,0.661296751801044
3,"Niedersachsen",3251015,"Ehrenburg",1544,781,763,0.505829015544041,1564,795,769,0.508312020460358,0.0181416918634609,0.320561556335495,0.661296751801044
3,"Niedersachsen",3251017,"Eydelstedt",1782,902,880,0.506172839506173,1786,912,874,0.51063829787234,0.0181416918634609,0.320561556335495,0.661296751801044
3,"Niedersachsen",3251018,"Freistatt",565,440,125,0.778761061946903,994,876,118,0.881287726358149,0.0181416918634609,0.320561556335495,0.661296751801044
3,"Niedersachsen",3251019,"Hemsloh",561,274,287,0.488413547237077,603,290,313,0.480928689883914,0.0181416918634609,0.320561556335495,0.661296751801044
3,"Niedersachsen",3251020,"Hüde",1063,548,515,0.51552210724365,1101,570,531,0.517711171662125,0.0181416918634609,0.320561556335495,0.661296751801044
3,"Niedersachsen",3251021,"Kirchdorf",1947,942,1005,0.48382126348228,2028,1045,983,0.515285996055227,0.0181416918634609,0.320561556335495,0.661296751801044
3,"Niedersachsen",3251022,"Lembruch",1133,594,539,0.524271844660194,1129,590,539,0.522586359610275,0.0181416918634609,0.320561556335495,0.661296751801044
3,"Niedersachsen",3251023,"Lemförde, Flecken",2977,1398,1579,0.469600268726906,2849,1323,1526,0.464373464373464,0.0181416918634609,0.320561556335495,0.661296751801044
3,"Niedersachsen",3251024,"Maasen",486,250,236,0.51440329218107,515,255,260,0.495145631067961,0.0181416918634609,0.320561556335495,0.661296751801044
3,"Niedersachsen",3251025,"Marl",703,361,342,0.513513513513513,576,300,276,0.520833333333333,0.0181416918634609,0.320561556335495,0.661296751801044
3,"Niedersachsen",3251026,"Martfeld",2676,1342,1334,0.501494768310912,2765,1380,1385,0.499095840867993,0.0181416918634609,0.320561556335495,0.661296751801044
3,"Niedersachsen",3251027,"Mellinghausen",1055,526,529,0.498578199052133,1045,539,506,0.515789473684211,0.0181416918634609,0.320561556335495,0.661296751801044
3,"Niedersachsen",3251028,"Neuenkirchen",1217,624,593,0.512736236647494,1182,606,576,0.512690355329949,0.0181416918634609,0.320561556335495,0.661296751801044
3,"Niedersachsen",3251029,"Quernheim",408,210,198,0.514705882352941,437,221,216,0.505720823798627,0.0181416918634609,0.320561556335495,0.661296751801044
3,"Niedersachsen",3251030,"Rehden",1850,926,924,0.500540540540541,1794,913,881,0.50891861761427,0.0181416918634609,0.320561556335495,0.661296751801044
3,"Niedersachsen",3251031,"Scholen",804,415,389,0.516169154228856,777,397,380,0.510939510939511,0.0181416918634609,0.320561556335495,0.661296751801044
3,"Niedersachsen",3251032,"Schwaförden",1536,793,743,0.516276041666667,1446,749,697,0.517980636237898,0.0181416918634609,0.320561556335495,0.661296751801044
3,"Niedersachsen",3251033,"Schwarme",2461,1264,1197,0.513612352702154,2418,1225,1193,0.506617038875103,0.0181416918634609,0.320561556335495,0.661296751801044
3,"Niedersachsen",3251034,"Siedenburg, Flecken",1291,648,643,0.501936483346243,1255,634,621,0.505179282868526,0.0181416918634609,0.320561556335495,0.661296751801044
3,"Niedersachsen",3251035,"Staffhorst",542,276,266,0.509225092250922,564,291,273,0.515957446808511,0.0181416918634609,0.320561556335495,0.661296751801044
3,"Niedersachsen",3251036,"Stemshorn",661,328,333,0.496217851739788,699,349,350,0.49928469241774,0.0181416918634609,0.320561556335495,0.661296751801044
3,"Niedersachsen",3251037,"Stuhr",32576,15862,16714,0.486922888015717,33645,16461,17184,0.489255461435577,0.0181416918634609,0.320561556335495,0.661296751801044
3,"Niedersachsen",3251038,"Sudwalde",1060,528,532,0.49811320754717,1062,527,535,0.49623352165725,0.0181416918634609,0.320561556335495,0.661296751801044
3,"Niedersachsen",3251039,"Süstedt",1560,798,762,0.511538461538461,1541,767,774,0.497728747566515,0.0181416918634609,0.320561556335495,0.661296751801044
3,"Niedersachsen",3251040,"Sulingen, Stadt",12457,6089,6368,0.488801477081159,12628,6222,6406,0.4927146024707,0.0181416918634609,0.320561556335495,0.661296751801044
3,"Niedersachsen",3251041,"Syke, Stadt",23583,11554,12029,0.489929186278251,24279,11891,12388,0.489764817331851,0.0181416918634609,0.320561556335495,0.661296751801044
3,"Niedersachsen",3251042,"Twistringen, Stadt",12197,6114,6083,0.501270804296138,12297,6139,6158,0.499227453850533,0.0181416918634609,0.320561556335495,0.661296751801044
3,"Niedersachsen",3251043,"Varrel",1287,662,625,0.514374514374514,1309,685,624,0.523300229182582,0.0181416918634609,0.320561556335495,0.661296751801044
3,"Niedersachsen",3251044,"Wagenfeld",6992,3506,3486,0.501430205949657,6890,3422,3468,0.4966618287373,0.0181416918634609,0.320561556335495,0.661296751801044
3,"Niedersachsen",3251045,"Wehrbleck",758,392,366,0.517150395778364,759,400,359,0.527009222661397,0.0181416918634609,0.320561556335495,0.661296751801044
3,"Niedersachsen",3251046,"Wetschen",1696,877,819,0.517099056603774,1740,896,844,0.514942528735632,0.0181416918634609,0.320561556335495,0.661296751801044
3,"Niedersachsen",3251047,"Weyhe",29896,14660,15236,0.49036660422799,30308,14962,15346,0.493665038933615,0.0181416918634609,0.320561556335495,0.661296751801044
3,"Niedersachsen",3251048,"Bruchhausen-Vilsen, Flecken",7169,3486,3683,0.486260287348305,6986,3443,3543,0.492842828514171,0.0181416918634609,0.320561556335495,0.661296751801044
3,"Niedersachsen",3252001,"Aerzen, Flecken",10874,5313,5561,0.488596652565753,11071,5427,5644,0.490199620630476,0.0181416918634609,0.320561556335495,0.661296751801044
3,"Niedersachsen",3252002,"Bad Münder am Deister, Stadt",17595,8520,9075,0.484228473998295,17327,8457,8870,0.488082183874877,0.0181416918634609,0.320561556335495,0.661296751801044
3,"Niedersachsen",3252003,"Bad Pyrmont, Stadt",19085,8848,10237,0.463610165051087,20650,9489,11161,0.459515738498789,0.0181416918634609,0.320561556335495,0.661296751801044
3,"Niedersachsen",3252004,"Coppenbrügge, Flecken",7349,3580,3769,0.487141107633692,7306,3570,3736,0.488639474404599,0.0181416918634609,0.320561556335495,0.661296751801044
3,"Niedersachsen",3252005,"Emmerthal",10109,4876,5233,0.482342467108517,10377,5034,5343,0.485111303845042,0.0181416918634609,0.320561556335495,0.661296751801044
3,"Niedersachsen",3252006,"Hameln, Stadt",56433,26749,29684,0.473995711728953,57342,27666,29676,0.482473579575181,0.0181416918634609,0.320561556335495,0.661296751801044
3,"Niedersachsen",3252007,"Hessisch Oldendorf, Stadt",18458,9071,9387,0.491440026004984,18827,9297,9530,0.493812078398045,0.0181416918634609,0.320561556335495,0.661296751801044
3,"Niedersachsen",3252008,"Salzhemmendorf, Flecken",9610,4735,4875,0.492715920915713,9782,4821,4961,0.492843999182171,0.0181416918634609,0.320561556335495,0.661296751801044
3,"Niedersachsen",3254001,"Adenstedt",1018,502,516,0.493123772102161,1010,501,509,0.496039603960396,0.0181416918634609,0.320561556335495,0.661296751801044
3,"Niedersachsen",3254002,"Alfeld (Leine), Stadt",19253,9330,9923,0.484599802628162,19919,9655,10264,0.484713088006426,0.0181416918634609,0.320561556335495,0.661296751801044
3,"Niedersachsen",3254003,"Algermissen",7971,3954,4017,0.496048174633045,7892,3919,3973,0.496578813988849,0.0181416918634609,0.320561556335495,0.661296751801044
3,"Niedersachsen",3254004,"Almstedt",893,446,447,0.499440089585666,915,441,474,0.481967213114754,0.0181416918634609,0.320561556335495,0.661296751801044
3,"Niedersachsen",3254005,"Bad Salzdetfurth, Stadt",13334,6442,6892,0.483125843707815,13525,6605,6920,0.488354898336414,0.0181416918634609,0.320561556335495,0.661296751801044
3,"Niedersachsen",3254006,"Banteln",1519,738,781,0.485845951283739,1563,777,786,0.497120921305182,0.0181416918634609,0.320561556335495,0.661296751801044
3,"Niedersachsen",3254007,"Betheln",999,491,508,0.491491491491492,1008,486,522,0.482142857142857,0.0181416918634609,0.320561556335495,0.661296751801044
3,"Niedersachsen",3254008,"Bockenem, Stadt",10106,4966,5140,0.491391252721156,10464,5200,5264,0.496941896024465,0.0181416918634609,0.320561556335495,0.661296751801044
3,"Niedersachsen",3254009,"Brüggen",897,444,453,0.494983277591973,890,432,458,0.485393258426966,0.0181416918634609,0.320561556335495,0.661296751801044
3,"Niedersachsen",3254010,"Despetal",1323,644,679,0.486772486772487,1335,650,685,0.48689138576779,0.0181416918634609,0.320561556335495,0.661296751801044
3,"Niedersachsen",3254011,"Diekholzen",6687,3279,3408,0.490354419021983,6656,3251,3405,0.488431490384615,0.0181416918634609,0.320561556335495,0.661296751801044
3,"Niedersachsen",3254012,"Eberholzen",606,304,302,0.501650165016502,609,304,305,0.499178981937603,0.0181416918634609,0.320561556335495,0.661296751801044
3,"Niedersachsen",3254013,"Eime, Flecken",2684,1340,1344,0.499254843517139,2696,1343,1353,0.498145400593472,0.0181416918634609,0.320561556335495,0.661296751801044
3,"Niedersachsen",3254014,"Elze, Stadt",8921,4345,4576,0.487053020961776,8868,4313,4555,0.486355435272891,0.0181416918634609,0.320561556335495,0.661296751801044
3,"Niedersachsen",3254015,"Everode",461,230,231,0.498915401301518,479,247,232,0.515657620041754,0.0181416918634609,0.320561556335495,0.661296751801044
3,"Niedersachsen",3254016,"Freden (Leine)",3105,1527,1578,0.491787439613527,3035,1493,1542,0.491927512355848,0.0181416918634609,0.320561556335495,0.661296751801044
3,"Niedersachsen",3254017,"Giesen",9758,4797,4961,0.491596638655462,9786,4793,4993,0.489781320253423,0.0181416918634609,0.320561556335495,0.661296751801044
3,"Niedersachsen",3254018,"Gronau (Leine), Stadt",5206,2474,2732,0.475220898962735,5117,2421,2696,0.47312878639828,0.0181416918634609,0.320561556335495,0.661296751801044
3,"Niedersachsen",3254019,"Harbarnsen",577,284,293,0.492201039861352,611,313,298,0.51227495908347,0.0181416918634609,0.320561556335495,0.661296751801044
3,"Niedersachsen",3254020,"Harsum",11681,5761,5920,0.49319407584967,11663,5778,5885,0.495412844036697,0.0181416918634609,0.320561556335495,0.661296751801044
3,"Niedersachsen",3254021,"Hildesheim, Stadt",99267,46825,52442,0.471707616831374,102584,48476,54108,0.472549325430866,0.0181416918634609,0.320561556335495,0.661296751801044
3,"Niedersachsen",3254022,"Holle",7228,3520,3708,0.48699501936912,7255,3555,3700,0.49000689179876,0.0181416918634609,0.320561556335495,0.661296751801044
3,"Niedersachsen",3254023,"Lamspringe, Flecken",3059,1473,1586,0.481529911735861,2972,1419,1553,0.477456258411844,0.0181416918634609,0.320561556335495,0.661296751801044
3,"Niedersachsen",3254024,"Landwehr",548,279,269,0.509124087591241,515,265,250,0.514563106796116,0.0181416918634609,0.320561556335495,0.661296751801044
3,"Niedersachsen",3254025,"Neuhof",421,202,219,0.479809976247031,413,201,212,0.486682808716707,0.0181416918634609,0.320561556335495,0.661296751801044
3,"Niedersachsen",3254026,"Nordstemmen",12160,5939,6221,0.488404605263158,12410,6087,6323,0.490491539081386,0.0181416918634609,0.320561556335495,0.661296751801044
3,"Niedersachsen",3254027,"Rheden",1100,543,557,0.493636363636364,1128,555,573,0.492021276595745,0.0181416918634609,0.320561556335495,0.661296751801044
3,"Niedersachsen",3254028,"Sarstedt, Stadt",18204,8880,9324,0.48780487804878,18482,9078,9404,0.49118060815929,0.0181416918634609,0.320561556335495,0.661296751801044
3,"Niedersachsen",3254029,"Schellerten",8174,4049,4125,0.495351113286029,8138,4021,4117,0.494101744900467,0.0181416918634609,0.320561556335495,0.661296751801044
3,"Niedersachsen",3254030,"Sehlem",895,447,448,0.499441340782123,914,450,464,0.492341356673961,0.0181416918634609,0.320561556335495,0.661296751801044
3,"Niedersachsen",3254031,"Sibbesse",2704,1324,1380,0.489644970414201,2619,1282,1337,0.489499809087438,0.0181416918634609,0.320561556335495,0.661296751801044
3,"Niedersachsen",3254032,"Söhlde",7887,3891,3996,0.493343476607075,7855,3887,3968,0.49484404837683,0.0181416918634609,0.320561556335495,0.661296751801044
3,"Niedersachsen",3254033,"Westfeld",923,450,473,0.487540628385699,941,459,482,0.487778958554729,0.0181416918634609,0.320561556335495,0.661296751801044
3,"Niedersachsen",3254034,"Winzenburg",739,354,385,0.479025710419486,743,362,381,0.48721399730821,0.0181416918634609,0.320561556335495,0.661296751801044
3,"Niedersachsen",3254035,"Woltershausen",861,431,430,0.500580720092915,849,435,414,0.512367491166078,0.0181416918634609,0.320561556335495,0.661296751801044
3,"Niedersachsen",3254036,"Coppengrave",656,334,322,0.509146341463415,658,331,327,0.503039513677812,0.0181416918634609,0.320561556335495,0.661296751801044
3,"Niedersachsen",3254037,"Duingen, Flecken",2908,1417,1491,0.487276478679505,2875,1403,1472,0.488,0.0181416918634609,0.320561556335495,0.661296751801044
3,"Niedersachsen",3254038,"Hoyershausen",485,240,245,0.494845360824742,484,245,239,0.506198347107438,0.0181416918634609,0.320561556335495,0.661296751801044
3,"Niedersachsen",3254039,"Marienhagen",773,375,398,0.485122897800776,791,390,401,0.493046776232617,0.0181416918634609,0.320561556335495,0.661296751801044
3,"Niedersachsen",3254040,"Weenzen",392,196,196,0.5,399,200,199,0.50125313283208,0.0181416918634609,0.320561556335495,0.661296751801044
3,"Niedersachsen",3255001,"Arholzen",398,197,201,0.494974874371859,391,189,202,0.483375959079284,0.0181416918634609,0.320561556335495,0.661296751801044
3,"Niedersachsen",3255002,"Bevern, Flecken",4017,1966,2051,0.48941996514812,3946,1939,2007,0.491383679675621,0.0181416918634609,0.320561556335495,0.661296751801044
3,"Niedersachsen",3255003,"Bodenwerder, Stadt",5701,2744,2957,0.481319066830381,5546,2691,2855,0.485214569058781,0.0181416918634609,0.320561556335495,0.661296751801044
3,"Niedersachsen",3255004,"Boffzen",2854,1393,1461,0.488086895585144,2701,1301,1400,0.481673454276194,0.0181416918634609,0.320561556335495,0.661296751801044
3,"Niedersachsen",3255005,"Brevörde",692,333,359,0.48121387283237,718,342,376,0.476323119777159,0.0181416918634609,0.320561556335495,0.661296751801044
3,"Niedersachsen",3255007,"Deensen",1467,758,709,0.516700749829584,1511,774,737,0.512243547319656,0.0181416918634609,0.320561556335495,0.661296751801044
3,"Niedersachsen",3255008,"Delligsen, Flecken",8139,3998,4141,0.491215136994717,8142,4021,4121,0.493859002702039,0.0181416918634609,0.320561556335495,0.661296751801044
3,"Niedersachsen",3255009,"Derental",621,294,327,0.473429951690821,671,317,354,0.472429210134128,0.0181416918634609,0.320561556335495,0.661296751801044
3,"Niedersachsen",3255010,"Dielmissen",829,400,429,0.482509047044632,812,393,419,0.483990147783251,0.0181416918634609,0.320561556335495,0.661296751801044
3,"Niedersachsen",3255012,"Eimen",971,480,491,0.494335736354274,996,490,506,0.491967871485944,0.0181416918634609,0.320561556335495,0.661296751801044
3,"Niedersachsen",3255013,"Eschershausen, Stadt",3507,1737,1770,0.495295124037639,3415,1708,1707,0.500146412884334,0.0181416918634609,0.320561556335495,0.661296751801044
3,"Niedersachsen",3255014,"Fürstenberg",1138,544,594,0.478031634446397,1167,584,583,0.500428449014567,0.0181416918634609,0.320561556335495,0.661296751801044
3,"Niedersachsen",3255015,"Golmbach",1010,506,504,0.500990099009901,979,485,494,0.495403472931563,0.0181416918634609,0.320561556335495,0.661296751801044
3,"Niedersachsen",3255016,"Halle",1597,804,793,0.503443957420163,1590,807,783,0.507547169811321,0.0181416918634609,0.320561556335495,0.661296751801044
3,"Niedersachsen",3255017,"Hehlen",1899,954,945,0.502369668246445,1912,959,953,0.501569037656904,0.0181416918634609,0.320561556335495,0.661296751801044
3,"Niedersachsen",3255018,"Heinade",920,452,468,0.491304347826087,920,455,465,0.494565217391304,0.0181416918634609,0.320561556335495,0.661296751801044
3,"Niedersachsen",3255019,"Heinsen",835,404,431,0.483832335329341,861,417,444,0.484320557491289,0.0181416918634609,0.320561556335495,0.661296751801044
3,"Niedersachsen",3255020,"Heyen",472,244,228,0.516949152542373,482,254,228,0.526970954356846,0.0181416918634609,0.320561556335495,0.661296751801044
3,"Niedersachsen",3255021,"Holenberg",432,217,215,0.502314814814815,440,223,217,0.506818181818182,0.0181416918634609,0.320561556335495,0.661296751801044
3,"Niedersachsen",3255022,"Holzen",626,284,342,0.453674121405751,629,294,335,0.467408585055644,0.0181416918634609,0.320561556335495,0.661296751801044
3,"Niedersachsen",3255023,"Holzminden, Stadt",20151,9805,10346,0.486576348568309,19939,9720,10219,0.487486834846281,0.0181416918634609,0.320561556335495,0.661296751801044
3,"Niedersachsen",3255025,"Kirchbrak",1069,542,527,0.507015902712816,1089,547,542,0.502295684113866,0.0181416918634609,0.320561556335495,0.661296751801044
3,"Niedersachsen",3255026,"Lauenförde, Flecken",2504,1247,1257,0.498003194888179,2503,1250,1253,0.499400719137036,0.0181416918634609,0.320561556335495,0.661296751801044
3,"Niedersachsen",3255027,"Lenne",667,327,340,0.490254872563718,673,329,344,0.488855869242199,0.0181416918634609,0.320561556335495,0.661296751801044
3,"Niedersachsen",3255028,"Lüerdissen",438,224,214,0.511415525114155,448,234,214,0.522321428571429,0.0181416918634609,0.320561556335495,0.661296751801044
3,"Niedersachsen",3255030,"Negenborn",710,353,357,0.497183098591549,691,347,344,0.502170767004341,0.0181416918634609,0.320561556335495,0.661296751801044
3,"Niedersachsen",3255031,"Ottenstein, Flecken",1190,598,592,0.502521008403361,1189,599,590,0.503784693019344,0.0181416918634609,0.320561556335495,0.661296751801044
3,"Niedersachsen",3255032,"Pegestorf",405,200,205,0.493827160493827,428,211,217,0.492990654205608,0.0181416918634609,0.320561556335495,0.661296751801044
3,"Niedersachsen",3255033,"Polle, Flecken",1203,625,578,0.519534497090607,1102,570,532,0.517241379310345,0.0181416918634609,0.320561556335495,0.661296751801044
3,"Niedersachsen",3255034,"Stadtoldendorf, Stadt",5664,2749,2915,0.48534604519774,5457,2596,2861,0.475719259666483,0.0181416918634609,0.320561556335495,0.661296751801044
3,"Niedersachsen",3255035,"Vahlbruch",424,223,201,0.525943396226415,458,242,216,0.528384279475983,0.0181416918634609,0.320561556335495,0.661296751801044
3,"Niedersachsen",3255036,"Wangelnstedt",605,301,304,0.497520661157025,617,307,310,0.497568881685575,0.0181416918634609,0.320561556335495,0.661296751801044
3,"Niedersachsen",3256001,"Balge",1835,937,898,0.510626702997275,1784,900,884,0.504484304932735,0.0181416918634609,0.320561556335495,0.661296751801044
3,"Niedersachsen",3256002,"Binnen",1002,514,488,0.512974051896208,988,504,484,0.510121457489879,0.0181416918634609,0.320561556335495,0.661296751801044
3,"Niedersachsen",3256003,"Bücken, Flecken",2160,1061,1099,0.491203703703704,2156,1069,1087,0.49582560296846,0.0181416918634609,0.320561556335495,0.661296751801044
3,"Niedersachsen",3256004,"Diepenau, Flecken",3951,2023,1928,0.512022272842318,3960,2033,1927,0.513383838383838,0.0181416918634609,0.320561556335495,0.661296751801044
3,"Niedersachsen",3256005,"Drakenburg, Flecken",1695,855,840,0.504424778761062,1719,863,856,0.502036067481094,0.0181416918634609,0.320561556335495,0.661296751801044
3,"Niedersachsen",3256006,"Estorf",1687,827,860,0.49021932424422,1709,846,863,0.495026331187829,0.0181416918634609,0.320561556335495,0.661296751801044
3,"Niedersachsen",3256007,"Eystrup",3371,1633,1738,0.484425986354198,3321,1618,1703,0.487202649804276,0.0181416918634609,0.320561556335495,0.661296751801044
3,"Niedersachsen",3256008,"Gandesbergen",495,251,244,0.507070707070707,458,225,233,0.491266375545852,0.0181416918634609,0.320561556335495,0.661296751801044
3,"Niedersachsen",3256009,"Hämelhausen",571,287,284,0.502626970227671,576,292,284,0.506944444444444,0.0181416918634609,0.320561556335495,0.661296751801044
3,"Niedersachsen",3256010,"Hassel (Weser)",1786,860,926,0.481522956326988,1855,906,949,0.488409703504043,0.0181416918634609,0.320561556335495,0.661296751801044
3,"Niedersachsen",3256011,"Haßbergen",1597,784,813,0.490920475892298,1557,784,773,0.503532434168272,0.0181416918634609,0.320561556335495,0.661296751801044
3,"Niedersachsen",3256012,"Heemsen",1725,845,880,0.489855072463768,1741,869,872,0.499138426191844,0.0181416918634609,0.320561556335495,0.661296751801044
3,"Niedersachsen",3256013,"Hilgermissen",2135,1094,1041,0.512412177985949,2130,1105,1025,0.518779342723005,0.0181416918634609,0.320561556335495,0.661296751801044
3,"Niedersachsen",3256014,"Hoya, Stadt",3798,1853,1945,0.487888362295945,3654,1793,1861,0.490695128626163,0.0181416918634609,0.320561556335495,0.661296751801044
3,"Niedersachsen",3256015,"Hoyerhagen",1017,503,514,0.494591937069813,1070,517,553,0.483177570093458,0.0181416918634609,0.320561556335495,0.661296751801044
3,"Niedersachsen",3256016,"Husum",2313,1161,1152,0.501945525291829,2036,1011,1025,0.496561886051081,0.0181416918634609,0.320561556335495,0.661296751801044
3,"Niedersachsen",3256017,"Landesbergen",2745,1314,1431,0.478688524590164,2834,1377,1457,0.485885673959068,0.0181416918634609,0.320561556335495,0.661296751801044
3,"Niedersachsen",3256018,"Leese",1665,825,840,0.495495495495495,1713,861,852,0.502626970227671,0.0181416918634609,0.320561556335495,0.661296751801044
3,"Niedersachsen",3256019,"Liebenau, Flecken",3518,1758,1760,0.499715747583854,3728,1881,1847,0.50456008583691,0.0181416918634609,0.320561556335495,0.661296751801044
3,"Niedersachsen",3256020,"Linsburg",923,459,464,0.497291440953413,931,458,473,0.491944146079484,0.0181416918634609,0.320561556335495,0.661296751801044
3,"Niedersachsen",3256021,"Marklohe",4477,2187,2290,0.488496761224034,4427,2168,2259,0.489722159475943,0.0181416918634609,0.320561556335495,0.661296751801044
3,"Niedersachsen",3256022,"Nienburg (Weser), Stadt",30815,14820,15995,0.48093460976797,31862,15613,16249,0.490019458916578,0.0181416918634609,0.320561556335495,0.661296751801044
3,"Niedersachsen",3256023,"Pennigsehl",1289,655,634,0.508145849495733,1276,653,623,0.511755485893417,0.0181416918634609,0.320561556335495,0.661296751801044
3,"Niedersachsen",3256024,"Raddestorf",1964,993,971,0.505600814663951,1985,1018,967,0.512846347607053,0.0181416918634609,0.320561556335495,0.661296751801044
3,"Niedersachsen",3256025,"Rehburg-Loccum, Stadt",10163,5075,5088,0.499360425071337,10338,5149,5189,0.49806538982395,0.0181416918634609,0.320561556335495,0.661296751801044
3,"Niedersachsen",3256026,"Rodewald",2555,1286,1269,0.503326810176125,2587,1287,1300,0.49748743718593,0.0181416918634609,0.320561556335495,0.661296751801044
3,"Niedersachsen",3256027,"Rohrsen",1039,509,530,0.489894128970164,1053,523,530,0.49667616334283,0.0181416918634609,0.320561556335495,0.661296751801044
3,"Niedersachsen",3256028,"Schweringen",797,401,396,0.503136762860728,792,398,394,0.502525252525252,0.0181416918634609,0.320561556335495,0.661296751801044
3,"Niedersachsen",3256029,"Steimbke",2455,1225,1230,0.4989816700611,2407,1203,1204,0.49979227253843,0.0181416918634609,0.320561556335495,0.661296751801044
3,"Niedersachsen",3256030,"Steyerberg, Flecken",5303,2639,2664,0.497642843673392,5226,2588,2638,0.49521622655951,0.0181416918634609,0.320561556335495,0.661296751801044
3,"Niedersachsen",3256031,"Stöckse",1343,686,657,0.510796723752792,1389,722,667,0.51979841612671,0.0181416918634609,0.320561556335495,0.661296751801044
3,"Niedersachsen",3256032,"Stolzenau",7502,3697,3805,0.492801919488137,7355,3627,3728,0.4931339225017,0.0181416918634609,0.320561556335495,0.661296751801044
3,"Niedersachsen",3256033,"Uchte, Flecken",5345,2889,2456,0.540505144995323,5321,2900,2421,0.545010336402932,0.0181416918634609,0.320561556335495,0.661296751801044
3,"Niedersachsen",3256034,"Warmsen",3383,1685,1698,0.498078628436299,3375,1681,1694,0.498074074074074,0.0181416918634609,0.320561556335495,0.661296751801044
3,"Niedersachsen",3256035,"Warpe",794,406,388,0.511335012594458,799,411,388,0.514392991239049,0.0181416918634609,0.320561556335495,0.661296751801044
3,"Niedersachsen",3256036,"Wietzen",2177,1054,1123,0.484152503445108,2113,1015,1098,0.480359678182679,0.0181416918634609,0.320561556335495,0.661296751801044
3,"Niedersachsen",3257001,"Ahnsen",1101,555,546,0.50408719346049,1163,560,603,0.481513327601032,0.0181416918634609,0.320561556335495,0.661296751801044
3,"Niedersachsen",3257002,"Apelern",2497,1265,1232,0.506607929515419,2543,1298,1245,0.51042076287849,0.0181416918634609,0.320561556335495,0.661296751801044
3,"Niedersachsen",3257003,"Auetal",6454,3153,3301,0.488534242330338,6195,3038,3157,0.490395480225989,0.0181416918634609,0.320561556335495,0.661296751801044
3,"Niedersachsen",3257004,"Auhagen",1288,652,636,0.506211180124224,1290,652,638,0.505426356589147,0.0181416918634609,0.320561556335495,0.661296751801044
3,"Niedersachsen",3257005,"Bad Eilsen",2387,1047,1340,0.438625890238793,2154,948,1206,0.440111420612813,0.0181416918634609,0.320561556335495,0.661296751801044
3,"Niedersachsen",3257006,"Bad Nenndorf, Stadt",10153,4695,5458,0.462424899044617,10560,4841,5719,0.45842803030303,0.0181416918634609,0.320561556335495,0.661296751801044
3,"Niedersachsen",3257007,"Beckedorf",1474,727,747,0.493215739484396,1501,737,764,0.491005996002665,0.0181416918634609,0.320561556335495,0.661296751801044
3,"Niedersachsen",3257008,"Buchholz",768,381,387,0.49609375,741,359,382,0.484480431848853,0.0181416918634609,0.320561556335495,0.661296751801044
3,"Niedersachsen",3257009,"Bückeburg, Stadt",19193,9145,10048,0.476475798468192,20407,9835,10572,0.481942470720831,0.0181416918634609,0.320561556335495,0.661296751801044
3,"Niedersachsen",3257010,"Hagenburg, Flecken",4528,2199,2329,0.485644876325088,4491,2193,2298,0.488309953239813,0.0181416918634609,0.320561556335495,0.661296751801044
3,"Niedersachsen",3257011,"Haste",2791,1318,1473,0.472232174847725,2762,1331,1431,0.48189717595945,0.0181416918634609,0.320561556335495,0.661296751801044
3,"Niedersachsen",3257012,"Heeßen",1397,694,703,0.496778811739442,1529,767,762,0.50163505559189,0.0181416918634609,0.320561556335495,0.661296751801044
3,"Niedersachsen",3257013,"Helpsen",1941,967,974,0.498196805770222,1936,967,969,0.49948347107438,0.0181416918634609,0.320561556335495,0.661296751801044
3,"Niedersachsen",3257014,"Hespe",2142,1038,1104,0.484593837535014,2145,1047,1098,0.488111888111888,0.0181416918634609,0.320561556335495,0.661296751801044
3,"Niedersachsen",3257015,"Heuerßen",958,470,488,0.490605427974948,998,494,504,0.49498997995992,0.0181416918634609,0.320561556335495,0.661296751801044
3,"Niedersachsen",3257016,"Hohnhorst",2021,997,1024,0.493320138545275,2123,1043,1080,0.491285916156382,0.0181416918634609,0.320561556335495,0.661296751801044
3,"Niedersachsen",3257017,"Hülsede",1050,506,544,0.481904761904762,1040,513,527,0.493269230769231,0.0181416918634609,0.320561556335495,0.661296751801044
3,"Niedersachsen",3257018,"Lauenau, Flecken",4119,2033,2086,0.493566399611556,4072,2016,2056,0.495088408644401,0.0181416918634609,0.320561556335495,0.661296751801044
3,"Niedersachsen",3257019,"Lauenhagen",1394,665,729,0.477044476327116,1437,689,748,0.479471120389701,0.0181416918634609,0.320561556335495,0.661296751801044
3,"Niedersachsen",3257020,"Lindhorst",4389,2128,2261,0.484848484848485,4343,2106,2237,0.484918259267787,0.0181416918634609,0.320561556335495,0.661296751801044
3,"Niedersachsen",3257021,"Lüdersfeld",1070,547,523,0.511214953271028,1090,554,536,0.508256880733945,0.0181416918634609,0.320561556335495,0.661296751801044
3,"Niedersachsen",3257022,"Luhden",1079,542,537,0.502316960148285,1090,551,539,0.505504587155963,0.0181416918634609,0.320561556335495,0.661296751801044
3,"Niedersachsen",3257023,"Meerbeck",1961,956,1005,0.487506374298827,1971,968,1003,0.491121258244546,0.0181416918634609,0.320561556335495,0.661296751801044
3,"Niedersachsen",3257024,"Messenkamp",752,371,381,0.493351063829787,752,376,376,0.5,0.0181416918634609,0.320561556335495,0.661296751801044
3,"Niedersachsen",3257025,"Niedernwöhren",1987,980,1007,0.493205837946653,1969,963,1006,0.489080751650584,0.0181416918634609,0.320561556335495,0.661296751801044
3,"Niedersachsen",3257026,"Nienstädt",4642,2313,2329,0.498276604911676,4641,2303,2338,0.496229260935143,0.0181416918634609,0.320561556335495,0.661296751801044
3,"Niedersachsen",3257027,"Nordsehl",758,367,391,0.484168865435356,754,364,390,0.482758620689655,0.0181416918634609,0.320561556335495,0.661296751801044
3,"Niedersachsen",3257028,"Obernkirchen, Stadt",9330,4614,4716,0.494533762057878,9204,4578,4626,0.497392438070404,0.0181416918634609,0.320561556335495,0.661296751801044
3,"Niedersachsen",3257029,"Pohle",875,459,416,0.524571428571429,911,482,429,0.529088913282108,0.0181416918634609,0.320561556335495,0.661296751801044
3,"Niedersachsen",3257030,"Pollhagen",1144,581,563,0.507867132867133,1154,584,570,0.506065857885615,0.0181416918634609,0.320561556335495,0.661296751801044
3,"Niedersachsen",3257031,"Rinteln, Stadt",25731,12508,13223,0.48610625315767,26733,13152,13581,0.491976209179666,0.0181416918634609,0.320561556335495,0.661296751801044
3,"Niedersachsen",3257032,"Rodenberg, Stadt",6352,3110,3242,0.489609571788413,6077,2963,3114,0.487576106631562,0.0181416918634609,0.320561556335495,0.661296751801044
3,"Niedersachsen",3257033,"Sachsenhagen, Stadt",1999,1004,995,0.502251125562781,1964,1001,963,0.509674134419552,0.0181416918634609,0.320561556335495,0.661296751801044
3,"Niedersachsen",3257034,"Seggebruch",1541,799,742,0.518494484101233,1556,818,738,0.525706940874036,0.0181416918634609,0.320561556335495,0.661296751801044
3,"Niedersachsen",3257035,"Stadthagen, Stadt",21582,10221,11361,0.473589102029469,22211,10501,11710,0.472783755796677,0.0181416918634609,0.320561556335495,0.661296751801044
3,"Niedersachsen",3257036,"Suthfeld",1476,730,746,0.494579945799458,1472,722,750,0.490489130434783,0.0181416918634609,0.320561556335495,0.661296751801044
3,"Niedersachsen",3257037,"Wiedensahl, Flecken",1057,533,524,0.504257332071902,1065,535,530,0.502347417840376,0.0181416918634609,0.320561556335495,0.661296751801044
3,"Niedersachsen",3257038,"Wölpinghausen",1645,819,826,0.497872340425532,1689,844,845,0.499703966844287,0.0181416918634609,0.320561556335495,0.661296751801044
3,"Niedersachsen",3351001,"Adelheidsdorf",2426,1190,1236,0.490519373454246,2478,1226,1252,0.494753833736885,0.0181416918634609,0.320561556335495,0.661296751801044
3,"Niedersachsen",3351002,"Ahnsbeck",1629,817,812,0.501534683855126,1653,836,817,0.505747126436782,0.0181416918634609,0.320561556335495,0.661296751801044
3,"Niedersachsen",3351003,"Beedenbostel",998,492,506,0.492985971943888,1054,515,539,0.488614800759013,0.0181416918634609,0.320561556335495,0.661296751801044
3,"Niedersachsen",3351004,"Bergen, Stadt",12893,6342,6551,0.49189482665012,12794,6384,6410,0.498983898702517,0.0181416918634609,0.320561556335495,0.661296751801044
3,"Niedersachsen",3351005,"Bröckel",1794,904,890,0.503901895206243,1769,883,886,0.499152063312606,0.0181416918634609,0.320561556335495,0.661296751801044
3,"Niedersachsen",3351006,"Celle, Stadt",68712,32875,35837,0.478446268482943,69972,33594,36378,0.480106328245584,0.0181416918634609,0.320561556335495,0.661296751801044
3,"Niedersachsen",3351007,"Eicklingen",3204,1589,1615,0.495942571785268,3216,1598,1618,0.496890547263682,0.0181416918634609,0.320561556335495,0.661296751801044
3,"Niedersachsen",3351008,"Eldingen",2100,1034,1066,0.492380952380952,2138,1048,1090,0.490177736202058,0.0181416918634609,0.320561556335495,0.661296751801044
3,"Niedersachsen",3351009,"Eschede",3805,1854,1951,0.487253613666229,3697,1822,1875,0.492832025967,0.0181416918634609,0.320561556335495,0.661296751801044
3,"Niedersachsen",3351010,"Faßberg",6248,3193,3055,0.511043533930858,6753,3636,3117,0.538427365615282,0.0181416918634609,0.320561556335495,0.661296751801044
3,"Niedersachsen",3351011,"Habighorst",748,377,371,0.504010695187166,785,393,392,0.500636942675159,0.0181416918634609,0.320561556335495,0.661296751801044
3,"Niedersachsen",3351012,"Hambühren",9962,4977,4985,0.499598474201967,10055,4917,5138,0.489010442565888,0.0181416918634609,0.320561556335495,0.661296751801044
3,"Niedersachsen",3351013,"Hermannsburg",8146,3983,4163,0.488951632703167,8102,3984,4118,0.491730436929153,0.0181416918634609,0.320561556335495,0.661296751801044
3,"Niedersachsen",3351014,"Höfer",922,483,439,0.523861171366594,942,488,454,0.518046709129512,0.0181416918634609,0.320561556335495,0.661296751801044
3,"Niedersachsen",3351015,"Hohne",1688,860,828,0.509478672985782,1715,874,841,0.509620991253644,0.0181416918634609,0.320561556335495,0.661296751801044
3,"Niedersachsen",3351016,"Lachendorf",5980,2928,3052,0.489632107023411,5844,2853,2991,0.488193018480493,0.0181416918634609,0.320561556335495,0.661296751801044
3,"Niedersachsen",3351017,"Langlingen",2227,1088,1139,0.488549618320611,2206,1073,1133,0.486400725294651,0.0181416918634609,0.320561556335495,0.661296751801044
3,"Niedersachsen",3351018,"Nienhagen",6506,3183,3323,0.489240700891485,6386,3113,3273,0.487472596304416,0.0181416918634609,0.320561556335495,0.661296751801044
3,"Niedersachsen",3351019,"Scharnhorst",679,333,346,0.490427098674521,709,343,366,0.483779971791255,0.0181416918634609,0.320561556335495,0.661296751801044
3,"Niedersachsen",3351020,"Unterlüß",3629,1811,1818,0.49903554698264,3605,1782,1823,0.494313453536754,0.0181416918634609,0.320561556335495,0.661296751801044
3,"Niedersachsen",3351021,"Wathlingen",6094,3018,3076,0.49524122087299,6030,2954,3076,0.489883913764511,0.0181416918634609,0.320561556335495,0.661296751801044
3,"Niedersachsen",3351022,"Wienhausen, Klostergemeinde",4196,2076,2120,0.494756911344137,4126,2060,2066,0.499272903538536,0.0181416918634609,0.320561556335495,0.661296751801044
3,"Niedersachsen",3351023,"Wietze",8009,3934,4075,0.491197402921713,7975,3927,4048,0.492413793103448,0.0181416918634609,0.320561556335495,0.661296751801044
3,"Niedersachsen",3351024,"Winsen (Aller)",12669,6185,6484,0.488199542189597,12892,6306,6586,0.489140552280484,0.0181416918634609,0.320561556335495,0.661296751801044
3,"Niedersachsen",3351501,"Lohheide, gemfr. Bezirk",790,409,381,0.517721518987342,695,371,324,0.533812949640288,0.0181416918634609,0.320561556335495,0.661296751801044
3,"Niedersachsen",3352002,"Armstorf",622,326,296,0.52411575562701,614,325,289,0.529315960912052,0.0181416918634609,0.320561556335495,0.661296751801044
3,"Niedersachsen",3352003,"Bad Bederkesa, Flecken",5240,2521,2719,0.481106870229008,4967,2398,2569,0.482786390175156,0.0181416918634609,0.320561556335495,0.661296751801044
3,"Niedersachsen",3352004,"Belum",836,422,414,0.504784688995215,803,419,384,0.521793275217933,0.0181416918634609,0.320561556335495,0.661296751801044
3,"Niedersachsen",3352007,"Bramstedt",1892,950,942,0.502114164904863,1884,952,932,0.505307855626327,0.0181416918634609,0.320561556335495,0.661296751801044
3,"Niedersachsen",3352008,"Bülkau",881,439,442,0.498297389330306,856,437,419,0.510514018691589,0.0181416918634609,0.320561556335495,0.661296751801044
3,"Niedersachsen",3352009,"Cadenberge",3420,1633,1787,0.477485380116959,3328,1573,1755,0.47265625,0.0181416918634609,0.320561556335495,0.661296751801044
3,"Niedersachsen",3352010,"Cappel",738,370,368,0.501355013550135,726,364,362,0.50137741046832,0.0181416918634609,0.320561556335495,0.661296751801044
3,"Niedersachsen",3352011,"Cuxhaven, Stadt",48829,23113,25716,0.473345757644023,50055,24011,26044,0.47969233842773,0.0181416918634609,0.320561556335495,0.661296751801044
3,"Niedersachsen",3352012,"Dorum",3748,1811,1937,0.483191035218783,3655,1758,1897,0.480984952120383,0.0181416918634609,0.320561556335495,0.661296751801044
3,"Niedersachsen",3352013,"Drangstedt",1462,725,737,0.495896032831737,1477,729,748,0.493568043331077,0.0181416918634609,0.320561556335495,0.661296751801044
3,"Niedersachsen",3352014,"Driftsethe",656,337,319,0.513719512195122,738,383,355,0.518970189701897,0.0181416918634609,0.320561556335495,0.661296751801044
3,"Niedersachsen",3352015,"Elmlohe",824,413,411,0.50121359223301,845,422,423,0.499408284023669,0.0181416918634609,0.320561556335495,0.661296751801044
3,"Niedersachsen",3352016,"Flögeln",623,310,313,0.497592295345104,637,306,331,0.480376766091052,0.0181416918634609,0.320561556335495,0.661296751801044
3,"Niedersachsen",3352018,"Geversdorf",733,364,369,0.496589358799454,709,352,357,0.496473906911142,0.0181416918634609,0.320561556335495,0.661296751801044
3,"Niedersachsen",3352019,"Hagen im Bremischen",4055,1985,2070,0.489519112207152,3805,1826,1979,0.479894875164258,0.0181416918634609,0.320561556335495,0.661296751801044
3,"Niedersachsen",3352020,"Hechthausen",3467,1752,1715,0.505336025382175,3459,1755,1704,0.507372072853426,0.0181416918634609,0.320561556335495,0.661296751801044
3,"Niedersachsen",3352022,"Hemmoor, Stadt",8784,4239,4545,0.482581967213115,8675,4161,4514,0.479654178674352,0.0181416918634609,0.320561556335495,0.661296751801044
3,"Niedersachsen",3352024,"Hollnseth",912,467,445,0.512061403508772,907,468,439,0.515986769570011,0.0181416918634609,0.320561556335495,0.661296751801044
3,"Niedersachsen",3352025,"Ihlienworth",1629,795,834,0.488029465930018,1643,804,839,0.48934875228241,0.0181416918634609,0.320561556335495,0.661296751801044
3,"Niedersachsen",3352027,"Köhlen",953,475,478,0.498426023084995,967,482,485,0.498448810754912,0.0181416918634609,0.320561556335495,0.661296751801044
3,"Niedersachsen",3352028,"Kührstedt",1020,520,500,0.509803921568627,1094,555,539,0.507312614259598,0.0181416918634609,0.320561556335495,0.661296751801044
3,"Niedersachsen",3352029,"Lamstedt",3308,1616,1692,0.488512696493349,3258,1600,1658,0.49109883364027,0.0181416918634609,0.320561556335495,0.661296751801044
3,"Niedersachsen",3352030,"Langen, Stadt",18432,9007,9425,0.488661024305556,18510,9064,9446,0.489681253376553,0.0181416918634609,0.320561556335495,0.661296751801044
3,"Niedersachsen",3352031,"Lintig",1243,596,647,0.479485116653258,1266,618,648,0.488151658767773,0.0181416918634609,0.320561556335495,0.661296751801044
3,"Niedersachsen",3352032,"Loxstedt",15873,7828,8045,0.493164493164493,16048,7929,8119,0.494080259222333,0.0181416918634609,0.320561556335495,0.661296751801044
3,"Niedersachsen",3352034,"Midlum",1752,888,864,0.506849315068493,1788,909,879,0.508389261744966,0.0181416918634609,0.320561556335495,0.661296751801044
3,"Niedersachsen",3352035,"Misselwarden",437,226,211,0.517162471395881,461,240,221,0.52060737527115,0.0181416918634609,0.320561556335495,0.661296751801044
3,"Niedersachsen",3352036,"Mittelstenahe",619,303,316,0.489499192245557,621,304,317,0.489533011272142,0.0181416918634609,0.320561556335495,0.661296751801044
3,"Niedersachsen",3352037,"Mulsum",543,278,265,0.511970534069982,501,263,238,0.524950099800399,0.0181416918634609,0.320561556335495,0.661296751801044
3,"Niedersachsen",3352038,"Neuenkirchen",1373,714,659,0.520029133284778,1387,722,665,0.520547945205479,0.0181416918634609,0.320561556335495,0.661296751801044
3,"Niedersachsen",3352039,"Neuhaus (Oste), Flecken",1204,606,598,0.503322259136213,1150,585,565,0.508695652173913,0.0181416918634609,0.320561556335495,0.661296751801044
3,"Niedersachsen",3352040,"Nordholz",7311,3705,3606,0.50677061961428,7430,3826,3604,0.514939434724092,0.0181416918634609,0.320561556335495,0.661296751801044
3,"Niedersachsen",3352041,"Nordleda",1101,570,531,0.517711171662125,1117,572,545,0.512085944494181,0.0181416918634609,0.320561556335495,0.661296751801044
3,"Niedersachsen",3352042,"Oberndorf",1405,700,705,0.498220640569395,1404,695,709,0.495014245014245,0.0181416918634609,0.320561556335495,0.661296751801044
3,"Niedersachsen",3352043,"Odisheim",536,289,247,0.539179104477612,554,302,252,0.545126353790614,0.0181416918634609,0.320561556335495,0.661296751801044
3,"Niedersachsen",3352044,"Osten",1864,930,934,0.498927038626609,1922,951,971,0.494797086368366,0.0181416918634609,0.320561556335495,0.661296751801044
3,"Niedersachsen",3352045,"Osterbruch",542,274,268,0.505535055350554,553,281,272,0.508137432188065,0.0181416918634609,0.320561556335495,0.661296751801044
3,"Niedersachsen",3352046,"Otterndorf, Stadt",7072,3389,3683,0.479213800904977,7068,3416,3652,0.483305036785512,0.0181416918634609,0.320561556335495,0.661296751801044
3,"Niedersachsen",3352047,"Padingbüttel",474,239,235,0.5042194092827,483,245,238,0.507246376811594,0.0181416918634609,0.320561556335495,0.661296751801044
3,"Niedersachsen",3352048,"Ringstedt",837,418,419,0.499402628434886,870,426,444,0.489655172413793,0.0181416918634609,0.320561556335495,0.661296751801044
3,"Niedersachsen",3352049,"Sandstedt",1556,782,774,0.502570694087404,1638,839,799,0.512210012210012,0.0181416918634609,0.320561556335495,0.661296751801044
3,"Niedersachsen",3352050,"Schiffdorf",13714,6729,6985,0.490666472218171,14001,6895,7106,0.492464823941147,0.0181416918634609,0.320561556335495,0.661296751801044
3,"Niedersachsen",3352051,"Steinau",883,459,424,0.519818799546999,889,467,422,0.525309336332958,0.0181416918634609,0.320561556335495,0.661296751801044
3,"Niedersachsen",3352052,"Stinstedt",569,293,276,0.51493848857645,531,284,247,0.534839924670433,0.0181416918634609,0.320561556335495,0.661296751801044
3,"Niedersachsen",3352054,"Uthlede",1014,486,528,0.479289940828402,1017,507,510,0.498525073746313,0.0181416918634609,0.320561556335495,0.661296751801044
3,"Niedersachsen",3352055,"Wanna",2227,1112,1115,0.499326448136507,2256,1137,1119,0.503989361702128,0.0181416918634609,0.320561556335495,0.661296751801044
3,"Niedersachsen",3352056,"Wingst",3428,1698,1730,0.495332555425904,3397,1661,1736,0.488960847806888,0.0181416918634609,0.320561556335495,0.661296751801044
3,"Niedersachsen",3352057,"Wremen",1950,962,988,0.493333333333333,1971,966,1005,0.490106544901065,0.0181416918634609,0.320561556335495,0.661296751801044
3,"Niedersachsen",3352058,"Wulsbüttel",1854,939,915,0.506472491909385,1893,974,919,0.514527205493925,0.0181416918634609,0.320561556335495,0.661296751801044
3,"Niedersachsen",3352059,"Beverstedt",13670,6801,6869,0.497512801755669,13615,6749,6866,0.495703268453911,0.0181416918634609,0.320561556335495,0.661296751801044
3,"Niedersachsen",3353001,"Appel",1830,915,915,0.5,1980,983,997,0.496464646464646,0.0181416918634609,0.320561556335495,0.661296751801044
3,"Niedersachsen",3353002,"Asendorf",1903,938,965,0.492905937992643,1877,905,972,0.482152370804475,0.0181416918634609,0.320561556335495,0.661296751801044
3,"Niedersachsen",3353003,"Bendestorf",2262,1063,1199,0.469938107869142,2414,1155,1259,0.478458989229495,0.0181416918634609,0.320561556335495,0.661296751801044
3,"Niedersachsen",3353004,"Brackel",1767,893,874,0.505376344086022,1721,872,849,0.506682161533992,0.0181416918634609,0.320561556335495,0.661296751801044
3,"Niedersachsen",3353005,"Buchholz in der Nordheide, Stadt",36875,17457,19418,0.473410169491525,39088,18845,20243,0.482117273843635,0.0181416918634609,0.320561556335495,0.661296751801044
3,"Niedersachsen",3353006,"Dohren",1080,543,537,0.502777777777778,1152,584,568,0.506944444444444,0.0181416918634609,0.320561556335495,0.661296751801044
3,"Niedersachsen",3353007,"Drage",4038,2038,2000,0.504705299653294,4075,2067,2008,0.507239263803681,0.0181416918634609,0.320561556335495,0.661296751801044
3,"Niedersachsen",3353008,"Drestedt",744,373,371,0.501344086021505,787,397,390,0.504447268106734,0.0181416918634609,0.320561556335495,0.661296751801044
3,"Niedersachsen",3353009,"Egestorf",2395,1178,1217,0.491858037578288,2357,1149,1208,0.487484089944845,0.0181416918634609,0.320561556335495,0.661296751801044
3,"Niedersachsen",3353010,"Eyendorf",1235,607,628,0.491497975708502,1284,618,666,0.481308411214953,0.0181416918634609,0.320561556335495,0.661296751801044
3,"Niedersachsen",3353011,"Garlstorf",1081,560,521,0.518038852913969,1107,569,538,0.514001806684733,0.0181416918634609,0.320561556335495,0.661296751801044
3,"Niedersachsen",3353012,"Garstedt",1449,713,736,0.492063492063492,1458,713,745,0.489026063100137,0.0181416918634609,0.320561556335495,0.661296751801044
3,"Niedersachsen",3353013,"Gödenstorf",931,452,479,0.485499462943072,937,455,482,0.485592315901814,0.0181416918634609,0.320561556335495,0.661296751801044
3,"Niedersachsen",3353014,"Halvesbostel",728,365,363,0.501373626373626,721,356,365,0.49375866851595,0.0181416918634609,0.320561556335495,0.661296751801044
3,"Niedersachsen",3353015,"Handeloh",2393,1190,1203,0.497283744254074,2438,1195,1243,0.490155865463495,0.0181416918634609,0.320561556335495,0.661296751801044
3,"Niedersachsen",3353016,"Hanstedt",5317,2509,2808,0.471882640586797,5236,2491,2745,0.475744843391902,0.0181416918634609,0.320561556335495,0.661296751801044
3,"Niedersachsen",3353017,"Harmstorf",884,409,475,0.462669683257919,904,415,489,0.459070796460177,0.0181416918634609,0.320561556335495,0.661296751801044
3,"Niedersachsen",3353018,"Heidenau",2098,1049,1049,0.5,2123,1070,1053,0.504003768252473,0.0181416918634609,0.320561556335495,0.661296751801044
3,"Niedersachsen",3353019,"Hollenstedt",3400,1665,1735,0.489705882352941,3187,1566,1621,0.491371195481644,0.0181416918634609,0.320561556335495,0.661296751801044
3,"Niedersachsen",3353020,"Jesteburg",7449,3569,3880,0.479124714726809,7427,3524,3903,0.474484987208833,0.0181416918634609,0.320561556335495,0.661296751801044
3,"Niedersachsen",3353021,"Kakenstorf",1312,643,669,0.490091463414634,1416,679,737,0.479519774011299,0.0181416918634609,0.320561556335495,0.661296751801044
3,"Niedersachsen",3353022,"Königsmoor",638,338,300,0.529780564263323,663,350,313,0.52790346907994,0.0181416918634609,0.320561556335495,0.661296751801044
3,"Niedersachsen",3353023,"Marschacht",3786,1850,1936,0.48864236661384,3708,1814,1894,0.489212513484358,0.0181416918634609,0.320561556335495,0.661296751801044
3,"Niedersachsen",3353024,"Marxen",1386,682,704,0.492063492063492,1361,668,693,0.490815576781778,0.0181416918634609,0.320561556335495,0.661296751801044
3,"Niedersachsen",3353025,"Moisburg",1761,887,874,0.503691084611016,1792,899,893,0.501674107142857,0.0181416918634609,0.320561556335495,0.661296751801044
3,"Niedersachsen",3353026,"Neu Wulmstorf",19935,9733,10202,0.488236769500878,20862,10338,10524,0.495542134023584,0.0181416918634609,0.320561556335495,0.661296751801044
3,"Niedersachsen",3353027,"Otter",1545,775,770,0.501618122977346,1611,832,779,0.516449410304159,0.0181416918634609,0.320561556335495,0.661296751801044
3,"Niedersachsen",3353028,"Regesbostel",1075,533,542,0.495813953488372,1089,541,548,0.496786042240588,0.0181416918634609,0.320561556335495,0.661296751801044
3,"Niedersachsen",3353029,"Rosengarten",12907,6309,6598,0.488804524676532,13491,6626,6865,0.491142242976799,0.0181416918634609,0.320561556335495,0.661296751801044
3,"Niedersachsen",3353030,"Salzhausen",4642,2264,2378,0.487720809995692,4579,2213,2366,0.483293295479362,0.0181416918634609,0.320561556335495,0.661296751801044
3,"Niedersachsen",3353031,"Seevetal",39921,19329,20592,0.484181257984519,42210,20933,21277,0.495925136223644,0.0181416918634609,0.320561556335495,0.661296751801044
3,"Niedersachsen",3353032,"Stelle",10827,5354,5473,0.494504479541886,11063,5468,5595,0.494260146434059,0.0181416918634609,0.320561556335495,0.661296751801044
3,"Niedersachsen",3353033,"Tespe",4108,2058,2050,0.500973709834469,4134,2088,2046,0.505079825834543,0.0181416918634609,0.320561556335495,0.661296751801044
3,"Niedersachsen",3353034,"Toppenstedt",2126,1070,1056,0.503292568203198,2131,1085,1046,0.509150633505397,0.0181416918634609,0.320561556335495,0.661296751801044
3,"Niedersachsen",3353035,"Tostedt",13089,6234,6855,0.476277790511116,13181,6320,6861,0.479478036567787,0.0181416918634609,0.320561556335495,0.661296751801044
3,"Niedersachsen",3353036,"Undeloh",979,484,495,0.49438202247191,974,476,498,0.48870636550308,0.0181416918634609,0.320561556335495,0.661296751801044
3,"Niedersachsen",3353037,"Vierhöfen",986,469,517,0.475659229208925,998,475,523,0.475951903807615,0.0181416918634609,0.320561556335495,0.661296751801044
3,"Niedersachsen",3353038,"Welle",1193,607,586,0.508801341156748,1231,627,604,0.509341998375305,0.0181416918634609,0.320561556335495,0.661296751801044
3,"Niedersachsen",3353039,"Wenzendorf",1271,627,644,0.493312352478363,1364,672,692,0.49266862170088,0.0181416918634609,0.320561556335495,0.661296751801044
3,"Niedersachsen",3353040,"Winsen (Luhe), Stadt",32638,15972,16666,0.489368221091979,34437,17084,17353,0.49609431715887,0.0181416918634609,0.320561556335495,0.661296751801044
3,"Niedersachsen",3353041,"Wistedt",1670,840,830,0.502994011976048,1767,898,869,0.508205998868138,0.0181416918634609,0.320561556335495,0.661296751801044
3,"Niedersachsen",3353042,"Wulfsen",1615,767,848,0.474922600619195,1654,789,865,0.477025392986699,0.0181416918634609,0.320561556335495,0.661296751801044
3,"Niedersachsen",3354001,"Bergen an der Dumme, Flecken",1589,798,791,0.502202643171806,1519,756,763,0.497695852534562,0.0181416918634609,0.320561556335495,0.661296751801044
3,"Niedersachsen",3354002,"Clenze, Flecken",2446,1251,1195,0.511447260834015,2305,1171,1134,0.508026030368764,0.0181416918634609,0.320561556335495,0.661296751801044
3,"Niedersachsen",3354003,"Damnatz",317,147,170,0.463722397476341,333,155,178,0.465465465465465,0.0181416918634609,0.320561556335495,0.661296751801044
3,"Niedersachsen",3354004,"Dannenberg (Elbe), Stadt",8081,3991,4090,0.493874520480139,8162,4054,4108,0.496691987258025,0.0181416918634609,0.320561556335495,0.661296751801044
3,"Niedersachsen",3354005,"Gartow, Flecken",1362,630,732,0.462555066079295,1368,650,718,0.475146198830409,0.0181416918634609,0.320561556335495,0.661296751801044
3,"Niedersachsen",3354006,"Göhrde",635,308,327,0.48503937007874,656,322,334,0.490853658536585,0.0181416918634609,0.320561556335495,0.661296751801044
3,"Niedersachsen",3354007,"Gorleben",634,314,320,0.495268138801262,638,310,328,0.4858934169279,0.0181416918634609,0.320561556335495,0.661296751801044
3,"Niedersachsen",3354008,"Gusborn",1225,623,602,0.508571428571429,1278,657,621,0.514084507042254,0.0181416918634609,0.320561556335495,0.661296751801044
3,"Niedersachsen",3354009,"Hitzacker (Elbe), Stadt",4933,2327,2606,0.471721062233935,4804,2283,2521,0.475228975853455,0.0181416918634609,0.320561556335495,0.661296751801044
3,"Niedersachsen",3354010,"Höhbeck",645,326,319,0.505426356589147,676,340,336,0.502958579881657,0.0181416918634609,0.320561556335495,0.661296751801044
3,"Niedersachsen",3354011,"Jameln",1071,541,530,0.505135387488329,1080,549,531,0.508333333333333,0.0181416918634609,0.320561556335495,0.661296751801044
3,"Niedersachsen",3354012,"Karwitz",742,369,373,0.497304582210243,794,395,399,0.497481108312343,0.0181416918634609,0.320561556335495,0.661296751801044
3,"Niedersachsen",3354013,"Küsten",1362,660,702,0.484581497797357,1406,659,747,0.468705547652916,0.0181416918634609,0.320561556335495,0.661296751801044
3,"Niedersachsen",3354014,"Langendorf",719,350,369,0.486787204450626,712,349,363,0.490168539325843,0.0181416918634609,0.320561556335495,0.661296751801044
3,"Niedersachsen",3354015,"Lemgow",1408,712,696,0.505681818181818,1386,715,671,0.515873015873016,0.0181416918634609,0.320561556335495,0.661296751801044
3,"Niedersachsen",3354016,"Luckau (Wendland)",634,339,295,0.534700315457413,605,343,262,0.566942148760331,0.0181416918634609,0.320561556335495,0.661296751801044
3,"Niedersachsen",3354017,"Lübbow",836,409,427,0.489234449760766,824,405,419,0.491504854368932,0.0181416918634609,0.320561556335495,0.661296751801044
3,"Niedersachsen",3354018,"Lüchow (Wendland), Stadt",9401,4553,4848,0.48431017976811,9325,4515,4810,0.484182305630027,0.0181416918634609,0.320561556335495,0.661296751801044
3,"Niedersachsen",3354019,"Neu Darchau",1396,663,733,0.474928366762178,1442,689,753,0.477808599167822,0.0181416918634609,0.320561556335495,0.661296751801044
3,"Niedersachsen",3354020,"Prezelle",473,232,241,0.490486257928118,466,239,227,0.512875536480687,0.0181416918634609,0.320561556335495,0.661296751801044
3,"Niedersachsen",3354021,"Schnackenburg, Stadt",586,298,288,0.508532423208191,580,287,293,0.494827586206897,0.0181416918634609,0.320561556335495,0.661296751801044
3,"Niedersachsen",3354022,"Schnega",1354,657,697,0.485228951255539,1337,667,670,0.49887808526552,0.0181416918634609,0.320561556335495,0.661296751801044
3,"Niedersachsen",3354023,"Trebel",953,466,487,0.488982161594963,923,459,464,0.497291440953413,0.0181416918634609,0.320561556335495,0.661296751801044
3,"Niedersachsen",3354024,"Waddeweitz",906,442,464,0.487858719646799,901,444,457,0.492785793562708,0.0181416918634609,0.320561556335495,0.661296751801044
3,"Niedersachsen",3354025,"Woltersdorf",939,471,468,0.501597444089457,952,494,458,0.51890756302521,0.0181416918634609,0.320561556335495,0.661296751801044
3,"Niedersachsen",3354026,"Wustrow (Wendland), Stadt",2847,1400,1447,0.491745697225149,2950,1458,1492,0.494237288135593,0.0181416918634609,0.320561556335495,0.661296751801044
3,"Niedersachsen",3354027,"Zernien",1588,794,794,0.5,1595,811,784,0.50846394984326,0.0181416918634609,0.320561556335495,0.661296751801044
3,"Niedersachsen",3355001,"Adendorf",10288,4923,5365,0.47851866251944,10357,5024,5333,0.485082552862798,0.0181416918634609,0.320561556335495,0.661296751801044
3,"Niedersachsen",3355002,"Amelinghausen",3962,1934,2028,0.488137304391721,3827,1836,1991,0.479749150770839,0.0181416918634609,0.320561556335495,0.661296751801044
3,"Niedersachsen",3355003,"Artlenburg, Flecken",1610,814,796,0.505590062111801,1636,826,810,0.504889975550122,0.0181416918634609,0.320561556335495,0.661296751801044
3,"Niedersachsen",3355004,"Bardowick, Flecken",6473,3162,3311,0.488490653483702,6451,3181,3270,0.493101844675244,0.0181416918634609,0.320561556335495,0.661296751801044
3,"Niedersachsen",3355005,"Barendorf",2418,1215,1203,0.502481389578164,2393,1199,1194,0.501044713748433,0.0181416918634609,0.320561556335495,0.661296751801044
3,"Niedersachsen",3355006,"Barnstedt",747,363,384,0.485943775100402,760,373,387,0.490789473684211,0.0181416918634609,0.320561556335495,0.661296751801044
3,"Niedersachsen",3355007,"Barum",1828,927,901,0.507111597374179,1870,967,903,0.517112299465241,0.0181416918634609,0.320561556335495,0.661296751801044
3,"Niedersachsen",3355008,"Betzendorf",1156,564,592,0.487889273356401,1149,575,574,0.500435161009574,0.0181416918634609,0.320561556335495,0.661296751801044
3,"Niedersachsen",3355009,"Bleckede, Stadt",9532,4615,4917,0.484158623583718,9633,4670,4963,0.48479186131008,0.0181416918634609,0.320561556335495,0.661296751801044
3,"Niedersachsen",3355010,"Boitze",393,195,198,0.49618320610687,395,197,198,0.49873417721519,0.0181416918634609,0.320561556335495,0.661296751801044
3,"Niedersachsen",3355011,"Brietlingen",3319,1615,1704,0.486592347092498,3318,1630,1688,0.491259795057263,0.0181416918634609,0.320561556335495,0.661296751801044
3,"Niedersachsen",3355012,"Dahlem",599,329,270,0.549248747913189,506,259,247,0.511857707509881,0.0181416918634609,0.320561556335495,0.661296751801044
3,"Niedersachsen",3355013,"Dahlenburg, Flecken",3351,1673,1678,0.499253954043569,3344,1677,1667,0.501495215311005,0.0181416918634609,0.320561556335495,0.661296751801044
3,"Niedersachsen",3355014,"Deutsch Evern",3736,1833,1903,0.490631691648822,3715,1825,1890,0.491251682368775,0.0181416918634609,0.320561556335495,0.661296751801044
3,"Niedersachsen",3355015,"Echem",1017,503,514,0.494591937069813,1011,492,519,0.486646884272997,0.0181416918634609,0.320561556335495,0.661296751801044
3,"Niedersachsen",3355016,"Embsen",2630,1275,1355,0.484790874524715,2653,1287,1366,0.485111194873728,0.0181416918634609,0.320561556335495,0.661296751801044
3,"Niedersachsen",3355017,"Handorf",1953,973,980,0.498207885304659,1979,992,987,0.501263264274886,0.0181416918634609,0.320561556335495,0.661296751801044
3,"Niedersachsen",3355018,"Hittbergen",912,454,458,0.49780701754386,871,439,432,0.504018369690011,0.0181416918634609,0.320561556335495,0.661296751801044
3,"Niedersachsen",3355019,"Hohnstorf (Elbe)",2408,1214,1194,0.504152823920266,2450,1233,1217,0.503265306122449,0.0181416918634609,0.320561556335495,0.661296751801044
3,"Niedersachsen",3355020,"Kirchgellersen",2279,1100,1179,0.482667836770513,2192,1052,1140,0.47992700729927,0.0181416918634609,0.320561556335495,0.661296751801044
3,"Niedersachsen",3355021,"Lüdersburg",624,304,320,0.487179487179487,627,319,308,0.508771929824561,0.0181416918634609,0.320561556335495,0.661296751801044
3,"Niedersachsen",3355022,"Lüneburg, Hansestadt",70438,33733,36705,0.478903432806156,73581,35771,37810,0.486144521004064,0.0181416918634609,0.320561556335495,0.661296751801044
3,"Niedersachsen",3355023,"Mechtersen",662,323,339,0.487915407854985,653,318,335,0.48698315467075,0.0181416918634609,0.320561556335495,0.661296751801044
3,"Niedersachsen",3355024,"Melbeck",3373,1667,1706,0.494218796323747,3359,1674,1685,0.498362607919024,0.0181416918634609,0.320561556335495,0.661296751801044
3,"Niedersachsen",3355025,"Nahrendorf",1236,615,621,0.497572815533981,1357,679,678,0.500368459837878,0.0181416918634609,0.320561556335495,0.661296751801044
3,"Niedersachsen",3355026,"Neetze",2583,1249,1334,0.483546264034069,2559,1232,1327,0.481438061742868,0.0181416918634609,0.320561556335495,0.661296751801044
3,"Niedersachsen",3355027,"Oldendorf (Luhe)",985,491,494,0.498477157360406,1006,502,504,0.499005964214712,0.0181416918634609,0.320561556335495,0.661296751801044
3,"Niedersachsen",3355028,"Radbruch",1970,1003,967,0.509137055837563,1991,1009,982,0.506780512305374,0.0181416918634609,0.320561556335495,0.661296751801044
3,"Niedersachsen",3355029,"Rehlingen",712,359,353,0.504213483146067,722,364,358,0.50415512465374,0.0181416918634609,0.320561556335495,0.661296751801044
3,"Niedersachsen",3355030,"Reinstorf",1290,614,676,0.475968992248062,1290,611,679,0.473643410852713,0.0181416918634609,0.320561556335495,0.661296751801044
3,"Niedersachsen",3355031,"Reppenstedt",7210,3478,3732,0.482385575589459,7212,3464,3748,0.480310593455352,0.0181416918634609,0.320561556335495,0.661296751801044
3,"Niedersachsen",3355032,"Rullstorf",1880,914,966,0.486170212765957,1846,898,948,0.486457204767064,0.0181416918634609,0.320561556335495,0.661296751801044
3,"Niedersachsen",3355033,"Scharnebeck",3321,1620,1701,0.48780487804878,3251,1586,1665,0.487849892340818,0.0181416918634609,0.320561556335495,0.661296751801044
3,"Niedersachsen",3355034,"Soderstorf",1444,714,730,0.494459833795014,1492,744,748,0.498659517426273,0.0181416918634609,0.320561556335495,0.661296751801044
3,"Niedersachsen",3355035,"Südergellersen",1602,784,818,0.489388264669164,1644,814,830,0.495133819951338,0.0181416918634609,0.320561556335495,0.661296751801044
3,"Niedersachsen",3355036,"Thomasburg",1291,668,623,0.517428350116189,1286,665,621,0.517107309486781,0.0181416918634609,0.320561556335495,0.661296751801044
3,"Niedersachsen",3355037,"Tosterglope",571,281,290,0.492119089316988,627,307,320,0.4896331738437,0.0181416918634609,0.320561556335495,0.661296751801044
3,"Niedersachsen",3355038,"Vastorf",815,447,368,0.548466257668712,894,502,392,0.561521252796421,0.0181416918634609,0.320561556335495,0.661296751801044
3,"Niedersachsen",3355039,"Vögelsen",2255,1062,1193,0.470953436807095,2297,1087,1210,0.473225946887244,0.0181416918634609,0.320561556335495,0.661296751801044
3,"Niedersachsen",3355040,"Wendisch Evern",1781,871,910,0.489051094890511,1779,859,920,0.482855536818437,0.0181416918634609,0.320561556335495,0.661296751801044
3,"Niedersachsen",3355041,"Westergellersen",1758,850,908,0.483503981797497,1773,862,911,0.486181613085166,0.0181416918634609,0.320561556335495,0.661296751801044
3,"Niedersachsen",3355042,"Wittorf",1443,730,713,0.505890505890506,1451,733,718,0.505168849069607,0.0181416918634609,0.320561556335495,0.661296751801044
3,"Niedersachsen",3355049,"Amt Neuhaus",4830,2454,2376,0.508074534161491,4883,2467,2416,0.50522219946754,0.0181416918634609,0.320561556335495,0.661296751801044
3,"Niedersachsen",3356001,"Axstedt",1115,573,542,0.51390134529148,1115,589,526,0.528251121076233,0.0181416918634609,0.320561556335495,0.661296751801044
3,"Niedersachsen",3356002,"Grasberg",7628,3793,3835,0.497246984792868,7580,3761,3819,0.496174142480211,0.0181416918634609,0.320561556335495,0.661296751801044
3,"Niedersachsen",3356003,"Hambergen",5753,2805,2948,0.487571701720841,5462,2638,2824,0.482973269864518,0.0181416918634609,0.320561556335495,0.661296751801044
3,"Niedersachsen",3356004,"Holste",1301,673,628,0.517294388931591,1355,707,648,0.521771217712177,0.0181416918634609,0.320561556335495,0.661296751801044
3,"Niedersachsen",3356005,"Lilienthal",18104,8707,9397,0.480943437914273,18430,8938,9492,0.484970157352143,0.0181416918634609,0.320561556335495,0.661296751801044
3,"Niedersachsen",3356006,"Lübberstedt",750,392,358,0.522666666666667,750,380,370,0.506666666666667,0.0181416918634609,0.320561556335495,0.661296751801044
3,"Niedersachsen",3356007,"Osterholz-Scharmbeck, Stadt",30097,14763,15334,0.490514004718078,29978,14686,15292,0.489892587897792,0.0181416918634609,0.320561556335495,0.661296751801044
3,"Niedersachsen",3356008,"Ritterhude",14455,7134,7321,0.493531649948115,14699,7318,7381,0.497856997074631,0.0181416918634609,0.320561556335495,0.661296751801044
3,"Niedersachsen",3356009,"Schwanewede",19484,9548,9936,0.49004311229727,19943,9935,10008,0.49816978388407,0.0181416918634609,0.320561556335495,0.661296751801044
3,"Niedersachsen",3356010,"Vollersode",2932,1497,1435,0.510572987721692,3030,1539,1491,0.507920792079208,0.0181416918634609,0.320561556335495,0.661296751801044
3,"Niedersachsen",3356011,"Worpswede",9223,4421,4802,0.479345115472189,9376,4519,4857,0.481975255972696,0.0181416918634609,0.320561556335495,0.661296751801044
3,"Niedersachsen",3357001,"Ahausen",1828,923,905,0.50492341356674,1852,929,923,0.501619870410367,0.0181416918634609,0.320561556335495,0.661296751801044
3,"Niedersachsen",3357002,"Alfstedt",856,432,424,0.504672897196262,830,417,413,0.502409638554217,0.0181416918634609,0.320561556335495,0.661296751801044
3,"Niedersachsen",3357003,"Anderlingen",897,463,434,0.516164994425864,898,468,430,0.521158129175947,0.0181416918634609,0.320561556335495,0.661296751801044
3,"Niedersachsen",3357004,"Basdahl",1475,744,731,0.504406779661017,1491,760,731,0.50972501676727,0.0181416918634609,0.320561556335495,0.661296751801044
3,"Niedersachsen",3357005,"Bötersen",1061,540,521,0.508953817153629,1080,551,529,0.510185185185185,0.0181416918634609,0.320561556335495,0.661296751801044
3,"Niedersachsen",3357006,"Bothel",2482,1232,1250,0.496373892022562,2453,1215,1238,0.495311863024868,0.0181416918634609,0.320561556335495,0.661296751801044
3,"Niedersachsen",3357007,"Breddorf",1092,559,533,0.511904761904762,1117,574,543,0.513876454789615,0.0181416918634609,0.320561556335495,0.661296751801044
3,"Niedersachsen",3357008,"Bremervörde, Stadt",18637,9296,9341,0.498792724150883,18556,9224,9332,0.497089890062513,0.0181416918634609,0.320561556335495,0.661296751801044
3,"Niedersachsen",3357009,"Brockel",1329,656,673,0.493604213694507,1346,668,678,0.4962852897474,0.0181416918634609,0.320561556335495,0.661296751801044
3,"Niedersachsen",3357010,"Bülstedt",738,379,359,0.513550135501355,734,386,348,0.525885558583106,0.0181416918634609,0.320561556335495,0.661296751801044
3,"Niedersachsen",3357011,"Deinstedt",662,329,333,0.496978851963746,679,339,340,0.499263622974963,0.0181416918634609,0.320561556335495,0.661296751801044
3,"Niedersachsen",3357012,"Ebersdorf",1047,541,506,0.516714422158548,1032,540,492,0.523255813953488,0.0181416918634609,0.320561556335495,0.661296751801044
3,"Niedersachsen",3357013,"Elsdorf",2019,1020,999,0.50520059435364,2028,1034,994,0.509861932938856,0.0181416918634609,0.320561556335495,0.661296751801044
3,"Niedersachsen",3357014,"Farven",650,344,306,0.529230769230769,680,359,321,0.527941176470588,0.0181416918634609,0.320561556335495,0.661296751801044
3,"Niedersachsen",3357015,"Fintel",2855,1408,1447,0.493169877408056,2879,1419,1460,0.492879472038902,0.0181416918634609,0.320561556335495,0.661296751801044
3,"Niedersachsen",3357016,"Gnarrenburg",9260,4629,4631,0.499892008639309,9203,4588,4615,0.498533087036836,0.0181416918634609,0.320561556335495,0.661296751801044
3,"Niedersachsen",3357017,"Groß Meckelsen",470,237,233,0.504255319148936,484,247,237,0.510330578512397,0.0181416918634609,0.320561556335495,0.661296751801044
3,"Niedersachsen",3357018,"Gyhum",2261,1148,1113,0.507739938080495,2333,1183,1150,0.507072438919846,0.0181416918634609,0.320561556335495,0.661296751801044
3,"Niedersachsen",3357019,"Hamersen",465,228,237,0.490322580645161,464,224,240,0.482758620689655,0.0181416918634609,0.320561556335495,0.661296751801044
3,"Niedersachsen",3357020,"Hassendorf",1142,572,570,0.500875656742557,1170,585,585,0.5,0.0181416918634609,0.320561556335495,0.661296751801044
3,"Niedersachsen",3357021,"Heeslingen",4653,2315,2338,0.497528476251881,4814,2425,2389,0.503739094308268,0.0181416918634609,0.320561556335495,0.661296751801044
3,"Niedersachsen",3357022,"Hellwege",1052,529,523,0.502851711026616,1102,547,555,0.496370235934664,0.0181416918634609,0.320561556335495,0.661296751801044
3,"Niedersachsen",3357023,"Helvesiek",758,391,367,0.515831134564644,811,406,405,0.500616522811344,0.0181416918634609,0.320561556335495,0.661296751801044
3,"Niedersachsen",3357024,"Hemsbünde",1149,572,577,0.497824194952132,1221,604,617,0.494676494676495,0.0181416918634609,0.320561556335495,0.661296751801044
3,"Niedersachsen",3357025,"Hemslingen",1424,701,723,0.492275280898876,1505,743,762,0.493687707641196,0.0181416918634609,0.320561556335495,0.661296751801044
3,"Niedersachsen",3357026,"Hepstedt",1015,498,517,0.49064039408867,1052,526,526,0.5,0.0181416918634609,0.320561556335495,0.661296751801044
3,"Niedersachsen",3357027,"Hipstedt",1255,639,616,0.509163346613546,1264,645,619,0.510284810126582,0.0181416918634609,0.320561556335495,0.661296751801044
3,"Niedersachsen",3357028,"Horstedt",1284,652,632,0.507788161993769,1319,671,648,0.508718726307809,0.0181416918634609,0.320561556335495,0.661296751801044
3,"Niedersachsen",3357029,"Kalbe",574,285,289,0.496515679442509,570,290,280,0.508771929824561,0.0181416918634609,0.320561556335495,0.661296751801044
3,"Niedersachsen",3357030,"Kirchtimke",976,485,491,0.496926229508197,978,484,494,0.494887525562372,0.0181416918634609,0.320561556335495,0.661296751801044
3,"Niedersachsen",3357031,"Kirchwalsede",1174,609,565,0.518739352640545,1247,658,589,0.52766639935846,0.0181416918634609,0.320561556335495,0.661296751801044
3,"Niedersachsen",3357032,"Klein Meckelsen",898,458,440,0.510022271714922,948,488,460,0.514767932489452,0.0181416918634609,0.320561556335495,0.661296751801044
3,"Niedersachsen",3357033,"Lauenbrück",2159,1073,1086,0.49698934691987,2130,1078,1052,0.506103286384976,0.0181416918634609,0.320561556335495,0.661296751801044
3,"Niedersachsen",3357034,"Lengenbostel",458,246,212,0.537117903930131,467,247,220,0.528907922912206,0.0181416918634609,0.320561556335495,0.661296751801044
3,"Niedersachsen",3357035,"Oerel",1820,917,903,0.503846153846154,1846,920,926,0.498374864572048,0.0181416918634609,0.320561556335495,0.661296751801044
3,"Niedersachsen",3357036,"Ostereistedt",924,483,441,0.522727272727273,941,500,441,0.53134962805526,0.0181416918634609,0.320561556335495,0.661296751801044
3,"Niedersachsen",3357037,"Reeßum",1655,830,825,0.501510574018127,1719,865,854,0.503199534613147,0.0181416918634609,0.320561556335495,0.661296751801044
3,"Niedersachsen",3357038,"Rhade",1130,564,566,0.499115044247788,1144,583,561,0.509615384615385,0.0181416918634609,0.320561556335495,0.661296751801044
3,"Niedersachsen",3357039,"Rotenburg (Wümme), Stadt",21082,10254,10828,0.486386490845271,21817,10746,11071,0.49255167988266,0.0181416918634609,0.320561556335495,0.661296751801044
3,"Niedersachsen",3357040,"Sandbostel",804,416,388,0.517412935323383,837,444,393,0.530465949820789,0.0181416918634609,0.320561556335495,0.661296751801044
3,"Niedersachsen",3357041,"Scheeßel",13005,6525,6480,0.501730103806228,12750,6383,6367,0.500627450980392,0.0181416918634609,0.320561556335495,0.661296751801044
3,"Niedersachsen",3357042,"Seedorf",1045,712,333,0.68133971291866,888,571,317,0.643018018018018,0.0181416918634609,0.320561556335495,0.661296751801044
3,"Niedersachsen",3357043,"Selsingen",3512,1714,1798,0.488041002277904,3429,1679,1750,0.489647127442403,0.0181416918634609,0.320561556335495,0.661296751801044
3,"Niedersachsen",3357044,"Sittensen",5588,2754,2834,0.492841803865426,5490,2735,2755,0.498178506375228,0.0181416918634609,0.320561556335495,0.661296751801044
3,"Niedersachsen",3357045,"Sottrum",6240,3071,3169,0.492147435897436,6023,2988,3035,0.49609828988876,0.0181416918634609,0.320561556335495,0.661296751801044
3,"Niedersachsen",3357046,"Stemmen",885,465,420,0.525423728813559,890,474,416,0.532584269662921,0.0181416918634609,0.320561556335495,0.661296751801044
3,"Niedersachsen",3357047,"Tarmstedt",3704,1860,1844,0.502159827213823,3486,1723,1763,0.494262765347103,0.0181416918634609,0.320561556335495,0.661296751801044
3,"Niedersachsen",3357048,"Tiste",863,450,413,0.52143684820394,875,467,408,0.533714285714286,0.0181416918634609,0.320561556335495,0.661296751801044
3,"Niedersachsen",3357049,"Vahlde",656,350,306,0.533536585365854,683,367,316,0.537335285505124,0.0181416918634609,0.320561556335495,0.661296751801044
3,"Niedersachsen",3357050,"Vierden",779,402,377,0.51604621309371,801,419,382,0.523096129837703,0.0181416918634609,0.320561556335495,0.661296751801044
3,"Niedersachsen",3357051,"Visselhövede, Stadt",10137,4997,5140,0.492946631153201,10209,5076,5133,0.497208345577432,0.0181416918634609,0.320561556335495,0.661296751801044
3,"Niedersachsen",3357052,"Vorwerk",1044,525,519,0.502873563218391,1052,520,532,0.494296577946768,0.0181416918634609,0.320561556335495,0.661296751801044
3,"Niedersachsen",3357053,"Westertimke",477,234,243,0.490566037735849,620,380,240,0.612903225806452,0.0181416918634609,0.320561556335495,0.661296751801044
3,"Niedersachsen",3357054,"Westerwalsede",716,345,371,0.481843575418994,779,372,407,0.477535301668806,0.0181416918634609,0.320561556335495,0.661296751801044
3,"Niedersachsen",3357055,"Wilstedt",1749,885,864,0.506003430531732,1739,865,874,0.497412305922944,0.0181416918634609,0.320561556335495,0.661296751801044
3,"Niedersachsen",3357056,"Wohnste",788,417,371,0.529187817258883,779,412,367,0.528883183568678,0.0181416918634609,0.320561556335495,0.661296751801044
3,"Niedersachsen",3357057,"Zeven, Stadt",13524,6791,6733,0.502144335995268,13429,6706,6723,0.4993670414774,0.0181416918634609,0.320561556335495,0.661296751801044
3,"Niedersachsen",3358001,"Ahlden (Aller), Flecken",1542,759,783,0.492217898832685,1511,713,798,0.471872931833223,0.0181416918634609,0.320561556335495,0.661296751801044
3,"Niedersachsen",3358002,"Bispingen",6263,3089,3174,0.493214114641546,6201,3054,3147,0.492501209482342,0.0181416918634609,0.320561556335495,0.661296751801044
3,"Niedersachsen",3358003,"Böhme",903,474,429,0.524916943521595,911,488,423,0.535675082327113,0.0181416918634609,0.320561556335495,0.661296751801044
3,"Niedersachsen",3358004,"Bomlitz",7043,3487,3556,0.495101519238961,6915,3413,3502,0.493564714389009,0.0181416918634609,0.320561556335495,0.661296751801044
3,"Niedersachsen",3358005,"Buchholz (Aller)",2076,1059,1017,0.510115606936416,2090,1053,1037,0.503827751196172,0.0181416918634609,0.320561556335495,0.661296751801044
3,"Niedersachsen",3358006,"Eickeloh",766,379,387,0.494778067885117,782,397,385,0.5076726342711,0.0181416918634609,0.320561556335495,0.661296751801044
3,"Niedersachsen",3358007,"Essel",1072,551,521,0.513992537313433,1083,549,534,0.506925207756233,0.0181416918634609,0.320561556335495,0.661296751801044
3,"Niedersachsen",3358008,"Bad Fallingbostel, Stadt",10826,5231,5595,0.483188619988916,11329,5490,5839,0.484597051813929,0.0181416918634609,0.320561556335495,0.661296751801044
3,"Niedersachsen",3358009,"Frankenfeld",504,250,254,0.496031746031746,525,251,274,0.478095238095238,0.0181416918634609,0.320561556335495,0.661296751801044
3,"Niedersachsen",3358010,"Gilten",1181,600,581,0.508044030482642,1176,589,587,0.500850340136054,0.0181416918634609,0.320561556335495,0.661296751801044
3,"Niedersachsen",3358011,"Grethem",659,317,342,0.48103186646434,673,321,352,0.476968796433878,0.0181416918634609,0.320561556335495,0.661296751801044
3,"Niedersachsen",3358012,"Hademstorf",835,419,416,0.501796407185629,837,431,406,0.514934289127838,0.0181416918634609,0.320561556335495,0.661296751801044
3,"Niedersachsen",3358013,"Häuslingen",829,432,397,0.521109770808203,864,450,414,0.520833333333333,0.0181416918634609,0.320561556335495,0.661296751801044
3,"Niedersachsen",3358014,"Hodenhagen",3165,1585,1580,0.500789889415482,3151,1588,1563,0.503966994604887,0.0181416918634609,0.320561556335495,0.661296751801044
3,"Niedersachsen",3358015,"Lindwedel",2558,1269,1289,0.496090695856138,2605,1306,1299,0.501343570057582,0.0181416918634609,0.320561556335495,0.661296751801044
3,"Niedersachsen",3358016,"Munster, Stadt",14688,7330,7358,0.499046840958606,15923,8506,7417,0.534195817371098,0.0181416918634609,0.320561556335495,0.661296751801044
3,"Niedersachsen",3358017,"Neuenkirchen",5561,2766,2795,0.49739255529581,5605,2797,2808,0.499018733273863,0.0181416918634609,0.320561556335495,0.661296751801044
3,"Niedersachsen",3358018,"Rethem (Aller), Stadt",2368,1160,1208,0.489864864864865,2266,1107,1159,0.488526037069726,0.0181416918634609,0.320561556335495,0.661296751801044
3,"Niedersachsen",3358019,"Schneverdingen, Stadt",18750,9060,9690,0.4832,18864,9343,9521,0.495282018659881,0.0181416918634609,0.320561556335495,0.661296751801044
3,"Niedersachsen",3358020,"Schwarmstedt",5302,2565,2737,0.483779705771407,5172,2508,2664,0.48491879350348,0.0181416918634609,0.320561556335495,0.661296751801044
3,"Niedersachsen",3358021,"Soltau, Stadt",21112,10321,10791,0.488868889730959,21672,10658,11014,0.491786637135474,0.0181416918634609,0.320561556335495,0.661296751801044
3,"Niedersachsen",3358022,"Walsrode, Stadt",23329,11493,11836,0.492648634746453,23870,11780,12090,0.493506493506494,0.0181416918634609,0.320561556335495,0.661296751801044
3,"Niedersachsen",3358023,"Wietzendorf",4099,2060,2039,0.502561600390339,4022,2014,2008,0.500745897563401,0.0181416918634609,0.320561556335495,0.661296751801044
3,"Niedersachsen",3358501,"Osterheide, gemfr. Bezirk",641,322,319,0.502340093603744,737,436,301,0.591587516960651,0.0181416918634609,0.320561556335495,0.661296751801044
3,"Niedersachsen",3359001,"Agathenburg",1145,566,579,0.494323144104803,1161,568,593,0.489233419465978,0.0181416918634609,0.320561556335495,0.661296751801044
3,"Niedersachsen",3359002,"Ahlerstedt",5061,2523,2538,0.498518079430943,5059,2560,2499,0.506028859458391,0.0181416918634609,0.320561556335495,0.661296751801044
3,"Niedersachsen",3359003,"Apensen",3580,1836,1744,0.512849162011173,3413,1758,1655,0.515089364195722,0.0181416918634609,0.320561556335495,0.661296751801044
3,"Niedersachsen",3359004,"Balje",1012,495,517,0.489130434782609,1025,491,534,0.479024390243902,0.0181416918634609,0.320561556335495,0.661296751801044
3,"Niedersachsen",3359005,"Bargstedt",2023,1045,978,0.516559565002472,2034,1051,983,0.516715830875123,0.0181416918634609,0.320561556335495,0.661296751801044
3,"Niedersachsen",3359006,"Beckdorf",2615,1319,1296,0.504397705544933,2560,1303,1257,0.508984375,0.0181416918634609,0.320561556335495,0.661296751801044
3,"Niedersachsen",3359007,"Bliedersdorf",1717,902,815,0.525334886429819,1741,930,811,0.534175761056864,0.0181416918634609,0.320561556335495,0.661296751801044
3,"Niedersachsen",3359008,"Brest",800,415,385,0.51875,805,412,393,0.511801242236025,0.0181416918634609,0.320561556335495,0.661296751801044
3,"Niedersachsen",3359009,"Burweg",971,506,465,0.521112255406797,971,502,469,0.516992790937178,0.0181416918634609,0.320561556335495,0.661296751801044
3,"Niedersachsen",3359010,"Buxtehude, Stadt",39858,20205,19653,0.506924582267048,40152,20324,19828,0.506176529189082,0.0181416918634609,0.320561556335495,0.661296751801044
3,"Niedersachsen",3359011,"Deinste",2053,1044,1009,0.50852411105699,2131,1095,1036,0.513843266072266,0.0181416918634609,0.320561556335495,0.661296751801044
3,"Niedersachsen",3359012,"Dollern",1856,918,938,0.494612068965517,1841,926,915,0.502987506789788,0.0181416918634609,0.320561556335495,0.661296751801044
3,"Niedersachsen",3359013,"Drochtersen",11249,5565,5684,0.494710640945862,11759,5970,5789,0.507696232672846,0.0181416918634609,0.320561556335495,0.661296751801044
3,"Niedersachsen",3359014,"Düdenbüttel",982,483,499,0.491853360488798,948,468,480,0.493670886075949,0.0181416918634609,0.320561556335495,0.661296751801044
3,"Niedersachsen",3359015,"Engelschoff",760,385,375,0.506578947368421,766,387,379,0.505221932114883,0.0181416918634609,0.320561556335495,0.661296751801044
3,"Niedersachsen",3359016,"Estorf",1409,717,692,0.508871540099361,1420,713,707,0.502112676056338,0.0181416918634609,0.320561556335495,0.661296751801044
3,"Niedersachsen",3359017,"Fredenbeck",5899,2968,2931,0.50313612476691,5769,2880,2889,0.499219968798752,0.0181416918634609,0.320561556335495,0.661296751801044
3,"Niedersachsen",3359018,"Freiburg (Elbe), Flecken",1934,938,996,0.485005170630817,1770,860,910,0.485875706214689,0.0181416918634609,0.320561556335495,0.661296751801044
3,"Niedersachsen",3359019,"Großenwörden",485,250,235,0.515463917525773,462,236,226,0.510822510822511,0.0181416918634609,0.320561556335495,0.661296751801044
3,"Niedersachsen",3359020,"Grünendeich",1866,906,960,0.485530546623794,1881,927,954,0.492822966507177,0.0181416918634609,0.320561556335495,0.661296751801044
3,"Niedersachsen",3359021,"Guderhandviertel",1117,551,566,0.493285586392122,1184,579,605,0.48902027027027,0.0181416918634609,0.320561556335495,0.661296751801044
3,"Niedersachsen",3359022,"Hammah",2840,1452,1388,0.511267605633803,2880,1479,1401,0.513541666666667,0.0181416918634609,0.320561556335495,0.661296751801044
3,"Niedersachsen",3359023,"Harsefeld, Flecken",12157,5940,6217,0.488607386690795,12387,6079,6308,0.49075643820134,0.0181416918634609,0.320561556335495,0.661296751801044
3,"Niedersachsen",3359024,"Heinbockel",1485,747,738,0.503030303030303,1516,775,741,0.511213720316623,0.0181416918634609,0.320561556335495,0.661296751801044
3,"Niedersachsen",3359025,"Himmelpforten",4934,2428,2506,0.492095662748277,4896,2426,2470,0.495506535947712,0.0181416918634609,0.320561556335495,0.661296751801044
3,"Niedersachsen",3359026,"Hollern-Twielenfleth",3326,1702,1624,0.511725796752856,3363,1733,1630,0.515313707998811,0.0181416918634609,0.320561556335495,0.661296751801044
3,"Niedersachsen",3359027,"Horneburg, Flecken",5679,2821,2858,0.496742384222574,5556,2737,2819,0.492620590352772,0.0181416918634609,0.320561556335495,0.661296751801044
3,"Niedersachsen",3359028,"Jork",11578,5859,5719,0.506045949214027,11796,5958,5838,0.505086469989827,0.0181416918634609,0.320561556335495,0.661296751801044
3,"Niedersachsen",3359029,"Kranenburg",719,373,346,0.518776077885953,731,384,347,0.52530779753762,0.0181416918634609,0.320561556335495,0.661296751801044
3,"Niedersachsen",3359030,"Krummendeich",509,257,252,0.504911591355599,449,217,232,0.483296213808463,0.0181416918634609,0.320561556335495,0.661296751801044
3,"Niedersachsen",3359031,"Kutenholz",4724,2347,2377,0.496824724809483,4727,2383,2344,0.5041252379945,0.0181416918634609,0.320561556335495,0.661296751801044
3,"Niedersachsen",3359032,"Mittelnkirchen",994,521,473,0.524144869215292,1024,530,494,0.517578125,0.0181416918634609,0.320561556335495,0.661296751801044
3,"Niedersachsen",3359033,"Neuenkirchen",842,424,418,0.503562945368171,854,434,420,0.508196721311475,0.0181416918634609,0.320561556335495,0.661296751801044
3,"Niedersachsen",3359034,"Nottensdorf",1358,660,698,0.4860088365243,1442,720,722,0.499306518723994,0.0181416918634609,0.320561556335495,0.661296751801044
3,"Niedersachsen",3359035,"Oederquart",1105,568,537,0.514027149321267,1113,568,545,0.510332434860737,0.0181416918634609,0.320561556335495,0.661296751801044
3,"Niedersachsen",3359036,"Oldendorf",2859,1407,1452,0.492130115424974,2843,1411,1432,0.496306718255364,0.0181416918634609,0.320561556335495,0.661296751801044
3,"Niedersachsen",3359037,"Sauensiek",2293,1143,1150,0.498473615351068,2312,1141,1171,0.493512110726644,0.0181416918634609,0.320561556335495,0.661296751801044
3,"Niedersachsen",3359038,"Stade, Hansestadt",45198,21681,23517,0.479689366786141,46235,22315,23920,0.482643019357629,0.0181416918634609,0.320561556335495,0.661296751801044
3,"Niedersachsen",3359039,"Steinkirchen",1572,783,789,0.498091603053435,1536,763,773,0.496744791666667,0.0181416918634609,0.320561556335495,0.661296751801044
3,"Niedersachsen",3359040,"Wischhafen",3042,1576,1466,0.518080210387903,3008,1533,1475,0.509640957446808,0.0181416918634609,0.320561556335495,0.661296751801044
3,"Niedersachsen",3360001,"Altenmedingen",1538,747,791,0.485695708712614,1541,747,794,0.484750162232317,0.0181416918634609,0.320561556335495,0.661296751801044
3,"Niedersachsen",3360002,"Bad Bevensen, Stadt",8786,3953,4833,0.449920327794218,8693,3890,4803,0.44748648337743,0.0181416918634609,0.320561556335495,0.661296751801044
3,"Niedersachsen",3360003,"Barum",829,407,422,0.490952955367913,816,389,427,0.47671568627451,0.0181416918634609,0.320561556335495,0.661296751801044
3,"Niedersachsen",3360004,"Bienenbüttel",6632,3301,3331,0.497738238841978,6626,3311,3315,0.499698158768488,0.0181416918634609,0.320561556335495,0.661296751801044
3,"Niedersachsen",3360005,"Bad Bodenteich, Flecken",3813,1846,1967,0.484133228429058,3900,1890,2010,0.484615384615385,0.0181416918634609,0.320561556335495,0.661296751801044
3,"Niedersachsen",3360006,"Ebstorf,Klosterflecken",5444,2669,2775,0.490264511388685,5303,2614,2689,0.492928531020177,0.0181416918634609,0.320561556335495,0.661296751801044
3,"Niedersachsen",3360007,"Eimke",845,435,410,0.514792899408284,898,445,453,0.49554565701559,0.0181416918634609,0.320561556335495,0.661296751801044
3,"Niedersachsen",3360008,"Emmendorf",761,358,403,0.470433639947438,737,352,385,0.477611940298507,0.0181416918634609,0.320561556335495,0.661296751801044
3,"Niedersachsen",3360009,"Gerdau",1480,749,731,0.506081081081081,1502,764,738,0.508655126498003,0.0181416918634609,0.320561556335495,0.661296751801044
3,"Niedersachsen",3360010,"Hanstedt",928,464,464,0.5,897,446,451,0.497212931995541,0.0181416918634609,0.320561556335495,0.661296751801044
3,"Niedersachsen",3360011,"Himbergen",1747,876,871,0.501431024613623,1706,862,844,0.505275498241501,0.0181416918634609,0.320561556335495,0.661296751801044
3,"Niedersachsen",3360012,"Jelmstorf",783,396,387,0.505747126436782,809,412,397,0.509270704573548,0.0181416918634609,0.320561556335495,0.661296751801044
3,"Niedersachsen",3360013,"Lüder",1256,616,640,0.490445859872611,1269,619,650,0.487785657998424,0.0181416918634609,0.320561556335495,0.661296751801044
3,"Niedersachsen",3360014,"Natendorf",798,389,409,0.487468671679198,806,405,401,0.502481389578164,0.0181416918634609,0.320561556335495,0.661296751801044
3,"Niedersachsen",3360015,"Oetzen",1164,592,572,0.508591065292096,1207,636,571,0.526926263463132,0.0181416918634609,0.320561556335495,0.661296751801044
3,"Niedersachsen",3360016,"Rätzlingen",483,237,246,0.490683229813665,499,240,259,0.480961923847695,0.0181416918634609,0.320561556335495,0.661296751801044
3,"Niedersachsen",3360017,"Römstedt",785,387,398,0.492993630573248,784,390,394,0.497448979591837,0.0181416918634609,0.320561556335495,0.661296751801044
3,"Niedersachsen",3360018,"Rosche",2069,1018,1051,0.492025132914451,2010,1008,1002,0.501492537313433,0.0181416918634609,0.320561556335495,0.661296751801044
3,"Niedersachsen",3360019,"Schwienau",722,368,354,0.509695290858726,730,386,344,0.528767123287671,0.0181416918634609,0.320561556335495,0.661296751801044
3,"Niedersachsen",3360020,"Soltendieck",1009,491,518,0.486620416253717,1022,488,534,0.477495107632094,0.0181416918634609,0.320561556335495,0.661296751801044
3,"Niedersachsen",3360022,"Stoetze",629,308,321,0.48966613672496,644,323,321,0.501552795031056,0.0181416918634609,0.320561556335495,0.661296751801044
3,"Niedersachsen",3360023,"Suderburg",4585,2279,2306,0.497055616139586,4534,2287,2247,0.504411116012351,0.0181416918634609,0.320561556335495,0.661296751801044
3,"Niedersachsen",3360024,"Suhlendorf",2566,1257,1309,0.489867498051442,2561,1273,1288,0.497071456462319,0.0181416918634609,0.320561556335495,0.661296751801044
3,"Niedersachsen",3360025,"Uelzen, Stadt",33467,16082,17385,0.480533062419697,34055,16383,17672,0.481074732051094,0.0181416918634609,0.320561556335495,0.661296751801044
3,"Niedersachsen",3360026,"Weste",1002,485,517,0.484031936127745,988,477,511,0.482793522267206,0.0181416918634609,0.320561556335495,0.661296751801044
3,"Niedersachsen",3360029,"Wriedel",2439,1220,1219,0.50020500205002,2466,1231,1235,0.49918896999189,0.0181416918634609,0.320561556335495,0.661296751801044
3,"Niedersachsen",3360030,"Wrestedt",6724,3289,3435,0.489143367043427,6561,3221,3340,0.490931260478586,0.0181416918634609,0.320561556335495,0.661296751801044
3,"Niedersachsen",3361001,"Achim, Stadt",29598,14369,15229,0.485471991350767,30258,14800,15458,0.489126842487937,0.0181416918634609,0.320561556335495,0.661296751801044
3,"Niedersachsen",3361002,"Blender",2902,1481,1421,0.510337698139214,2892,1475,1417,0.510027662517289,0.0181416918634609,0.320561556335495,0.661296751801044
3,"Niedersachsen",3361003,"Dörverden",9011,4482,4529,0.497392076351126,9076,4560,4516,0.502423975319524,0.0181416918634609,0.320561556335495,0.661296751801044
3,"Niedersachsen",3361004,"Emtinghausen",1531,764,767,0.499020248203788,1565,774,791,0.494568690095847,0.0181416918634609,0.320561556335495,0.661296751801044
3,"Niedersachsen",3361005,"Kirchlinteln",10033,5014,5019,0.499750822286455,10239,5133,5106,0.501318488133607,0.0181416918634609,0.320561556335495,0.661296751801044
3,"Niedersachsen",3361006,"Langwedel, Flecken",14421,7098,7323,0.492198876638236,14552,7160,7392,0.492028587135789,0.0181416918634609,0.320561556335495,0.661296751801044
3,"Niedersachsen",3361008,"Ottersberg, Flecken",12118,5863,6255,0.483825713814161,11981,5846,6135,0.487939237125449,0.0181416918634609,0.320561556335495,0.661296751801044
3,"Niedersachsen",3361009,"Oyten",15356,7436,7920,0.484240687679083,15540,7643,7897,0.491827541827542,0.0181416918634609,0.320561556335495,0.661296751801044
3,"Niedersachsen",3361010,"Riede",2695,1357,1338,0.503525046382189,2741,1373,1368,0.500912075884714,0.0181416918634609,0.320561556335495,0.661296751801044
3,"Niedersachsen",3361012,"Verden (Aller), Stadt",26599,12608,13991,0.474002782059476,26729,12819,13910,0.479591454973998,0.0181416918634609,0.320561556335495,0.661296751801044
3,"Niedersachsen",3361013,"Thedinghausen",7672,3821,3851,0.498044838373306,7461,3762,3699,0.504221954161641,0.0181416918634609,0.320561556335495,0.661296751801044
3,"Niedersachsen",3401000,"Delmenhorst, Stadt",73364,35942,37422,0.489913308979881,74497,36713,37784,0.492811791078835,0.0181416918634609,0.320561556335495,0.661296751801044
3,"Niedersachsen",3402000,"Emden, Stadt",49848,24433,25415,0.490150056170759,51528,25688,25840,0.498525073746313,0.0181416918634609,0.320561556335495,0.661296751801044
3,"Niedersachsen",3403000,"Oldenburg (Oldenburg), Stadt",157706,74619,83087,0.473152575044703,162481,78432,84049,0.482714902050086,0.0181416918634609,0.320561556335495,0.661296751801044
3,"Niedersachsen",3404000,"Osnabrück, Stadt",154513,73525,80988,0.475849928484982,165021,79147,85874,0.479617745620254,0.0181416918634609,0.320561556335495,0.661296751801044
3,"Niedersachsen",3405000,"Wilhelmshaven, Stadt",76926,37783,39143,0.491160335907236,81020,41143,39877,0.507812885707233,0.0181416918634609,0.320561556335495,0.661296751801044
3,"Niedersachsen",3451001,"Apen",11085,5519,5566,0.4978800180424,11054,5516,5538,0.499004885109463,0.0181416918634609,0.320561556335495,0.661296751801044
3,"Niedersachsen",3451002,"Bad Zwischenahn",27531,13200,14331,0.47945951836112,27897,13505,14392,0.484102233215041,0.0181416918634609,0.320561556335495,0.661296751801044
3,"Niedersachsen",3451004,"Edewecht",21049,10352,10697,0.491804836334268,21324,10542,10782,0.494372537985369,0.0181416918634609,0.320561556335495,0.661296751801044
3,"Niedersachsen",3451005,"Rastede",21046,10307,10739,0.489736767081631,20953,10221,10732,0.487806042094211,0.0181416918634609,0.320561556335495,0.661296751801044
3,"Niedersachsen",3451007,"Westerstede, Stadt",21893,10680,11213,0.487827159366007,22071,10868,11203,0.492410855874224,0.0181416918634609,0.320561556335495,0.661296751801044
3,"Niedersachsen",3451008,"Wiefelstede",15347,7645,7702,0.498142959536066,15539,7776,7763,0.500418302336058,0.0181416918634609,0.320561556335495,0.661296751801044
3,"Niedersachsen",3452001,"Aurich, Stadt",40606,19743,20863,0.486208934640201,40416,19566,20850,0.484115201900238,0.0181416918634609,0.320561556335495,0.661296751801044
3,"Niedersachsen",3452002,"Baltrum",546,242,304,0.443223443223443,511,239,272,0.467710371819961,0.0181416918634609,0.320561556335495,0.661296751801044
3,"Niedersachsen",3452003,"Berumbur",2594,1277,1317,0.492289899768697,2580,1265,1315,0.49031007751938,0.0181416918634609,0.320561556335495,0.661296751801044
3,"Niedersachsen",3452006,"Großefehn",13532,6778,6754,0.500886786875554,13394,6643,6751,0.495968344034642,0.0181416918634609,0.320561556335495,0.661296751801044
3,"Niedersachsen",3452007,"Großheide",8495,4271,4224,0.502766333137139,8604,4335,4269,0.503835425383543,0.0181416918634609,0.320561556335495,0.661296751801044
3,"Niedersachsen",3452008,"Hage, Flecken",6045,2911,3134,0.481555004135649,5833,2790,3043,0.478313046459798,0.0181416918634609,0.320561556335495,0.661296751801044
3,"Niedersachsen",3452009,"Hagermarsch",432,224,208,0.518518518518518,432,224,208,0.518518518518518,0.0181416918634609,0.320561556335495,0.661296751801044
3,"Niedersachsen",3452010,"Halbemond",995,476,519,0.478391959798995,1073,518,555,0.482758620689655,0.0181416918634609,0.320561556335495,0.661296751801044
3,"Niedersachsen",3452011,"Hinte",6956,3440,3516,0.494537090281771,6978,3439,3539,0.492834623101175,0.0181416918634609,0.320561556335495,0.661296751801044
3,"Niedersachsen",3452012,"Ihlow",12095,5983,6112,0.494667217858619,12378,6159,6219,0.497576345128454,0.0181416918634609,0.320561556335495,0.661296751801044
3,"Niedersachsen",3452013,"Juist",1509,702,807,0.465208747514911,1772,786,986,0.443566591422122,0.0181416918634609,0.320561556335495,0.661296751801044
3,"Niedersachsen",3452014,"Krummhörn",12469,6125,6344,0.491218221188548,12418,6122,6296,0.492994040908359,0.0181416918634609,0.320561556335495,0.661296751801044
3,"Niedersachsen",3452015,"Leezdorf",1790,878,912,0.490502793296089,1914,947,967,0.494775339602926,0.0181416918634609,0.320561556335495,0.661296751801044
3,"Niedersachsen",3452016,"Lütetsburg",741,360,381,0.48582995951417,778,400,378,0.51413881748072,0.0181416918634609,0.320561556335495,0.661296751801044
3,"Niedersachsen",3452017,"Marienhafe, Flecken",2223,1030,1193,0.463337831758884,2115,952,1163,0.450118203309693,0.0181416918634609,0.320561556335495,0.661296751801044
3,"Niedersachsen",3452019,"Norden, Stadt",25010,12074,12936,0.482766893242703,25019,11981,13038,0.478876054198809,0.0181416918634609,0.320561556335495,0.661296751801044
3,"Niedersachsen",3452020,"Norderney, Stadt",5787,2638,3149,0.455849317435632,5776,2572,3204,0.445290858725762,0.0181416918634609,0.320561556335495,0.661296751801044
3,"Niedersachsen",3452021,"Osteel",2216,1109,1107,0.500451263537906,2279,1161,1118,0.509433962264151,0.0181416918634609,0.320561556335495,0.661296751801044
3,"Niedersachsen",3452022,"Rechtsupweg",2068,1056,1012,0.51063829787234,2100,1065,1035,0.507142857142857,0.0181416918634609,0.320561556335495,0.661296751801044
3,"Niedersachsen",3452023,"Südbrookmerland",18549,9182,9367,0.495013208259205,18969,9463,9506,0.498866571775001,0.0181416918634609,0.320561556335495,0.661296751801044
3,"Niedersachsen",3452024,"Upgant-Schott",3798,1905,1893,0.501579778830964,3877,1962,1915,0.506061387670879,0.0181416918634609,0.320561556335495,0.661296751801044
3,"Niedersachsen",3452025,"Wiesmoor, Stadt",12670,6133,6537,0.48405682715075,13335,6528,6807,0.489538807649044,0.0181416918634609,0.320561556335495,0.661296751801044
3,"Niedersachsen",3452026,"Wirdum",1048,526,522,0.501908396946565,1031,520,511,0.504364694471387,0.0181416918634609,0.320561556335495,0.661296751801044
3,"Niedersachsen",3452027,"Dornum",4539,2190,2349,0.482485128883014,4748,2277,2471,0.479570345408593,0.0181416918634609,0.320561556335495,0.661296751801044
3,"Niedersachsen",3453001,"Barßel",12432,6219,6213,0.500241312741313,12616,6352,6264,0.503487634749524,0.0181416918634609,0.320561556335495,0.661296751801044
3,"Niedersachsen",3453002,"Bösel",7430,3770,3660,0.507402422611036,7539,3834,3705,0.508555511341027,0.0181416918634609,0.320561556335495,0.661296751801044
3,"Niedersachsen",3453003,"Cappeln (Oldenburg)",6566,3437,3129,0.523454157782516,6766,3579,3187,0.528968371268105,0.0181416918634609,0.320561556335495,0.661296751801044
3,"Niedersachsen",3453004,"Cloppenburg, Stadt",32994,16281,16713,0.493453355155483,32640,16085,16555,0.492800245098039,0.0181416918634609,0.320561556335495,0.661296751801044
3,"Niedersachsen",3453005,"Emstek",11479,5815,5664,0.506577227981531,11627,5994,5633,0.515524210888449,0.0181416918634609,0.320561556335495,0.661296751801044
3,"Niedersachsen",3453006,"Essen (Oldenburg)",8334,4369,3965,0.524238060955124,8261,4385,3876,0.530807408304079,0.0181416918634609,0.320561556335495,0.661296751801044
3,"Niedersachsen",3453007,"Friesoythe, Stadt",20960,10452,10508,0.498664122137405,20736,10407,10329,0.501880787037037,0.0181416918634609,0.320561556335495,0.661296751801044
3,"Niedersachsen",3453008,"Garrel",14041,7153,6888,0.509436649811267,13406,6906,6500,0.51514247351932,0.0181416918634609,0.320561556335495,0.661296751801044
3,"Niedersachsen",3453009,"Lastrup",6710,3411,3299,0.508345752608048,6814,3487,3327,0.511740534194306,0.0181416918634609,0.320561556335495,0.661296751801044
3,"Niedersachsen",3453010,"Lindern (Oldenburg)",4659,2360,2299,0.506546469199399,4645,2350,2295,0.505920344456405,0.0181416918634609,0.320561556335495,0.661296751801044
3,"Niedersachsen",3453011,"Löningen, Stadt",12882,6437,6445,0.49968948920975,13057,6618,6439,0.506854560772,0.0181416918634609,0.320561556335495,0.661296751801044
3,"Niedersachsen",3453012,"Molbergen",7797,4009,3788,0.514172117481082,7845,4042,3803,0.515232632249841,0.0181416918634609,0.320561556335495,0.661296751801044
3,"Niedersachsen",3453013,"Saterland",13006,6569,6437,0.505074580962633,13050,6572,6478,0.50360153256705,0.0181416918634609,0.320561556335495,0.661296751801044
3,"Niedersachsen",3454001,"Andervenne",881,447,434,0.507377979568672,918,465,453,0.506535947712418,0.0181416918634609,0.320561556335495,0.661296751801044
3,"Niedersachsen",3454002,"Bawinkel",2339,1173,1166,0.501496365968363,2379,1204,1175,0.506094997898277,0.0181416918634609,0.320561556335495,0.661296751801044
3,"Niedersachsen",3454003,"Beesten",1629,856,773,0.525475751995089,1657,864,793,0.52142426071213,0.0181416918634609,0.320561556335495,0.661296751801044
3,"Niedersachsen",3454004,"Bockhorst",994,511,483,0.514084507042254,970,493,477,0.508247422680412,0.0181416918634609,0.320561556335495,0.661296751801044
3,"Niedersachsen",3454005,"Börger",2712,1343,1369,0.495206489675516,2745,1381,1364,0.503096539162113,0.0181416918634609,0.320561556335495,0.661296751801044
3,"Niedersachsen",3454006,"Breddenberg",762,382,380,0.501312335958005,773,387,386,0.500646830530401,0.0181416918634609,0.320561556335495,0.661296751801044
3,"Niedersachsen",3454007,"Dersum",1477,753,724,0.509817197020988,1455,759,696,0.521649484536083,0.0181416918634609,0.320561556335495,0.661296751801044
3,"Niedersachsen",3454008,"Dörpen",4803,2393,2410,0.4982302727462,4991,2491,2500,0.499098377078742,0.0181416918634609,0.320561556335495,0.661296751801044
3,"Niedersachsen",3454009,"Dohren",1099,560,539,0.509554140127389,1140,585,555,0.513157894736842,0.0181416918634609,0.320561556335495,0.661296751801044
3,"Niedersachsen",3454010,"Emsbüren",9797,4943,4854,0.504542206797999,10005,5090,4915,0.508745627186407,0.0181416918634609,0.320561556335495,0.661296751801044
3,"Niedersachsen",3454011,"Esterwegen",5192,2646,2546,0.509630200308166,5259,2693,2566,0.51207453888572,0.0181416918634609,0.320561556335495,0.661296751801044
3,"Niedersachsen",3454012,"Freren, Stadt",5003,2510,2493,0.501698980611633,5078,2504,2574,0.493107522646711,0.0181416918634609,0.320561556335495,0.661296751801044
3,"Niedersachsen",3454013,"Fresenburg",922,474,448,0.51409978308026,908,468,440,0.515418502202643,0.0181416918634609,0.320561556335495,0.661296751801044
3,"Niedersachsen",3454014,"Geeste",11169,5686,5483,0.509087653326171,11191,5724,5467,0.511482441247431,0.0181416918634609,0.320561556335495,0.661296751801044
3,"Niedersachsen",3454015,"Gersten",1224,618,606,0.504901960784314,1222,607,615,0.496726677577741,0.0181416918634609,0.320561556335495,0.661296751801044
3,"Niedersachsen",3454016,"Groß Berßen",684,363,321,0.530701754385965,693,362,331,0.522366522366522,0.0181416918634609,0.320561556335495,0.661296751801044
3,"Niedersachsen",3454017,"Handrup",867,453,414,0.522491349480969,881,457,424,0.518728717366629,0.0181416918634609,0.320561556335495,0.661296751801044
3,"Niedersachsen",3454018,"Haren (Ems), Stadt",22801,11588,11213,0.508223323538441,23050,11638,11412,0.504902386117137,0.0181416918634609,0.320561556335495,0.661296751801044
3,"Niedersachsen",3454019,"Haselünne, Stadt",12375,6196,6179,0.500686868686869,12887,6564,6323,0.509350508264142,0.0181416918634609,0.320561556335495,0.661296751801044
3,"Niedersachsen",3454020,"Heede",2368,1223,1145,0.516469594594595,2311,1179,1132,0.510168758113371,0.0181416918634609,0.320561556335495,0.661296751801044
3,"Niedersachsen",3454021,"Herzlake",4297,2353,1944,0.5475913427973,4125,2233,1892,0.541333333333333,0.0181416918634609,0.320561556335495,0.661296751801044
3,"Niedersachsen",3454022,"Hilkenbrook",833,433,400,0.519807923169268,844,443,401,0.524881516587678,0.0181416918634609,0.320561556335495,0.661296751801044
3,"Niedersachsen",3454023,"Hüven",550,290,260,0.527272727272727,560,293,267,0.523214285714286,0.0181416918634609,0.320561556335495,0.661296751801044
3,"Niedersachsen",3454024,"Klein Berßen",1138,579,559,0.508787346221441,1155,584,571,0.505627705627706,0.0181416918634609,0.320561556335495,0.661296751801044
3,"Niedersachsen",3454025,"Kluse",1552,813,739,0.523840206185567,1534,812,722,0.529335071707953,0.0181416918634609,0.320561556335495,0.661296751801044
3,"Niedersachsen",3454026,"Lähden",4587,2373,2214,0.517331589274035,4571,2363,2208,0.516954714504485,0.0181416918634609,0.320561556335495,0.661296751801044
3,"Niedersachsen",3454027,"Lahn",880,465,415,0.528409090909091,874,461,413,0.52745995423341,0.0181416918634609,0.320561556335495,0.661296751801044
3,"Niedersachsen",3454028,"Langen",1447,714,733,0.493434692467173,1438,718,720,0.499304589707928,0.0181416918634609,0.320561556335495,0.661296751801044
3,"Niedersachsen",3454029,"Lathen",6035,2993,3042,0.495940347970174,6000,2959,3041,0.493166666666667,0.0181416918634609,0.320561556335495,0.661296751801044
3,"Niedersachsen",3454030,"Lehe",1023,532,491,0.520039100684262,984,510,474,0.518292682926829,0.0181416918634609,0.320561556335495,0.661296751801044
3,"Niedersachsen",3454031,"Lengerich",2650,1335,1315,0.50377358490566,2582,1296,1286,0.501936483346243,0.0181416918634609,0.320561556335495,0.661296751801044
3,"Niedersachsen",3454032,"Lingen (Ems), Stadt",51735,25526,26209,0.493399052865565,51007,25133,25874,0.4927362910973,0.0181416918634609,0.320561556335495,0.661296751801044
3,"Niedersachsen",3454033,"Lorup",3273,1821,1452,0.556370302474794,3236,1806,1430,0.558096415327565,0.0181416918634609,0.320561556335495,0.661296751801044
3,"Niedersachsen",3454034,"Lünne",1840,946,894,0.514130434782609,1880,954,926,0.507446808510638,0.0181416918634609,0.320561556335495,0.661296751801044
3,"Niedersachsen",3454035,"Meppen, Stadt",33909,16762,17147,0.494323041080539,34875,17501,17374,0.501820788530466,0.0181416918634609,0.320561556335495,0.661296751801044
3,"Niedersachsen",3454036,"Messingen",1084,553,531,0.510147601476015,1085,556,529,0.512442396313364,0.0181416918634609,0.320561556335495,0.661296751801044
3,"Niedersachsen",3454037,"Neubörger",1578,790,788,0.50063371356147,1556,781,775,0.501928020565553,0.0181416918634609,0.320561556335495,0.661296751801044
3,"Niedersachsen",3454038,"Neulehe",731,375,356,0.512995896032832,692,367,325,0.530346820809249,0.0181416918634609,0.320561556335495,0.661296751801044
3,"Niedersachsen",3454039,"Niederlangen",1240,640,600,0.516129032258065,1221,633,588,0.518427518427518,0.0181416918634609,0.320561556335495,0.661296751801044
3,"Niedersachsen",3454040,"Oberlangen",960,488,472,0.508333333333333,976,494,482,0.506147540983607,0.0181416918634609,0.320561556335495,0.661296751801044
3,"Niedersachsen",3454041,"Papenburg, Stadt",35194,17453,17741,0.495908393476161,35237,17685,17552,0.501887220819025,0.0181416918634609,0.320561556335495,0.661296751801044
3,"Niedersachsen",3454042,"Rastdorf",1008,515,493,0.510912698412698,1005,518,487,0.515422885572139,0.0181416918634609,0.320561556335495,0.661296751801044
3,"Niedersachsen",3454043,"Renkenberge",699,359,340,0.513590844062947,695,356,339,0.512230215827338,0.0181416918634609,0.320561556335495,0.661296751801044
3,"Niedersachsen",3454044,"Rhede (Ems)",4195,2190,2005,0.522050059594756,4213,2221,1992,0.527177783052457,0.0181416918634609,0.320561556335495,0.661296751801044
3,"Niedersachsen",3454045,"Salzbergen",7527,3777,3750,0.50179354324432,7492,3765,3727,0.502536038441004,0.0181416918634609,0.320561556335495,0.661296751801044
3,"Niedersachsen",3454046,"Schapen",2347,1218,1129,0.518960374946741,2405,1235,1170,0.513513513513513,0.0181416918634609,0.320561556335495,0.661296751801044
3,"Niedersachsen",3454047,"Sögel",6944,3583,3361,0.515985023041475,7286,3804,3482,0.522097172659896,0.0181416918634609,0.320561556335495,0.661296751801044
3,"Niedersachsen",3454048,"Spahnharrenstätte",1451,752,699,0.518263266712612,1443,744,699,0.515592515592516,0.0181416918634609,0.320561556335495,0.661296751801044
3,"Niedersachsen",3454049,"Spelle",8602,4381,4221,0.509300162752848,8602,4397,4205,0.511160195303418,0.0181416918634609,0.320561556335495,0.661296751801044
3,"Niedersachsen",3454050,"Stavern",1077,562,515,0.521819870009285,1097,575,522,0.52415679124886,0.0181416918634609,0.320561556335495,0.661296751801044
3,"Niedersachsen",3454051,"Surwold",4294,2211,2083,0.514904517931998,4314,2272,2042,0.526657394529439,0.0181416918634609,0.320561556335495,0.661296751801044
3,"Niedersachsen",3454052,"Sustrum",1334,690,644,0.517241379310345,1322,687,635,0.519667170953101,0.0181416918634609,0.320561556335495,0.661296751801044
3,"Niedersachsen",3454053,"Thuine",1790,807,983,0.450837988826816,1931,828,1103,0.428793371310202,0.0181416918634609,0.320561556335495,0.661296751801044
3,"Niedersachsen",3454054,"Twist",9636,4892,4744,0.507679535076795,9615,4884,4731,0.50795631825273,0.0181416918634609,0.320561556335495,0.661296751801044
3,"Niedersachsen",3454055,"Vrees",1657,910,747,0.549185274592637,1679,915,764,0.544967242406194,0.0181416918634609,0.320561556335495,0.661296751801044
3,"Niedersachsen",3454056,"Walchum",1455,745,710,0.512027491408935,1435,733,702,0.510801393728223,0.0181416918634609,0.320561556335495,0.661296751801044
3,"Niedersachsen",3454057,"Werlte",9483,4761,4722,0.502056311293894,9562,4820,4742,0.504078644635014,0.0181416918634609,0.320561556335495,0.661296751801044
3,"Niedersachsen",3454058,"Werpeloh",1030,543,487,0.527184466019417,1074,571,503,0.531657355679702,0.0181416918634609,0.320561556335495,0.661296751801044
3,"Niedersachsen",3454059,"Wettrup",561,299,262,0.532976827094474,547,286,261,0.522851919561243,0.0181416918634609,0.320561556335495,0.661296751801044
3,"Niedersachsen",3454060,"Wippingen",910,469,441,0.515384615384615,877,455,422,0.518814139110604,0.0181416918634609,0.320561556335495,0.661296751801044
3,"Niedersachsen",3455007,"Jever, Stadt",13924,6681,7243,0.4798190175237,13877,6659,7218,0.479858759097788,0.0181416918634609,0.320561556335495,0.661296751801044
3,"Niedersachsen",3455014,"Sande",9166,4473,4693,0.487999127209252,9087,4437,4650,0.488279960382965,0.0181416918634609,0.320561556335495,0.661296751801044
3,"Niedersachsen",3455015,"Schortens, Stadt",20339,10034,10305,0.493337922218398,20587,10126,10461,0.491863797542138,0.0181416918634609,0.320561556335495,0.661296751801044
3,"Niedersachsen",3455020,"Wangerland",9244,4537,4707,0.490804846386846,9918,4924,4994,0.496471062714257,0.0181416918634609,0.320561556335495,0.661296751801044
3,"Niedersachsen",3455021,"Wangerooge, Nordseebad",1278,594,684,0.464788732394366,868,399,469,0.459677419354839,0.0181416918634609,0.320561556335495,0.661296751801044
3,"Niedersachsen",3455025,"Bockhorn",8503,4248,4255,0.499588380571563,8586,4285,4301,0.499068250640578,0.0181416918634609,0.320561556335495,0.661296751801044
3,"Niedersachsen",3455026,"Varel, Stadt",23729,11444,12285,0.482279067807324,24596,11922,12674,0.484712961457147,0.0181416918634609,0.320561556335495,0.661296751801044
3,"Niedersachsen",3455027,"Zetel",11674,5723,5951,0.490234709611102,11677,5740,5937,0.491564614198852,0.0181416918634609,0.320561556335495,0.661296751801044
3,"Niedersachsen",3456001,"Bad Bentheim, Stadt",15070,7407,7663,0.491506303915063,15528,7618,7910,0.490597630087584,0.0181416918634609,0.320561556335495,0.661296751801044
3,"Niedersachsen",3456002,"Emlichheim",7074,3530,3544,0.499010460842522,6956,3468,3488,0.498562392179413,0.0181416918634609,0.320561556335495,0.661296751801044
3,"Niedersachsen",3456003,"Engden",445,225,220,0.50561797752809,447,225,222,0.503355704697987,0.0181416918634609,0.320561556335495,0.661296751801044
3,"Niedersachsen",3456004,"Esche",578,308,270,0.532871972318339,563,287,276,0.509769094138544,0.0181416918634609,0.320561556335495,0.661296751801044
3,"Niedersachsen",3456005,"Georgsdorf",1312,667,645,0.508384146341463,1313,667,646,0.507996953541508,0.0181416918634609,0.320561556335495,0.661296751801044
3,"Niedersachsen",3456006,"Getelo",544,287,257,0.527573529411765,662,353,309,0.533232628398791,0.0181416918634609,0.320561556335495,0.661296751801044
3,"Niedersachsen",3456007,"Gölenkamp",611,316,295,0.517184942716858,623,325,298,0.521669341894061,0.0181416918634609,0.320561556335495,0.661296751801044
3,"Niedersachsen",3456008,"Halle",667,332,335,0.497751124437781,653,323,330,0.494640122511485,0.0181416918634609,0.320561556335495,0.661296751801044
3,"Niedersachsen",3456009,"Hoogstede",2895,1466,1429,0.506390328151986,2889,1470,1419,0.508826583592939,0.0181416918634609,0.320561556335495,0.661296751801044
3,"Niedersachsen",3456010,"Isterberg",593,295,298,0.497470489038786,589,295,294,0.500848896434635,0.0181416918634609,0.320561556335495,0.661296751801044
3,"Niedersachsen",3456011,"Itterbeck",1813,924,889,0.50965250965251,1775,903,872,0.508732394366197,0.0181416918634609,0.320561556335495,0.661296751801044
3,"Niedersachsen",3456012,"Laar",2165,1105,1060,0.510392609699769,2148,1105,1043,0.514432029795158,0.0181416918634609,0.320561556335495,0.661296751801044
3,"Niedersachsen",3456013,"Lage",1093,567,526,0.51875571820677,1011,537,474,0.531157270029674,0.0181416918634609,0.320561556335495,0.661296751801044
3,"Niedersachsen",3456014,"Neuenhaus, Stadt",9831,4915,4916,0.499949140474011,9633,4798,4835,0.498079518322433,0.0181416918634609,0.320561556335495,0.661296751801044
3,"Niedersachsen",3456015,"Nordhorn, Stadt",52085,25406,26679,0.487779591053086,53058,25904,27154,0.488220438011233,0.0181416918634609,0.320561556335495,0.661296751801044
3,"Niedersachsen",3456016,"Ohne",581,297,284,0.51118760757315,552,269,283,0.48731884057971,0.0181416918634609,0.320561556335495,0.661296751801044
3,"Niedersachsen",3456017,"Osterwald",1173,592,581,0.504688832054561,1181,604,577,0.511430990685859,0.0181416918634609,0.320561556335495,0.661296751801044
3,"Niedersachsen",3456018,"Quendorf",552,267,285,0.483695652173913,572,285,287,0.498251748251748,0.0181416918634609,0.320561556335495,0.661296751801044
3,"Niedersachsen",3456019,"Ringe",2116,1111,1005,0.525047258979206,2157,1148,1009,0.532220676866018,0.0181416918634609,0.320561556335495,0.661296751801044
3,"Niedersachsen",3456020,"Samern",697,358,339,0.513629842180775,716,365,351,0.509776536312849,0.0181416918634609,0.320561556335495,0.661296751801044
3,"Niedersachsen",3456023,"Uelsen",5467,2715,2752,0.496616059996342,5431,2684,2747,0.494199963174369,0.0181416918634609,0.320561556335495,0.661296751801044
3,"Niedersachsen",3456024,"Wielen",587,316,271,0.538330494037479,569,300,269,0.527240773286467,0.0181416918634609,0.320561556335495,0.661296751801044
3,"Niedersachsen",3456025,"Wietmarschen",11423,5754,5669,0.50372056377484,11490,5821,5669,0.506614447345518,0.0181416918634609,0.320561556335495,0.661296751801044
3,"Niedersachsen",3456026,"Wilsum",1624,822,802,0.50615763546798,1620,816,804,0.503703703703704,0.0181416918634609,0.320561556335495,0.661296751801044
3,"Niedersachsen",3456027,"Schüttorf, Stadt",12404,6244,6160,0.503386004514673,12667,6299,6368,0.497276387463488,0.0181416918634609,0.320561556335495,0.661296751801044
3,"Niedersachsen",3457002,"Borkum, Stadt",5155,2407,2748,0.466925315227934,5157,2334,2823,0.452588714368819,0.0181416918634609,0.320561556335495,0.661296751801044
3,"Niedersachsen",3457003,"Brinkum",700,369,331,0.527142857142857,649,337,312,0.519260400616333,0.0181416918634609,0.320561556335495,0.661296751801044
3,"Niedersachsen",3457006,"Detern, Flecken",2670,1324,1346,0.495880149812734,2686,1342,1344,0.499627699180938,0.0181416918634609,0.320561556335495,0.661296751801044
3,"Niedersachsen",3457008,"Filsum",2101,1032,1069,0.49119466920514,2075,1029,1046,0.495903614457831,0.0181416918634609,0.320561556335495,0.661296751801044
3,"Niedersachsen",3457009,"Firrel",808,407,401,0.503712871287129,842,420,422,0.498812351543943,0.0181416918634609,0.320561556335495,0.661296751801044
3,"Niedersachsen",3457010,"Hesel",4415,2177,2238,0.493091732729332,4104,2060,2044,0.501949317738791,0.0181416918634609,0.320561556335495,0.661296751801044
3,"Niedersachsen",3457011,"Holtland",2215,1051,1164,0.474492099322799,2311,1115,1196,0.482475118996106,0.0181416918634609,0.320561556335495,0.661296751801044
3,"Niedersachsen",3457012,"Jemgum",3662,1835,1827,0.501092299290005,3598,1832,1766,0.50917176209005,0.0181416918634609,0.320561556335495,0.661296751801044
3,"Niedersachsen",3457013,"Leer (Ostfriesland), Stadt",33995,16746,17249,0.492601853213708,34285,17010,17275,0.496135336152837,0.0181416918634609,0.320561556335495,0.661296751801044
3,"Niedersachsen",3457014,"Moormerland",22566,11038,11528,0.489142958433041,22458,11035,11423,0.491361652863122,0.0181416918634609,0.320561556335495,0.661296751801044
3,"Niedersachsen",3457015,"Neukamperfehn",1582,771,811,0.487357774968394,1647,810,837,0.491803278688525,0.0181416918634609,0.320561556335495,0.661296751801044
3,"Niedersachsen",3457016,"Nortmoor",1621,832,789,0.51326341764343,1663,856,807,0.514732411304871,0.0181416918634609,0.320561556335495,0.661296751801044
3,"Niedersachsen",3457017,"Ostrhauderfehn",10452,5141,5311,0.491867585151167,10719,5330,5389,0.497247877600522,0.0181416918634609,0.320561556335495,0.661296751801044
3,"Niedersachsen",3457018,"Rhauderfehn",17257,8449,8808,0.489598423828012,17449,8597,8852,0.49269299100235,0.0181416918634609,0.320561556335495,0.661296751801044
3,"Niedersachsen",3457019,"Schwerinsdorf",726,358,368,0.493112947658402,752,363,389,0.482712765957447,0.0181416918634609,0.320561556335495,0.661296751801044
3,"Niedersachsen",3457020,"Uplengen",11359,5652,5707,0.497579012236993,11523,5745,5778,0.498568081228847,0.0181416918634609,0.320561556335495,0.661296751801044
3,"Niedersachsen",3457021,"Weener, Stadt",15479,7699,7780,0.497383551909038,15714,7835,7879,0.498599974544992,0.0181416918634609,0.320561556335495,0.661296751801044
3,"Niedersachsen",3457022,"Westoverledingen",19698,9842,9856,0.499644633972992,19817,9852,9965,0.497148912549831,0.0181416918634609,0.320561556335495,0.661296751801044
3,"Niedersachsen",3457024,"Bunde",7530,3732,3798,0.495617529880478,7547,3741,3806,0.495693653107195,0.0181416918634609,0.320561556335495,0.661296751801044
3,"Niedersachsen",3458001,"Beckeln",828,423,405,0.510869565217391,851,437,414,0.513513513513513,0.0181416918634609,0.320561556335495,0.661296751801044
3,"Niedersachsen",3458002,"Colnrade",787,420,367,0.533672172808132,801,433,368,0.540574282147316,0.0181416918634609,0.320561556335495,0.661296751801044
3,"Niedersachsen",3458003,"Dötlingen",6046,2996,3050,0.495534237512405,6112,3061,3051,0.500818062827225,0.0181416918634609,0.320561556335495,0.661296751801044
3,"Niedersachsen",3458004,"Dünsen",1169,579,590,0.495295124037639,1174,590,584,0.502555366269165,0.0181416918634609,0.320561556335495,0.661296751801044
3,"Niedersachsen",3458005,"Ganderkesee",30293,14846,15447,0.490080216551679,30927,15177,15750,0.490736249878747,0.0181416918634609,0.320561556335495,0.661296751801044
3,"Niedersachsen",3458006,"Groß Ippener",1043,529,514,0.5071907957814,1135,569,566,0.501321585903084,0.0181416918634609,0.320561556335495,0.661296751801044
3,"Niedersachsen",3458007,"Großenkneten",14048,6911,7137,0.491956150341686,14532,7206,7326,0.495871180842279,0.0181416918634609,0.320561556335495,0.661296751801044
3,"Niedersachsen",3458008,"Harpstedt, Flecken",4726,2281,2445,0.482649174777825,4447,2181,2266,0.490442995277715,0.0181416918634609,0.320561556335495,0.661296751801044
3,"Niedersachsen",3458009,"Hatten",13645,6793,6852,0.49783803591059,13854,6869,6985,0.495813483470478,0.0181416918634609,0.320561556335495,0.661296751801044
3,"Niedersachsen",3458010,"Hude (Oldb)",15829,7916,7913,0.500094762777181,15782,7875,7907,0.498986186795083,0.0181416918634609,0.320561556335495,0.661296751801044
3,"Niedersachsen",3458011,"Kirchseelte",1170,578,592,0.494017094017094,1292,670,622,0.518575851393189,0.0181416918634609,0.320561556335495,0.661296751801044
3,"Niedersachsen",3458012,"Prinzhöfte",705,349,356,0.495035460992908,763,386,377,0.505897771952818,0.0181416918634609,0.320561556335495,0.661296751801044
3,"Niedersachsen",3458013,"Wardenburg",15538,7535,8003,0.484940146737032,15948,7827,8121,0.490782543265613,0.0181416918634609,0.320561556335495,0.661296751801044
3,"Niedersachsen",3458014,"Wildeshausen, Stadt",18888,9294,9594,0.492058449809403,19372,9555,9817,0.493237662605823,0.0181416918634609,0.320561556335495,0.661296751801044
3,"Niedersachsen",3458015,"Winkelsett",550,284,266,0.516363636363636,603,310,293,0.514096185737977,0.0181416918634609,0.320561556335495,0.661296751801044
3,"Niedersachsen",3459001,"Alfhausen",3776,1915,1861,0.507150423728814,3800,1949,1851,0.512894736842105,0.0181416918634609,0.320561556335495,0.661296751801044
3,"Niedersachsen",3459002,"Ankum",7104,3518,3586,0.495213963963964,7207,3588,3619,0.497849313167754,0.0181416918634609,0.320561556335495,0.661296751801044
3,"Niedersachsen",3459003,"Bad Essen",15102,7398,7704,0.489868891537545,15592,7687,7905,0.493009235505387,0.0181416918634609,0.320561556335495,0.661296751801044
3,"Niedersachsen",3459004,"Bad Iburg, Stadt",10586,5059,5527,0.477895333459286,11601,5595,6006,0.482286009826739,0.0181416918634609,0.320561556335495,0.661296751801044
3,"Niedersachsen",3459005,"Bad Laer",9136,4478,4658,0.490148861646235,9092,4506,4586,0.495600527936648,0.0181416918634609,0.320561556335495,0.661296751801044
3,"Niedersachsen",3459006,"Bad Rothenfelde",7530,3532,3998,0.469057104913679,7531,3557,3974,0.472314433674147,0.0181416918634609,0.320561556335495,0.661296751801044
3,"Niedersachsen",3459007,"Badbergen",4436,2332,2104,0.525698827772768,4600,2433,2167,0.528913043478261,0.0181416918634609,0.320561556335495,0.661296751801044
3,"Niedersachsen",3459008,"Belm",13420,6556,6864,0.488524590163934,13516,6611,6905,0.489124001183782,0.0181416918634609,0.320561556335495,0.661296751801044
3,"Niedersachsen",3459009,"Berge",3619,1814,1805,0.50124343741365,3690,1849,1841,0.501084010840108,0.0181416918634609,0.320561556335495,0.661296751801044
3,"Niedersachsen",3459010,"Bersenbrück, Stadt",7841,3886,3955,0.495600051013901,7962,3961,4001,0.497488068324542,0.0181416918634609,0.320561556335495,0.661296751801044
3,"Niedersachsen",3459011,"Bippen",2975,1475,1500,0.495798319327731,3005,1489,1516,0.495507487520799,0.0181416918634609,0.320561556335495,0.661296751801044
3,"Niedersachsen",3459012,"Bissendorf",14346,7074,7272,0.493099121706399,14253,7009,7244,0.491756121518277,0.0181416918634609,0.320561556335495,0.661296751801044
3,"Niedersachsen",3459013,"Bohmte",12706,6330,6376,0.498189831575634,12877,6433,6444,0.499572881882426,0.0181416918634609,0.320561556335495,0.661296751801044
3,"Niedersachsen",3459014,"Bramsche, Stadt",30217,14914,15303,0.49356322599861,30992,17206,13786,0.555175529168818,0.0181416918634609,0.320561556335495,0.661296751801044
3,"Niedersachsen",3459015,"Dissen am Teutoburger Wald, Stadt",9334,4670,4664,0.500321405613885,9396,4736,4660,0.504044274159217,0.0181416918634609,0.320561556335495,0.661296751801044
3,"Niedersachsen",3459016,"Eggermühlen",1721,868,853,0.504357931435212,1744,882,862,0.505733944954128,0.0181416918634609,0.320561556335495,0.661296751801044
3,"Niedersachsen",3459017,"Fürstenau, Stadt",9140,4466,4674,0.488621444201313,9648,4750,4898,0.492330016583748,0.0181416918634609,0.320561556335495,0.661296751801044
3,"Niedersachsen",3459018,"Gehrde",2486,1243,1243,0.5,2483,1232,1251,0.496173983084978,0.0181416918634609,0.320561556335495,0.661296751801044
3,"Niedersachsen",3459019,"Georgsmarienhütte, Stadt",31984,15612,16372,0.488119059529765,32026,15598,16428,0.487041778554924,0.0181416918634609,0.320561556335495,0.661296751801044
3,"Niedersachsen",3459020,"Hagen am Teutoburger Wald",13629,6675,6954,0.48976447281532,13847,6821,7026,0.492597674586553,0.0181416918634609,0.320561556335495,0.661296751801044
3,"Niedersachsen",3459021,"Hasbergen",10965,5288,5677,0.482261741906065,11034,5359,5675,0.485680623527279,0.0181416918634609,0.320561556335495,0.661296751801044
3,"Niedersachsen",3459022,"Hilter am Teutoburger Wald",10205,5056,5149,0.495443410093092,10267,5084,5183,0.495178727963378,0.0181416918634609,0.320561556335495,0.661296751801044
3,"Niedersachsen",3459023,"Kettenkamp",1687,878,809,0.520450503852994,1720,891,829,0.518023255813953,0.0181416918634609,0.320561556335495,0.661296751801044
3,"Niedersachsen",3459024,"Melle, Stadt",45878,22614,23264,0.492915994594359,46093,22793,23300,0.494500249495585,0.0181416918634609,0.320561556335495,0.661296751801044
3,"Niedersachsen",3459025,"Menslage",2476,1255,1221,0.50686591276252,2534,1292,1242,0.509865824782952,0.0181416918634609,0.320561556335495,0.661296751801044
3,"Niedersachsen",3459026,"Merzen",3925,2030,1895,0.517197452229299,4009,2067,1942,0.515589922673984,0.0181416918634609,0.320561556335495,0.661296751801044
3,"Niedersachsen",3459027,"Neuenkirchen",4483,2240,2243,0.499665402632166,4502,2245,2257,0.498667258996002,0.0181416918634609,0.320561556335495,0.661296751801044
3,"Niedersachsen",3459028,"Nortrup",2951,1486,1465,0.503558115892918,2942,1478,1464,0.50237933378654,0.0181416918634609,0.320561556335495,0.661296751801044
3,"Niedersachsen",3459029,"Ostercappeln",9480,4682,4798,0.493881856540084,9502,4661,4841,0.49052830982951,0.0181416918634609,0.320561556335495,0.661296751801044
3,"Niedersachsen",3459030,"Quakenbrück, Stadt",12452,6155,6297,0.494298104722133,13223,6641,6582,0.502230961203963,0.0181416918634609,0.320561556335495,0.661296751801044
3,"Niedersachsen",3459031,"Rieste",3246,1621,1625,0.499383857054837,3277,1649,1628,0.503204150137321,0.0181416918634609,0.320561556335495,0.661296751801044
3,"Niedersachsen",3459032,"Voltlage",1764,914,850,0.518140589569161,1754,889,865,0.506841505131129,0.0181416918634609,0.320561556335495,0.661296751801044
3,"Niedersachsen",3459033,"Wallenhorst",23109,11196,11913,0.48448656367649,23557,11559,11998,0.490682175149637,0.0181416918634609,0.320561556335495,0.661296751801044
3,"Niedersachsen",3459034,"Glandorf",6709,3433,3276,0.511700700551498,6713,3435,3278,0.511693728586325,0.0181416918634609,0.320561556335495,0.661296751801044
3,"Niedersachsen",3460001,"Bakum",5915,2995,2920,0.506339814032122,5852,2968,2884,0.507177033492823,0.0181416918634609,0.320561556335495,0.661296751801044
3,"Niedersachsen",3460002,"Damme, Stadt",16287,8092,8195,0.496837968932277,16416,8166,8250,0.497441520467836,0.0181416918634609,0.320561556335495,0.661296751801044
3,"Niedersachsen",3460003,"Dinklage, Stadt",12596,6305,6291,0.500555731978406,12912,6558,6354,0.507899628252788,0.0181416918634609,0.320561556335495,0.661296751801044
3,"Niedersachsen",3460004,"Goldenstedt",9282,4675,4607,0.503663003663004,9337,4707,4630,0.504123380100675,0.0181416918634609,0.320561556335495,0.661296751801044
3,"Niedersachsen",3460005,"Holdorf",6546,3308,3238,0.505346776657501,6555,3343,3212,0.509992372234935,0.0181416918634609,0.320561556335495,0.661296751801044
3,"Niedersachsen",3460006,"Lohne (Oldenburg), Stadt",25045,12533,12512,0.500419245358355,26363,13232,13131,0.501915563479118,0.0181416918634609,0.320561556335495,0.661296751801044
3,"Niedersachsen",3460007,"Neuenkirchen-Vörden",7832,3937,3895,0.502681307456588,7944,4007,3937,0.504405840886203,0.0181416918634609,0.320561556335495,0.661296751801044
3,"Niedersachsen",3460008,"Steinfeld (Oldenburg)",9584,4850,4734,0.506051752921536,9686,4908,4778,0.506710716498038,0.0181416918634609,0.320561556335495,0.661296751801044
3,"Niedersachsen",3460009,"Vechta, Stadt",30423,14983,15440,0.492489235118167,32104,15815,16289,0.492617742337403,0.0181416918634609,0.320561556335495,0.661296751801044
3,"Niedersachsen",3460010,"Visbek",9242,4703,4539,0.508872538411599,9326,4764,4562,0.510829937808278,0.0181416918634609,0.320561556335495,0.661296751801044
3,"Niedersachsen",3461001,"Berne",6917,3462,3455,0.500505999710857,6872,3459,3413,0.503346915017462,0.0181416918634609,0.320561556335495,0.661296751801044
3,"Niedersachsen",3461002,"Brake (Unterweser), Stadt",15038,7293,7745,0.484971405772044,15523,7680,7843,0.494749726212717,0.0181416918634609,0.320561556335495,0.661296751801044
3,"Niedersachsen",3461003,"Butjadingen",6251,3068,3183,0.490801471764518,6195,3047,3148,0.491848264729621,0.0181416918634609,0.320561556335495,0.661296751801044
3,"Niedersachsen",3461004,"Elsfleth, Stadt",9144,4673,4471,0.511045494313211,9114,4651,4463,0.510313802940531,0.0181416918634609,0.320561556335495,0.661296751801044
3,"Niedersachsen",3461005,"Jade",5786,2903,2883,0.501728309713101,5724,2882,2842,0.503494060097834,0.0181416918634609,0.320561556335495,0.661296751801044
3,"Niedersachsen",3461006,"Lemwerder",6942,3465,3477,0.499135695764909,6908,3421,3487,0.495222929936306,0.0181416918634609,0.320561556335495,0.661296751801044
3,"Niedersachsen",3461007,"Nordenham, Stadt",26416,13051,13365,0.494056632344034,26706,13208,13498,0.494570508499963,0.0181416918634609,0.320561556335495,0.661296751801044
3,"Niedersachsen",3461008,"Ovelgönne",5513,2760,2753,0.50063486305097,5481,2779,2702,0.507024265644955,0.0181416918634609,0.320561556335495,0.661296751801044
3,"Niedersachsen",3461009,"Stadland",7520,3758,3762,0.499734042553191,7459,3756,3703,0.503552755061,0.0181416918634609,0.320561556335495,0.661296751801044
3,"Niedersachsen",3462001,"Blomberg",1669,823,846,0.493109646494907,1589,787,802,0.49528005034613,0.0181416918634609,0.320561556335495,0.661296751801044
3,"Niedersachsen",3462002,"Dunum",1115,530,585,0.475336322869955,1135,549,586,0.483700440528634,0.0181416918634609,0.320561556335495,0.661296751801044
3,"Niedersachsen",3462003,"Esens, Stadt",7247,3362,3885,0.463916103215123,6959,3213,3746,0.461704267854577,0.0181416918634609,0.320561556335495,0.661296751801044
3,"Niedersachsen",3462004,"Eversmeer",813,411,402,0.505535055350554,845,436,409,0.515976331360947,0.0181416918634609,0.320561556335495,0.661296751801044
3,"Niedersachsen",3462005,"Friedeburg",10135,4968,5167,0.490182535767144,10356,5103,5253,0.492757821552723,0.0181416918634609,0.320561556335495,0.661296751801044
3,"Niedersachsen",3462006,"Holtgast",1735,873,862,0.503170028818444,1812,906,906,0.5,0.0181416918634609,0.320561556335495,0.661296751801044
3,"Niedersachsen",3462007,"Langeoog",1731,808,923,0.466782206816869,1968,903,1065,0.458841463414634,0.0181416918634609,0.320561556335495,0.661296751801044
3,"Niedersachsen",3462008,"Moorweg",849,418,431,0.492343934040047,883,432,451,0.489241223103058,0.0181416918634609,0.320561556335495,0.661296751801044
3,"Niedersachsen",3462009,"Nenndorf",744,355,389,0.477150537634409,726,344,382,0.473829201101928,0.0181416918634609,0.320561556335495,0.661296751801044
3,"Niedersachsen",3462010,"Neuharlingersiel",1021,497,524,0.486777668952008,1104,551,553,0.499094202898551,0.0181416918634609,0.320561556335495,0.661296751801044
3,"Niedersachsen",3462011,"Neuschoo",1157,590,567,0.509939498703544,1185,588,597,0.49620253164557,0.0181416918634609,0.320561556335495,0.661296751801044
3,"Niedersachsen",3462012,"Ochtersum",930,469,461,0.504301075268817,925,459,466,0.496216216216216,0.0181416918634609,0.320561556335495,0.661296751801044
3,"Niedersachsen",3462013,"Schweindorf",685,328,357,0.478832116788321,701,341,360,0.486447931526391,0.0181416918634609,0.320561556335495,0.661296751801044
3,"Niedersachsen",3462014,"Spiekeroog",748,365,383,0.487967914438503,775,364,411,0.469677419354839,0.0181416918634609,0.320561556335495,0.661296751801044
3,"Niedersachsen",3462015,"Stedesdorf",1560,798,762,0.511538461538461,1649,831,818,0.503941782898726,0.0181416918634609,0.320561556335495,0.661296751801044
3,"Niedersachsen",3462016,"Utarp",637,322,315,0.505494505494505,654,340,314,0.519877675840979,0.0181416918634609,0.320561556335495,0.661296751801044
3,"Niedersachsen",3462017,"Werdum",744,367,377,0.493279569892473,731,367,364,0.502051983584131,0.0181416918634609,0.320561556335495,0.661296751801044
3,"Niedersachsen",3462018,"Westerholt",2514,1207,1307,0.480111376292761,2354,1122,1232,0.476635514018692,0.0181416918634609,0.320561556335495,0.661296751801044
3,"Niedersachsen",3462019,"Wittmund, Stadt",20538,10004,10534,0.487097088324082,20659,10144,10515,0.491020862578053,0.0181416918634609,0.320561556335495,0.661296751801044
4,"Bremen",4011000,"Bremen, Stadt",544043,264337,279706,0.485875197364914,548319,266554,281765,0.486129424659733,0.000403779374949528,0.264435112654446,0.735161107970605
4,"Bremen",4012000,"Bremerhaven, Stadt",108139,52776,55363,0.488038542986342,112982,56223,56759,0.497627940733922,0.000403779374949528,0.264435112654446,0.735161107970605
5,"Nordrhein-Westfalen",5111000,"Düsseldorf, Stadt",589649,283216,306433,0.480312864093724,592393,282408,309985,0.47672406662469,0.00491407099468635,0.290295190050447,0.704792660014677
5,"Nordrhein-Westfalen",5112000,"Duisburg, Stadt",487470,237546,249924,0.487303834082097,488005,239730,248275,0.49124496675239,0.00491407099468635,0.290295190050447,0.704792660014677
5,"Nordrhein-Westfalen",5113000,"Essen, Stadt",565900,270912,294988,0.478727690404665,573468,276029,297439,0.481332872976347,0.00491407099468635,0.290295190050447,0.704792660014677
5,"Nordrhein-Westfalen",5114000,"Krefeld, Stadt",221864,106744,115120,0.481123571196769,234396,114084,120312,0.486714790354784,0.00491407099468635,0.290295190050447,0.704792660014677
5,"Nordrhein-Westfalen",5116000,"Mönchengladbach, Stadt",254834,123662,131172,0.485264917554173,257208,124957,132251,0.485820814282604,0.00491407099468635,0.290295190050447,0.704792660014677
5,"Nordrhein-Westfalen",5117000,"Mülheim an der Ruhr, Stadt",166804,79254,87550,0.475132490827558,167156,80226,86930,0.479946875972146,0.00491407099468635,0.290295190050447,0.704792660014677
5,"Nordrhein-Westfalen",5119000,"Oberhausen, Stadt",210256,102009,108247,0.485165702762347,212568,103548,109020,0.487128824658462,0.00491407099468635,0.290295190050447,0.704792660014677
5,"Nordrhein-Westfalen",5120000,"Remscheid, Stadt",110132,53747,56385,0.488023462753786,109596,53346,56250,0.486751341289828,0.00491407099468635,0.290295190050447,0.704792660014677
5,"Nordrhein-Westfalen",5122000,"Solingen, Stadt",155080,74669,80411,0.481486974464792,159699,77409,82290,0.484718125974489,0.00491407099468635,0.290295190050447,0.704792660014677
5,"Nordrhein-Westfalen",5124000,"Wuppertal, Stadt",342570,164808,177762,0.481092915316578,349470,168999,180471,0.483586573954846,0.00491407099468635,0.290295190050447,0.704792660014677
5,"Nordrhein-Westfalen",5154004,"Bedburg-Hau",12608,6393,6215,0.507059010152284,13231,6696,6535,0.50608419620588,0.00491407099468635,0.290295190050447,0.704792660014677
5,"Nordrhein-Westfalen",5154008,"Emmerich am Rhein, Stadt",29944,14815,15129,0.494756879508416,29621,14687,14934,0.495830660679923,0.00491407099468635,0.290295190050447,0.704792660014677
5,"Nordrhein-Westfalen",5154012,"Geldern, Stadt",32889,16226,16663,0.493356441363374,33637,16570,17067,0.492612301929423,0.00491407099468635,0.290295190050447,0.704792660014677
5,"Nordrhein-Westfalen",5154016,"Goch, Stadt",32750,16254,16496,0.49630534351145,34125,16911,17214,0.49556043956044,0.00491407099468635,0.290295190050447,0.704792660014677
5,"Nordrhein-Westfalen",5154020,"Issum",11848,5742,6106,0.484638757596219,11871,5722,6149,0.482014994524471,0.00491407099468635,0.290295190050447,0.704792660014677
5,"Nordrhein-Westfalen",5154024,"Kalkar, Stadt",13705,6762,6943,0.493396570594673,13791,6830,6961,0.49525052570517,0.00491407099468635,0.290295190050447,0.704792660014677
5,"Nordrhein-Westfalen",5154028,"Kerken",12521,6126,6395,0.48925804648191,12675,6254,6421,0.493412228796844,0.00491407099468635,0.290295190050447,0.704792660014677
5,"Nordrhein-Westfalen",5154032,"Kevelaer, Stadt",27553,13398,14155,0.486262838892317,28402,13871,14531,0.488381099922541,0.00491407099468635,0.290295190050447,0.704792660014677
5,"Nordrhein-Westfalen",5154036,"Kleve, Stadt",47622,23123,24499,0.485552895720465,49621,24421,25200,0.492150500796034,0.00491407099468635,0.290295190050447,0.704792660014677
5,"Nordrhein-Westfalen",5154040,"Kranenburg",10164,5061,5103,0.497933884297521,9972,4987,4985,0.500100280786201,0.00491407099468635,0.290295190050447,0.704792660014677
5,"Nordrhein-Westfalen",5154044,"Rees, Stadt",21402,10463,10939,0.488879543967853,22097,11091,11006,0.501923338009685,0.00491407099468635,0.290295190050447,0.704792660014677
5,"Nordrhein-Westfalen",5154048,"Rheurdt",6685,3315,3370,0.495886312640239,6742,3381,3361,0.501483239394838,0.00491407099468635,0.290295190050447,0.704792660014677
5,"Nordrhein-Westfalen",5154052,"Straelen, Stadt",15350,7652,7698,0.498501628664495,15411,7728,7683,0.501459996106677,0.00491407099468635,0.290295190050447,0.704792660014677
5,"Nordrhein-Westfalen",5154056,"Uedem",8136,4034,4102,0.495821042281219,8125,4037,4088,0.496861538461538,0.00491407099468635,0.290295190050447,0.704792660014677
5,"Nordrhein-Westfalen",5154060,"Wachtendonk",7856,3860,3996,0.491344195519348,7942,3916,4026,0.493074792243767,0.00491407099468635,0.290295190050447,0.704792660014677
5,"Nordrhein-Westfalen",5154064,"Weeze",10138,5056,5082,0.498717695797988,10822,5640,5182,0.521160598780262,0.00491407099468635,0.290295190050447,0.704792660014677
5,"Nordrhein-Westfalen",5158004,"Erkrath, Stadt",43812,20929,22883,0.477700173468456,46042,22194,23848,0.482038139090396,0.00491407099468635,0.290295190050447,0.704792660014677
5,"Nordrhein-Westfalen",5158008,"Haan, Stadt",29794,14160,15634,0.475263475867624,29240,13886,15354,0.474897400820793,0.00491407099468635,0.290295190050447,0.704792660014677
5,"Nordrhein-Westfalen",5158012,"Heiligenhaus, Stadt",25479,12361,13118,0.485144628910083,26462,12996,13466,0.491119340941728,0.00491407099468635,0.290295190050447,0.704792660014677
5,"Nordrhein-Westfalen",5158016,"Hilden, Stadt",54500,26176,28324,0.480293577981651,55508,26680,28828,0.480651437630612,0.00491407099468635,0.290295190050447,0.704792660014677
5,"Nordrhein-Westfalen",5158020,"Langenfeld (Rheinland), Stadt",56989,27667,29322,0.48547965396831,59248,28916,30332,0.488050229543613,0.00491407099468635,0.290295190050447,0.704792660014677
5,"Nordrhein-Westfalen",5158024,"Mettmann, Stadt",37874,18154,19720,0.479326186830015,39156,18935,20221,0.483578506486873,0.00491407099468635,0.290295190050447,0.704792660014677
5,"Nordrhein-Westfalen",5158026,"Monheim am Rhein, Stadt",40254,19299,20955,0.479430615590997,43038,21138,21900,0.491147358148613,0.00491407099468635,0.290295190050447,0.704792660014677
5,"Nordrhein-Westfalen",5158028,"Ratingen, Stadt",86882,41303,45579,0.475391910867614,90982,43564,47418,0.478819986370931,0.00491407099468635,0.290295190050447,0.704792660014677
5,"Nordrhein-Westfalen",5158032,"Velbert, Stadt",81192,39315,41877,0.484222583505764,83563,40500,43063,0.484664265284875,0.00491407099468635,0.290295190050447,0.704792660014677
5,"Nordrhein-Westfalen",5158036,"Wülfrath, Stadt",21143,10185,10958,0.481719718110013,21218,10289,10929,0.48491846545386,0.00491407099468635,0.290295190050447,0.704792660014677
5,"Nordrhein-Westfalen",5162004,"Dormagen, Stadt",62312,30597,31715,0.491029015277956,63019,31282,31737,0.496389977625795,0.00491407099468635,0.290295190050447,0.704792660014677
5,"Nordrhein-Westfalen",5162008,"Grevenbroich, Stadt",61374,29776,31598,0.485156580962623,63488,31370,32118,0.494109122983871,0.00491407099468635,0.290295190050447,0.704792660014677
5,"Nordrhein-Westfalen",5162012,"Jüchen",22177,10970,11207,0.494656626234387,22639,11173,11466,0.493528866115995,0.00491407099468635,0.290295190050447,0.704792660014677
5,"Nordrhein-Westfalen",5162016,"Kaarst, Stadt",41941,20078,21863,0.478720106816719,42162,20300,21862,0.481476210805939,0.00491407099468635,0.290295190050447,0.704792660014677
5,"Nordrhein-Westfalen",5162020,"Korschenbroich, Stadt",32026,15497,16529,0.483888090926123,33022,16121,16901,0.488189691720671,0.00491407099468635,0.290295190050447,0.704792660014677
5,"Nordrhein-Westfalen",5162022,"Meerbusch, Stadt",54378,25812,28566,0.4746772591857,54572,25921,28651,0.474987172909184,0.00491407099468635,0.290295190050447,0.704792660014677
5,"Nordrhein-Westfalen",5162024,"Neuss, Stadt",151070,72947,78123,0.482868868736347,152010,73572,78438,0.48399447404776,0.00491407099468635,0.290295190050447,0.704792660014677
5,"Nordrhein-Westfalen",5162028,"Rommerskirchen",12454,6110,6344,0.490605427974948,12938,6440,6498,0.497758540732725,0.00491407099468635,0.290295190050447,0.704792660014677
5,"Nordrhein-Westfalen",5166004,"Brüggen",15486,7540,7946,0.48689138576779,15828,7767,8061,0.490712661106899,0.00491407099468635,0.290295190050447,0.704792660014677
5,"Nordrhein-Westfalen",5166008,"Grefrath",14915,7282,7633,0.4882333221589,15524,7605,7919,0.489886627157949,0.00491407099468635,0.290295190050447,0.704792660014677
5,"Nordrhein-Westfalen",5166012,"Kempen, Stadt",34937,16960,17977,0.485445229985402,35694,17334,18360,0.485627836611195,0.00491407099468635,0.290295190050447,0.704792660014677
5,"Nordrhein-Westfalen",5166016,"Nettetal, Stadt",41429,20359,21070,0.491419054285645,41716,20448,21268,0.49017163678205,0.00491407099468635,0.290295190050447,0.704792660014677
5,"Nordrhein-Westfalen",5166020,"Niederkrüchten",15049,7311,7738,0.485813010831284,15414,7567,7847,0.490917347865577,0.00491407099468635,0.290295190050447,0.704792660014677
5,"Nordrhein-Westfalen",5166024,"Schwalmtal",18965,9291,9674,0.489902451885051,18858,9198,9660,0.487750556792873,0.00491407099468635,0.290295190050447,0.704792660014677
5,"Nordrhein-Westfalen",5166028,"Tönisvorst, Stadt",29551,14340,15211,0.485262766065446,29671,14384,15287,0.484783121566513,0.00491407099468635,0.290295190050447,0.704792660014677
5,"Nordrhein-Westfalen",5166032,"Viersen, Stadt",74974,35902,39072,0.478859337903807,75291,36345,38946,0.482727019165637,0.00491407099468635,0.290295190050447,0.704792660014677
5,"Nordrhein-Westfalen",5166036,"Willich, Stadt",50676,24602,26074,0.485476359617965,51846,25388,26458,0.489680978281835,0.00491407099468635,0.290295190050447,0.704792660014677
5,"Nordrhein-Westfalen",5170004,"Alpen",12769,6268,6501,0.490876341138695,12750,6267,6483,0.491529411764706,0.00491407099468635,0.290295190050447,0.704792660014677
5,"Nordrhein-Westfalen",5170008,"Dinslaken, Stadt",67743,32677,35066,0.482367181849047,69227,33603,35624,0.48540309416846,0.00491407099468635,0.290295190050447,0.704792660014677
5,"Nordrhein-Westfalen",5170012,"Hamminkeln, Stadt",26372,13027,13345,0.493970878204156,27639,13655,13984,0.494048265132602,0.00491407099468635,0.290295190050447,0.704792660014677
5,"Nordrhein-Westfalen",5170016,"Hünxe",13517,6611,6906,0.489087815343641,13566,6557,7009,0.483340704702934,0.00491407099468635,0.290295190050447,0.704792660014677
5,"Nordrhein-Westfalen",5170020,"Kamp-Lintfort, Stadt",37166,18122,19044,0.48759619006619,38197,18525,19672,0.484985731863759,0.00491407099468635,0.290295190050447,0.704792660014677
5,"Nordrhein-Westfalen",5170024,"Moers, Stadt",103831,50000,53831,0.481551752366827,105102,50675,54427,0.482150672679873,0.00491407099468635,0.290295190050447,0.704792660014677
5,"Nordrhein-Westfalen",5170028,"Neukirchen-Vluyn, Stadt",27134,13004,14130,0.479251124051006,27689,13273,14416,0.479360034670808,0.00491407099468635,0.290295190050447,0.704792660014677
5,"Nordrhein-Westfalen",5170032,"Rheinberg, Stadt",30836,15005,15831,0.486606563756648,31499,15361,16138,0.487666275119845,0.00491407099468635,0.290295190050447,0.704792660014677
5,"Nordrhein-Westfalen",5170036,"Schermbeck",13376,6510,6866,0.486692583732057,13681,6709,6972,0.490388129522696,0.00491407099468635,0.290295190050447,0.704792660014677
5,"Nordrhein-Westfalen",5170040,"Sonsbeck",8655,4223,4432,0.487926054303871,8647,4216,4431,0.487567942639066,0.00491407099468635,0.290295190050447,0.704792660014677
5,"Nordrhein-Westfalen",5170044,"Voerde (Niederrhein), Stadt",36891,18018,18873,0.48841180775799,37146,18088,19058,0.486943412480482,0.00491407099468635,0.290295190050447,0.704792660014677
5,"Nordrhein-Westfalen",5170048,"Wesel, Stadt",60227,29122,31105,0.483537283942418,60625,29418,31207,0.485245360824742,0.00491407099468635,0.290295190050447,0.704792660014677
5,"Nordrhein-Westfalen",5170052,"Xanten, Stadt",21223,10335,10888,0.486971681666117,21506,10485,11021,0.48753836138752,0.00491407099468635,0.290295190050447,0.704792660014677
5,"Nordrhein-Westfalen",5314000,"Bonn, Stadt",307530,145101,162429,0.471827138815725,327913,157518,170395,0.480365218823285,0.00491407099468635,0.290295190050447,0.704792660014677
5,"Nordrhein-Westfalen",5315000,"Köln, Stadt",1013665,491249,522416,0.484626577814169,1017155,492416,524739,0.484111074516667,0.00491407099468635,0.290295190050447,0.704792660014677
5,"Nordrhein-Westfalen",5316000,"Leverkusen, Stadt",159373,77081,82292,0.483651559548983,161195,78161,83034,0.484884766897236,0.00491407099468635,0.290295190050447,0.704792660014677
5,"Nordrhein-Westfalen",5334002,"Aachen, Stadt",238665,121839,116826,0.510502168311231,260454,134998,125456,0.518318013929523,0.00491407099468635,0.290295190050447,0.704792660014677
5,"Nordrhein-Westfalen",5334004,"Alsdorf, Stadt",46434,22786,23648,0.490718008355946,45337,22321,23016,0.492335178772305,0.00491407099468635,0.290295190050447,0.704792660014677
5,"Nordrhein-Westfalen",5334008,"Baesweiler, Stadt",26405,12839,13566,0.486233667865934,27905,13729,14176,0.491990682673356,0.00491407099468635,0.290295190050447,0.704792660014677
5,"Nordrhein-Westfalen",5334012,"Eschweiler, Stadt",54651,26464,28187,0.484236336023129,55425,26844,28581,0.484330175913396,0.00491407099468635,0.290295190050447,0.704792660014677
5,"Nordrhein-Westfalen",5334016,"Herzogenrath, Stadt",46601,22565,24036,0.484217076886762,46519,22785,23734,0.489799866721125,0.00491407099468635,0.290295190050447,0.704792660014677
5,"Nordrhein-Westfalen",5334020,"Monschau, Stadt",12042,5909,6133,0.490699219398771,12424,6186,6238,0.497907276239536,0.00491407099468635,0.290295190050447,0.704792660014677
5,"Nordrhein-Westfalen",5334024,"Roetgen",8336,4070,4266,0.488243761996161,8294,4069,4225,0.490595611285266,0.00491407099468635,0.290295190050447,0.704792660014677
5,"Nordrhein-Westfalen",5334028,"Simmerath",15026,7453,7573,0.49600692133635,15423,7794,7629,0.505349153861117,0.00491407099468635,0.290295190050447,0.704792660014677
5,"Nordrhein-Westfalen",5334032,"Stolberg (Rhld.), Stadt",56044,27421,28623,0.489276282920562,57273,28318,28955,0.494438915370244,0.00491407099468635,0.290295190050447,0.704792660014677
5,"Nordrhein-Westfalen",5334036,"Würselen, Stadt",37317,18204,19113,0.487820564354048,37762,18263,19499,0.483634341401409,0.00491407099468635,0.290295190050447,0.704792660014677
5,"Nordrhein-Westfalen",5358004,"Aldenhoven",13745,6890,6855,0.501273190251,13914,7023,6891,0.504743423889608,0.00491407099468635,0.290295190050447,0.704792660014677
5,"Nordrhein-Westfalen",5358008,"Düren, Stadt",88567,43330,45237,0.489234139126311,92486,46603,45883,0.503892481024155,0.00491407099468635,0.290295190050447,0.704792660014677
5,"Nordrhein-Westfalen",5358012,"Heimbach, Stadt",4397,2176,2221,0.494882874687287,4428,2198,2230,0.496386630532972,0.00491407099468635,0.290295190050447,0.704792660014677
5,"Nordrhein-Westfalen",5358016,"Hürtgenwald",8647,4297,4350,0.496935353301723,8640,4322,4318,0.500231481481481,0.00491407099468635,0.290295190050447,0.704792660014677
5,"Nordrhein-Westfalen",5358020,"Inden",6935,3384,3551,0.487959625090123,6845,3339,3506,0.487801314828342,0.00491407099468635,0.290295190050447,0.704792660014677
5,"Nordrhein-Westfalen",5358024,"Jülich, Stadt",31909,15650,16259,0.490457237769908,33059,16337,16722,0.494177077346562,0.00491407099468635,0.290295190050447,0.704792660014677
5,"Nordrhein-Westfalen",5358028,"Kreuzau",17196,8438,8758,0.490695510583857,17731,8608,9123,0.485477412441487,0.00491407099468635,0.290295190050447,0.704792660014677
5,"Nordrhein-Westfalen",5358032,"Langerwehe",13410,6593,6817,0.491648023862789,14077,7022,7055,0.498827875257512,0.00491407099468635,0.290295190050447,0.704792660014677
5,"Nordrhein-Westfalen",5358036,"Linnich, Stadt",12665,6244,6421,0.493012238452428,13559,6990,6569,0.515524743712663,0.00491407099468635,0.290295190050447,0.704792660014677
5,"Nordrhein-Westfalen",5358040,"Merzenich",9842,4845,4997,0.492277992277992,9743,4755,4988,0.488042697321154,0.00491407099468635,0.290295190050447,0.704792660014677
5,"Nordrhein-Westfalen",5358044,"Nideggen, Stadt",9860,4831,5029,0.489959432048682,10621,5235,5386,0.492891441483853,0.00491407099468635,0.290295190050447,0.704792660014677
5,"Nordrhein-Westfalen",5358048,"Niederzier",13672,6755,6917,0.494075482738444,13910,6855,7055,0.492810927390367,0.00491407099468635,0.290295190050447,0.704792660014677
5,"Nordrhein-Westfalen",5358052,"Nörvenich",10466,5137,5329,0.490827441238295,10948,5525,5423,0.504658385093168,0.00491407099468635,0.290295190050447,0.704792660014677
5,"Nordrhein-Westfalen",5358056,"Titz",8260,4079,4181,0.493825665859564,8195,3998,4197,0.487858450274558,0.00491407099468635,0.290295190050447,0.704792660014677
5,"Nordrhein-Westfalen",5358060,"Vettweiß",8953,4454,4499,0.497486875907517,8948,4492,4456,0.502011622708985,0.00491407099468635,0.290295190050447,0.704792660014677
5,"Nordrhein-Westfalen",5362004,"Bedburg, Stadt",22988,11286,11702,0.490951800939621,24608,12240,12368,0.49739921976593,0.00491407099468635,0.290295190050447,0.704792660014677
5,"Nordrhein-Westfalen",5362008,"Bergheim, Stadt",58749,28727,30022,0.488978535804865,61668,30903,30765,0.501118894726601,0.00491407099468635,0.290295190050447,0.704792660014677
5,"Nordrhein-Westfalen",5362012,"Brühl, Stadt",43483,20627,22856,0.474369293746982,44331,21273,23058,0.479867361440076,0.00491407099468635,0.290295190050447,0.704792660014677
5,"Nordrhein-Westfalen",5362016,"Elsdorf, Stadt",20820,10188,10632,0.489337175792507,21182,10539,10643,0.49754508544991,0.00491407099468635,0.290295190050447,0.704792660014677
5,"Nordrhein-Westfalen",5362020,"Erftstadt, Stadt",49172,23779,25393,0.483588220938746,50502,24617,25885,0.487446041740921,0.00491407099468635,0.290295190050447,0.704792660014677
5,"Nordrhein-Westfalen",5362024,"Frechen, Stadt",50141,24207,25934,0.482778564448256,50590,24533,26057,0.484937734730184,0.00491407099468635,0.290295190050447,0.704792660014677
5,"Nordrhein-Westfalen",5362028,"Hürth, Stadt",55581,26736,28845,0.481027689318292,58673,28743,29930,0.489884614729092,0.00491407099468635,0.290295190050447,0.704792660014677
5,"Nordrhein-Westfalen",5362032,"Kerpen, Stadt",63569,31172,32397,0.490364800453051,64839,31890,32949,0.491833618655439,0.00491407099468635,0.290295190050447,0.704792660014677
5,"Nordrhein-Westfalen",5362036,"Pulheim, Stadt",53208,25759,27449,0.484118929484288,54031,26123,27908,0.48348170494716,0.00491407099468635,0.290295190050447,0.704792660014677
5,"Nordrhein-Westfalen",5362040,"Wesseling, Stadt",35081,17256,17825,0.49189019697272,35154,17133,18021,0.4873698583376,0.00491407099468635,0.290295190050447,0.704792660014677
5,"Nordrhein-Westfalen",5366004,"Bad Münstereifel, Stadt",17431,8493,8938,0.487235385233205,18403,9114,9289,0.495245340433625,0.00491407099468635,0.290295190050447,0.704792660014677
5,"Nordrhein-Westfalen",5366008,"Blankenheim",8607,4329,4278,0.502962704775183,8205,4055,4150,0.494210847044485,0.00491407099468635,0.290295190050447,0.704792660014677
5,"Nordrhein-Westfalen",5366012,"Dahlem",4210,2073,2137,0.492399049881235,4137,2048,2089,0.495044718394972,0.00491407099468635,0.290295190050447,0.704792660014677
5,"Nordrhein-Westfalen",5366016,"Euskirchen, Stadt",55437,27121,28316,0.489221999747461,55639,27247,28392,0.489710454896745,0.00491407099468635,0.290295190050447,0.704792660014677
5,"Nordrhein-Westfalen",5366020,"Hellenthal",8207,4128,4079,0.502985256488364,8163,4134,4029,0.506431459022418,0.00491407099468635,0.290295190050447,0.704792660014677
5,"Nordrhein-Westfalen",5366024,"Kall",11336,5580,5756,0.492237120677488,11670,5799,5871,0.496915167095116,0.00491407099468635,0.290295190050447,0.704792660014677
5,"Nordrhein-Westfalen",5366028,"Mechernich, Stadt",26736,13178,13558,0.492893476959904,27086,13507,13579,0.498670900095991,0.00491407099468635,0.290295190050447,0.704792660014677
5,"Nordrhein-Westfalen",5366032,"Nettersheim",7550,3720,3830,0.492715231788079,7658,3800,3858,0.496213110472708,0.00491407099468635,0.290295190050447,0.704792660014677
5,"Nordrhein-Westfalen",5366036,"Schleiden, Stadt",12995,6353,6642,0.488880338591766,13191,6415,6776,0.486316427867485,0.00491407099468635,0.290295190050447,0.704792660014677
5,"Nordrhein-Westfalen",5366040,"Weilerswist",15604,7664,7940,0.49115611381697,16444,8194,8250,0.498297251277062,0.00491407099468635,0.290295190050447,0.704792660014677
5,"Nordrhein-Westfalen",5366044,"Zülpich, Stadt",19688,9626,10062,0.488927265339293,19995,9769,10226,0.488572143035759,0.00491407099468635,0.290295190050447,0.704792660014677
5,"Nordrhein-Westfalen",5370004,"Erkelenz, Stadt",43066,20833,22233,0.483745878419171,44496,21762,22734,0.489077669902913,0.00491407099468635,0.290295190050447,0.704792660014677
5,"Nordrhein-Westfalen",5370008,"Gangelt",11437,5587,5850,0.488502229605666,11705,5752,5953,0.491413925672789,0.00491407099468635,0.290295190050447,0.704792660014677
5,"Nordrhein-Westfalen",5370012,"Geilenkirchen, Stadt",26351,13004,13347,0.493491708094569,28333,13975,14358,0.493241096954082,0.00491407099468635,0.290295190050447,0.704792660014677
5,"Nordrhein-Westfalen",5370016,"Heinsberg, Stadt",40949,19994,20955,0.488265891718968,40785,20001,20784,0.490400882677455,0.00491407099468635,0.290295190050447,0.704792660014677
5,"Nordrhein-Westfalen",5370020,"Hückelhoven, Stadt",38774,18884,19890,0.487027389487801,39070,19112,19958,0.489173278730484,0.00491407099468635,0.290295190050447,0.704792660014677
5,"Nordrhein-Westfalen",5370024,"Selfkant",9919,4973,4946,0.501361024296804,10208,5165,5043,0.505975705329154,0.00491407099468635,0.290295190050447,0.704792660014677
5,"Nordrhein-Westfalen",5370028,"Übach-Palenberg, Stadt",24208,11962,12246,0.494134170522141,24724,12310,12414,0.497896780456237,0.00491407099468635,0.290295190050447,0.704792660014677
5,"Nordrhein-Westfalen",5370032,"Waldfeucht",8715,4318,4397,0.495467584624211,9113,4547,4566,0.498957533194338,0.00491407099468635,0.290295190050447,0.704792660014677
5,"Nordrhein-Westfalen",5370036,"Wassenberg, Stadt",16929,8385,8544,0.495303916356548,17329,8623,8706,0.4976051705234,0.00491407099468635,0.290295190050447,0.704792660014677
5,"Nordrhein-Westfalen",5370040,"Wegberg, Stadt",27813,13674,14139,0.491640599719556,29023,14425,14598,0.49701960514075,0.00491407099468635,0.290295190050447,0.704792660014677
5,"Nordrhein-Westfalen",5374004,"Bergneustadt, Stadt",18842,9204,9638,0.488483175883664,19540,9728,9812,0.497850562947799,0.00491407099468635,0.290295190050447,0.704792660014677
5,"Nordrhein-Westfalen",5374008,"Engelskirchen",19375,9466,9909,0.488567741935484,19977,9745,10232,0.487810982630025,0.00491407099468635,0.290295190050447,0.704792660014677
5,"Nordrhein-Westfalen",5374012,"Gummersbach, Stadt",49838,24132,25706,0.484208836630683,51023,24880,26143,0.48762322873998,0.00491407099468635,0.290295190050447,0.704792660014677
5,"Nordrhein-Westfalen",5374016,"Hückeswagen, Stadt",15218,7480,7738,0.491523196215009,15599,7619,7980,0.4884287454324,0.00491407099468635,0.290295190050447,0.704792660014677
5,"Nordrhein-Westfalen",5374020,"Lindlar",21162,10272,10890,0.485398355542954,21989,10891,11098,0.495293101096003,0.00491407099468635,0.290295190050447,0.704792660014677
5,"Nordrhein-Westfalen",5374024,"Marienheide",13666,6723,6943,0.491950826869603,13724,6739,6985,0.491037598367823,0.00491407099468635,0.290295190050447,0.704792660014677
5,"Nordrhein-Westfalen",5374028,"Morsbach",10462,5201,5261,0.497132479449436,10870,5439,5431,0.500367985280589,0.00491407099468635,0.290295190050447,0.704792660014677
5,"Nordrhein-Westfalen",5374032,"Nümbrecht",16693,8105,8588,0.485532858084227,17168,8305,8863,0.483748835041938,0.00491407099468635,0.290295190050447,0.704792660014677
5,"Nordrhein-Westfalen",5374036,"Radevormwald, Stadt",22377,10715,11662,0.478839880234169,22307,10692,11615,0.479311426906352,0.00491407099468635,0.290295190050447,0.704792660014677
5,"Nordrhein-Westfalen",5374040,"Reichshof",18855,9435,9420,0.500397772474145,19365,9734,9631,0.502659437128841,0.00491407099468635,0.290295190050447,0.704792660014677
5,"Nordrhein-Westfalen",5374044,"Waldbröl, Stadt",18929,9007,9922,0.475830735907866,19300,9311,9989,0.482435233160622,0.00491407099468635,0.290295190050447,0.704792660014677
5,"Nordrhein-Westfalen",5374048,"Wiehl, Stadt",25307,12203,13104,0.48219860117754,25644,12453,13191,0.485610669162377,0.00491407099468635,0.290295190050447,0.704792660014677
5,"Nordrhein-Westfalen",5374052,"Wipperfürth, Stadt",21563,10577,10986,0.490516161944071,23026,11400,11626,0.495092504125771,0.00491407099468635,0.290295190050447,0.704792660014677
5,"Nordrhein-Westfalen",5378004,"Bergisch Gladbach, Stadt",109026,52238,56788,0.479133417716875,105836,50958,54878,0.481480781586606,0.00491407099468635,0.290295190050447,0.704792660014677
5,"Nordrhein-Westfalen",5378008,"Burscheid, Stadt",18099,8943,9156,0.494115696999834,18627,9272,9355,0.497772051323348,0.00491407099468635,0.290295190050447,0.704792660014677
5,"Nordrhein-Westfalen",5378012,"Kürten",19481,9578,9903,0.491658539089369,19468,9657,9811,0.49604479145264,0.00491407099468635,0.290295190050447,0.704792660014677
5,"Nordrhein-Westfalen",5378016,"Leichlingen (Rheinland), Stadt",27400,13095,14305,0.477919708029197,27390,13119,14271,0.478970427163198,0.00491407099468635,0.290295190050447,0.704792660014677
5,"Nordrhein-Westfalen",5378020,"Odenthal",14795,7194,7601,0.486245353159851,15731,7644,8087,0.485919521963003,0.00491407099468635,0.290295190050447,0.704792660014677
5,"Nordrhein-Westfalen",5378024,"Overath, Stadt",26788,13118,13670,0.489696879199642,26749,13122,13627,0.490560394781113,0.00491407099468635,0.290295190050447,0.704792660014677
5,"Nordrhein-Westfalen",5378028,"Rösrath, Stadt",27446,13455,13991,0.490235371274503,27243,13322,13921,0.489006350255111,0.00491407099468635,0.290295190050447,0.704792660014677
5,"Nordrhein-Westfalen",5378032,"Wermelskirchen, Stadt",34781,16852,17929,0.484517408930163,35129,17093,18036,0.48657804093484,0.00491407099468635,0.290295190050447,0.704792660014677
5,"Nordrhein-Westfalen",5382004,"Alfter",22992,11156,11836,0.485212247738344,22988,11140,11848,0.484600661214547,0.00491407099468635,0.290295190050447,0.704792660014677
5,"Nordrhein-Westfalen",5382008,"Bad Honnef, Stadt",24653,11697,12956,0.474465582282075,25326,11937,13389,0.471333807154703,0.00491407099468635,0.290295190050447,0.704792660014677
5,"Nordrhein-Westfalen",5382012,"Bornheim, Stadt",46320,22438,23882,0.484412780656304,48636,23900,24736,0.491405543219015,0.00491407099468635,0.290295190050447,0.704792660014677
5,"Nordrhein-Westfalen",5382016,"Eitorf",18750,9272,9478,0.494506666666667,19395,9639,9756,0.496983758700696,0.00491407099468635,0.290295190050447,0.704792660014677
5,"Nordrhein-Westfalen",5382020,"Hennef (Sieg), Stadt",44937,21986,22951,0.489262745621648,46342,22953,23389,0.49529584394286,0.00491407099468635,0.290295190050447,0.704792660014677
5,"Nordrhein-Westfalen",5382024,"Königswinter, Stadt",40081,19279,20802,0.481000973029615,40760,19761,20999,0.484813542688911,0.00491407099468635,0.290295190050447,0.704792660014677
5,"Nordrhein-Westfalen",5382028,"Lohmar, Stadt",29624,14415,15209,0.486598703753713,31272,15444,15828,0.493860322333078,0.00491407099468635,0.290295190050447,0.704792660014677
5,"Nordrhein-Westfalen",5382032,"Meckenheim, Stadt",23555,11463,12092,0.486648270006368,24248,11965,12283,0.493442758165622,0.00491407099468635,0.290295190050447,0.704792660014677
5,"Nordrhein-Westfalen",5382036,"Much",14074,6868,7206,0.487992042063379,14890,7412,7478,0.497783747481531,0.00491407099468635,0.290295190050447,0.704792660014677
5,"Nordrhein-Westfalen",5382040,"Neunkirchen-Seelscheid",19744,9716,10028,0.49209886547812,20578,10232,10346,0.497230051511323,0.00491407099468635,0.290295190050447,0.704792660014677
5,"Nordrhein-Westfalen",5382044,"Niederkassel, Stadt",36528,17903,18625,0.490117170389838,37699,18640,19059,0.494442823417067,0.00491407099468635,0.290295190050447,0.704792660014677
5,"Nordrhein-Westfalen",5382048,"Rheinbach, Stadt",26534,13043,13491,0.49155800105525,27572,13699,13873,0.496844624981866,0.00491407099468635,0.290295190050447,0.704792660014677
5,"Nordrhein-Westfalen",5382052,"Ruppichteroth",10222,4959,5263,0.485130111524164,10624,5198,5426,0.489269578313253,0.00491407099468635,0.290295190050447,0.704792660014677
5,"Nordrhein-Westfalen",5382056,"Sankt Augustin, Stadt",54100,26047,28053,0.481460258780037,55810,27367,28443,0.490360150510661,0.00491407099468635,0.290295190050447,0.704792660014677
5,"Nordrhein-Westfalen",5382060,"Siegburg, Stadt",38809,18747,20062,0.483058053544281,39795,19341,20454,0.486015831134565,0.00491407099468635,0.290295190050447,0.704792660014677
5,"Nordrhein-Westfalen",5382064,"Swisttal",17578,8568,9010,0.48742746615087,18201,9044,9157,0.49689577495742,0.00491407099468635,0.290295190050447,0.704792660014677
5,"Nordrhein-Westfalen",5382068,"Troisdorf, Stadt",72584,35354,37230,0.487077041772291,75608,37320,38288,0.493598560998836,0.00491407099468635,0.290295190050447,0.704792660014677
5,"Nordrhein-Westfalen",5382072,"Wachtberg",19614,9551,10063,0.486948098297135,20395,9893,10502,0.485069870066193,0.00491407099468635,0.290295190050447,0.704792660014677
5,"Nordrhein-Westfalen",5382076,"Windeck",18895,9389,9506,0.496903942842022,20293,10013,10280,0.493421376829449,0.00491407099468635,0.290295190050447,0.704792660014677
5,"Nordrhein-Westfalen",5512000,"Bottrop, Stadt",117074,56701,60373,0.484317611083588,116361,56170,60191,0.482721874167462,0.00491407099468635,0.290295190050447,0.704792660014677
5,"Nordrhein-Westfalen",5513000,"Gelsenkirchen, Stadt",257994,126598,131396,0.490701334139554,256652,125063,131589,0.487286286489098,0.00491407099468635,0.290295190050447,0.704792660014677
5,"Nordrhein-Westfalen",5515000,"Münster, Stadt",293393,140133,153260,0.477628982286558,291754,136802,154952,0.468895028003044,0.00491407099468635,0.290295190050447,0.704792660014677
5,"Nordrhein-Westfalen",5554004,"Ahaus, Stadt",38443,19014,19429,0.494602398356008,38989,19562,19427,0.501731257534176,0.00491407099468635,0.290295190050447,0.704792660014677
5,"Nordrhein-Westfalen",5554008,"Bocholt, Stadt",71233,34763,36470,0.488018193814665,73052,35828,37224,0.490445162350107,0.00491407099468635,0.290295190050447,0.704792660014677
5,"Nordrhein-Westfalen",5554012,"Borken, Stadt",41491,20248,21243,0.48800944783206,40968,20255,20713,0.494410271431361,0.00491407099468635,0.290295190050447,0.704792660014677
5,"Nordrhein-Westfalen",5554016,"Gescher, Stadt",16837,8452,8385,0.50198966561739,17086,8611,8475,0.503979866557415,0.00491407099468635,0.290295190050447,0.704792660014677
5,"Nordrhein-Westfalen",5554020,"Gronau (Westf.), Stadt",45622,22430,23192,0.491648765946254,46546,22984,23562,0.493791088385683,0.00491407099468635,0.290295190050447,0.704792660014677
5,"Nordrhein-Westfalen",5554024,"Heek",8362,4203,4159,0.502630949533604,8370,4260,4110,0.508960573476703,0.00491407099468635,0.290295190050447,0.704792660014677
5,"Nordrhein-Westfalen",5554028,"Heiden",8056,4050,4006,0.502730883813307,8043,4083,3960,0.507646400596792,0.00491407099468635,0.290295190050447,0.704792660014677
5,"Nordrhein-Westfalen",5554032,"Isselburg, Stadt",10937,5450,5487,0.498308494102588,11183,5613,5570,0.501922561030135,0.00491407099468635,0.290295190050447,0.704792660014677
5,"Nordrhein-Westfalen",5554036,"Legden",6946,3581,3365,0.515548517132162,6796,3525,3271,0.518687463213655,0.00491407099468635,0.290295190050447,0.704792660014677
5,"Nordrhein-Westfalen",5554040,"Raesfeld",11106,5535,5571,0.49837925445705,10943,5554,5389,0.507539066069634,0.00491407099468635,0.290295190050447,0.704792660014677
5,"Nordrhein-Westfalen",5554044,"Reken",14344,7263,7081,0.506344116006693,14066,7207,6859,0.512370254514432,0.00491407099468635,0.290295190050447,0.704792660014677
5,"Nordrhein-Westfalen",5554048,"Rhede, Stadt",19112,9462,9650,0.495081624110506,19385,9695,9690,0.500128965695125,0.00491407099468635,0.290295190050447,0.704792660014677
5,"Nordrhein-Westfalen",5554052,"Schöppingen",7169,3780,3389,0.527270191100572,8634,4804,3830,0.556404910817697,0.00491407099468635,0.290295190050447,0.704792660014677
5,"Nordrhein-Westfalen",5554056,"Stadtlohn, Stadt",20130,9977,10153,0.495628415300546,20518,10284,10234,0.501218442343308,0.00491407099468635,0.290295190050447,0.704792660014677
5,"Nordrhein-Westfalen",5554060,"Südlohn",8914,4406,4508,0.494278662777653,9025,4478,4547,0.49617728531856,0.00491407099468635,0.290295190050447,0.704792660014677
5,"Nordrhein-Westfalen",5554064,"Velen",13011,6456,6555,0.496195526861886,12949,6506,6443,0.502432620279558,0.00491407099468635,0.290295190050447,0.704792660014677
5,"Nordrhein-Westfalen",5554068,"Vreden, Stadt",22380,11405,10975,0.509606791778374,22554,11546,11008,0.511926930921344,0.00491407099468635,0.290295190050447,0.704792660014677
5,"Nordrhein-Westfalen",5558004,"Ascheberg",15040,7454,7586,0.49561170212766,14861,7398,7463,0.497813067761254,0.00491407099468635,0.290295190050447,0.704792660014677
5,"Nordrhein-Westfalen",5558008,"Billerbeck, Stadt",11448,5677,5771,0.495894479385045,11491,5686,5805,0.494822034635802,0.00491407099468635,0.290295190050447,0.704792660014677
5,"Nordrhein-Westfalen",5558012,"Coesfeld, Stadt",35777,17470,18307,0.488302540738463,36198,17619,18579,0.486739598872866,0.00491407099468635,0.290295190050447,0.704792660014677
5,"Nordrhein-Westfalen",5558016,"Dülmen, Stadt",46178,22245,23933,0.481722898349864,46445,22602,23843,0.486640111960383,0.00491407099468635,0.290295190050447,0.704792660014677
5,"Nordrhein-Westfalen",5558020,"Havixbeck",11601,5589,6012,0.481768813033359,11842,5646,6196,0.47677757135619,0.00491407099468635,0.290295190050447,0.704792660014677
5,"Nordrhein-Westfalen",5558024,"Lüdinghausen, Stadt",23581,11520,12061,0.488528900385904,24144,11748,12396,0.486580516898608,0.00491407099468635,0.290295190050447,0.704792660014677
5,"Nordrhein-Westfalen",5558028,"Nordkirchen",9704,4802,4902,0.49484748557296,10413,5395,5018,0.518102372034956,0.00491407099468635,0.290295190050447,0.704792660014677
5,"Nordrhein-Westfalen",5558032,"Nottuln",19206,9443,9763,0.491669270019785,19848,9809,10039,0.494205965336558,0.00491407099468635,0.290295190050447,0.704792660014677
5,"Nordrhein-Westfalen",5558036,"Olfen, Stadt",12075,5831,6244,0.482898550724638,12156,5965,6191,0.490704179006252,0.00491407099468635,0.290295190050447,0.704792660014677
5,"Nordrhein-Westfalen",5558040,"Rosendahl",10477,5303,5174,0.506156342464446,10815,5582,5233,0.516134997688396,0.00491407099468635,0.290295190050447,0.704792660014677
5,"Nordrhein-Westfalen",5558044,"Senden",19944,9832,10112,0.492980344965905,20657,10147,10510,0.491213632182795,0.00491407099468635,0.290295190050447,0.704792660014677
5,"Nordrhein-Westfalen",5562004,"Castrop-Rauxel, Stadt",74323,35888,38435,0.48286533105499,74935,36328,38607,0.484793487689331,0.00491407099468635,0.290295190050447,0.704792660014677
5,"Nordrhein-Westfalen",5562008,"Datteln, Stadt",34543,16850,17693,0.487797817213328,35512,17331,18181,0.488032214462717,0.00491407099468635,0.290295190050447,0.704792660014677
5,"Nordrhein-Westfalen",5562012,"Dorsten, Stadt",76518,37108,39410,0.484957787710081,76223,37143,39080,0.487293861432901,0.00491407099468635,0.290295190050447,0.704792660014677
5,"Nordrhein-Westfalen",5562014,"Gladbeck, Stadt",74045,35748,38297,0.482787494091431,75246,36474,38772,0.48473008532015,0.00491407099468635,0.290295190050447,0.704792660014677
5,"Nordrhein-Westfalen",5562016,"Haltern am See, Stadt",37216,18039,19177,0.484710877042132,37579,18365,19214,0.488703797333617,0.00491407099468635,0.290295190050447,0.704792660014677
5,"Nordrhein-Westfalen",5562020,"Herten, Stadt",61178,29847,31331,0.487871457059727,61634,29954,31680,0.485997988123438,0.00491407099468635,0.290295190050447,0.704792660014677
5,"Nordrhein-Westfalen",5562024,"Marl, Stadt",84680,41394,43286,0.488828530940009,87201,42509,44692,0.487482941709384,0.00491407099468635,0.290295190050447,0.704792660014677
5,"Nordrhein-Westfalen",5562028,"Oer-Erkenschwick, Stadt",30727,14908,15819,0.485175903928141,30010,14616,15394,0.487037654115295,0.00491407099468635,0.290295190050447,0.704792660014677
5,"Nordrhein-Westfalen",5562032,"Recklinghausen, Stadt",115648,55829,59819,0.48274937742114,117672,56896,60776,0.483513495139031,0.00491407099468635,0.290295190050447,0.704792660014677
5,"Nordrhein-Westfalen",5562036,"Waltrop, Stadt",28953,14017,14936,0.484129451179498,29511,14391,15120,0.487648673376029,0.00491407099468635,0.290295190050447,0.704792660014677
5,"Nordrhein-Westfalen",5566004,"Altenberge",10041,4995,5046,0.497460412309531,10238,5117,5121,0.499804649345575,0.00491407099468635,0.290295190050447,0.704792660014677
5,"Nordrhein-Westfalen",5566008,"Emsdetten, Stadt",35275,17245,18030,0.488873139617293,35376,17277,18099,0.488381953867028,0.00491407099468635,0.290295190050447,0.704792660014677
5,"Nordrhein-Westfalen",5566012,"Greven, Stadt",34710,17016,17694,0.490233362143475,36115,17775,18340,0.492177765471411,0.00491407099468635,0.290295190050447,0.704792660014677
5,"Nordrhein-Westfalen",5566016,"Hörstel, Stadt",19652,9867,9785,0.502086301648687,19806,9932,9874,0.501464202766838,0.00491407099468635,0.290295190050447,0.704792660014677
5,"Nordrhein-Westfalen",5566020,"Hopsten",7602,3851,3751,0.506577216521968,7522,3878,3644,0.515554373836746,0.00491407099468635,0.290295190050447,0.704792660014677
5,"Nordrhein-Westfalen",5566024,"Horstmar, Stadt",6448,3245,3203,0.50325682382134,6426,3256,3170,0.506691565515095,0.00491407099468635,0.290295190050447,0.704792660014677
5,"Nordrhein-Westfalen",5566028,"Ibbenbüren, Stadt",50644,24926,25718,0.492180712423979,51487,25378,26109,0.492901120671237,0.00491407099468635,0.290295190050447,0.704792660014677
5,"Nordrhein-Westfalen",5566032,"Ladbergen",6375,3127,3248,0.490509803921569,6392,3166,3226,0.495306633291615,0.00491407099468635,0.290295190050447,0.704792660014677
5,"Nordrhein-Westfalen",5566036,"Laer",6487,3228,3259,0.497610605827039,6292,3170,3122,0.503814367450731,0.00491407099468635,0.290295190050447,0.704792660014677
5,"Nordrhein-Westfalen",5566040,"Lengerich, Stadt",21843,10695,11148,0.489630545254773,22174,10875,11299,0.490439253179399,0.00491407099468635,0.290295190050447,0.704792660014677
5,"Nordrhein-Westfalen",5566044,"Lienen",8551,4281,4270,0.500643199625775,8541,4297,4244,0.503102681184873,0.00491407099468635,0.290295190050447,0.704792660014677
5,"Nordrhein-Westfalen",5566048,"Lotte",13758,6775,6983,0.492440761738625,13972,6912,7060,0.494703693100487,0.00491407099468635,0.290295190050447,0.704792660014677
5,"Nordrhein-Westfalen",5566052,"Metelen",6409,3201,3208,0.499453892963021,6332,3167,3165,0.500157927984839,0.00491407099468635,0.290295190050447,0.704792660014677
5,"Nordrhein-Westfalen",5566056,"Mettingen",11796,5791,6005,0.490929128518142,12053,5889,6164,0.488592051771343,0.00491407099468635,0.290295190050447,0.704792660014677
5,"Nordrhein-Westfalen",5566060,"Neuenkirchen",13674,6810,6864,0.498025449758666,13703,6862,6841,0.500766255564475,0.00491407099468635,0.290295190050447,0.704792660014677
5,"Nordrhein-Westfalen",5566064,"Nordwalde",9346,4592,4754,0.491333190669805,9305,4587,4718,0.492960773777539,0.00491407099468635,0.290295190050447,0.704792660014677
5,"Nordrhein-Westfalen",5566068,"Ochtrup, Stadt",18971,9504,9467,0.500975172631912,19443,9778,9665,0.502905930154812,0.00491407099468635,0.290295190050447,0.704792660014677
5,"Nordrhein-Westfalen",5566072,"Recke",11275,5575,5700,0.494456762749446,11438,5695,5743,0.497901731071866,0.00491407099468635,0.290295190050447,0.704792660014677
5,"Nordrhein-Westfalen",5566076,"Rheine, Stadt",72942,35550,37392,0.487373529653697,76563,38011,38552,0.496466961848412,0.00491407099468635,0.290295190050447,0.704792660014677
5,"Nordrhein-Westfalen",5566080,"Saerbeck",7144,3536,3608,0.494960806270997,7242,3587,3655,0.495305164319249,0.00491407099468635,0.290295190050447,0.704792660014677
5,"Nordrhein-Westfalen",5566084,"Steinfurt, Stadt",33376,16403,16973,0.491460930009588,33722,16737,16985,0.496322875274302,0.00491407099468635,0.290295190050447,0.704792660014677
5,"Nordrhein-Westfalen",5566088,"Tecklenburg, Stadt",8806,4374,4432,0.496706790824438,9082,4575,4507,0.50374366879542,0.00491407099468635,0.290295190050447,0.704792660014677
5,"Nordrhein-Westfalen",5566092,"Westerkappeln",10931,5391,5540,0.493184521086817,11139,5497,5642,0.493491336744771,0.00491407099468635,0.290295190050447,0.704792660014677
5,"Nordrhein-Westfalen",5566096,"Wettringen",7764,3864,3900,0.497681607418856,7935,4031,3904,0.508002520478891,0.00491407099468635,0.290295190050447,0.704792660014677
5,"Nordrhein-Westfalen",5570004,"Ahlen, Stadt",52036,25293,26743,0.486067337996771,53090,25900,27190,0.487850819363345,0.00491407099468635,0.290295190050447,0.704792660014677
5,"Nordrhein-Westfalen",5570008,"Beckum, Stadt",36106,17686,18420,0.489835484407024,36595,18107,18488,0.494794370815685,0.00491407099468635,0.290295190050447,0.704792660014677
5,"Nordrhein-Westfalen",5570012,"Beelen",6270,3172,3098,0.505901116427432,6272,3184,3088,0.50765306122449,0.00491407099468635,0.290295190050447,0.704792660014677
5,"Nordrhein-Westfalen",5570016,"Drensteinfurt, Stadt",15132,7434,7698,0.491276764472641,15367,7565,7802,0.492288670527754,0.00491407099468635,0.290295190050447,0.704792660014677
5,"Nordrhein-Westfalen",5570020,"Ennigerloh, Stadt",19614,9734,9880,0.496278168655042,19589,9802,9787,0.500382867936087,0.00491407099468635,0.290295190050447,0.704792660014677
5,"Nordrhein-Westfalen",5570024,"Everswinkel",9320,4582,4738,0.491630901287554,9339,4622,4717,0.494913802334297,0.00491407099468635,0.290295190050447,0.704792660014677
5,"Nordrhein-Westfalen",5570028,"Oelde, Stadt",28877,14365,14512,0.497454721750874,29213,14504,14709,0.49649128812515,0.00491407099468635,0.290295190050447,0.704792660014677
5,"Nordrhein-Westfalen",5570032,"Ostbevern",10625,5204,5421,0.489788235294118,10500,5087,5413,0.48447619047619,0.00491407099468635,0.290295190050447,0.704792660014677
5,"Nordrhein-Westfalen",5570036,"Sassenberg, Stadt",13924,6834,7090,0.490807239299052,14122,7068,7054,0.500495680498513,0.00491407099468635,0.290295190050447,0.704792660014677
5,"Nordrhein-Westfalen",5570040,"Sendenhorst, Stadt",12873,6323,6550,0.491183096403325,13254,6491,6763,0.489738946733062,0.00491407099468635,0.290295190050447,0.704792660014677
5,"Nordrhein-Westfalen",5570044,"Telgte, Stadt",18828,9033,9795,0.479764181007011,19056,9318,9738,0.488979848866499,0.00491407099468635,0.290295190050447,0.704792660014677
5,"Nordrhein-Westfalen",5570048,"Wadersloh",12400,6182,6218,0.498548387096774,12605,6297,6308,0.499563665212217,0.00491407099468635,0.290295190050447,0.704792660014677
5,"Nordrhein-Westfalen",5570052,"Warendorf, Stadt",36980,17864,19116,0.483071930773391,38047,18600,19447,0.488869030409756,0.00491407099468635,0.290295190050447,0.704792660014677
5,"Nordrhein-Westfalen",5711000,"Bielefeld, Stadt",327199,157770,169429,0.482183625255578,323395,154922,168473,0.47904884120039,0.00491407099468635,0.290295190050447,0.704792660014677
5,"Nordrhein-Westfalen",5754004,"Borgholzhausen, Stadt",8716,4316,4400,0.495181275814594,8585,4212,4373,0.490623179965055,0.00491407099468635,0.290295190050447,0.704792660014677
5,"Nordrhein-Westfalen",5754008,"Gütersloh, Stadt",94290,46130,48160,0.489235337787676,96758,47433,49325,0.490223030653796,0.00491407099468635,0.290295190050447,0.704792660014677
5,"Nordrhein-Westfalen",5754012,"Halle (Westf.), Stadt",21148,10327,10821,0.488320408549272,21137,10309,10828,0.487722950276766,0.00491407099468635,0.290295190050447,0.704792660014677
5,"Nordrhein-Westfalen",5754016,"Harsewinkel, Stadt",23785,11874,11911,0.499222198864831,24162,12048,12114,0.498634219021604,0.00491407099468635,0.290295190050447,0.704792660014677
5,"Nordrhein-Westfalen",5754020,"Herzebrock-Clarholz",15815,7915,7900,0.500474233322795,16025,8118,7907,0.506583463338534,0.00491407099468635,0.290295190050447,0.704792660014677
5,"Nordrhein-Westfalen",5754024,"Langenberg",8215,4151,4064,0.505295191722459,8080,4067,4013,0.503341584158416,0.00491407099468635,0.290295190050447,0.704792660014677
5,"Nordrhein-Westfalen",5754028,"Rheda-Wiedenbrück, Stadt",46661,23014,23647,0.493217033496925,47540,23639,23901,0.49724442574674,0.00491407099468635,0.290295190050447,0.704792660014677
5,"Nordrhein-Westfalen",5754032,"Rietberg, Stadt",28571,14309,14262,0.500822512337685,28885,14555,14330,0.503894755063182,0.00491407099468635,0.290295190050447,0.704792660014677
5,"Nordrhein-Westfalen",5754036,"Schloß Holte-Stukenbrock, Stadt",26352,12988,13364,0.492865816636308,26150,12869,13281,0.492122370936902,0.00491407099468635,0.290295190050447,0.704792660014677
5,"Nordrhein-Westfalen",5754040,"Steinhagen",20183,9875,10308,0.489273150671357,19799,9581,10218,0.483913328956008,0.00491407099468635,0.290295190050447,0.704792660014677
5,"Nordrhein-Westfalen",5754044,"Verl, Stadt",24877,12693,12184,0.510230333239538,25159,12925,12234,0.513732660280615,0.00491407099468635,0.290295190050447,0.704792660014677
5,"Nordrhein-Westfalen",5754048,"Versmold, Stadt",20864,10350,10514,0.496069785276074,20943,10405,10538,0.49682471470181,0.00491407099468635,0.290295190050447,0.704792660014677
5,"Nordrhein-Westfalen",5754052,"Werther (Westf.), Stadt",11337,5567,5770,0.491047014201288,11399,5615,5784,0.492587069041144,0.00491407099468635,0.290295190050447,0.704792660014677
5,"Nordrhein-Westfalen",5758004,"Bünde, Stadt",45406,21950,23456,0.483416288596221,44573,21566,23007,0.483835505799475,0.00491407099468635,0.290295190050447,0.704792660014677
5,"Nordrhein-Westfalen",5758008,"Enger, Stadt",20380,10023,10357,0.49180569185476,19941,9831,10110,0.493004362870468,0.00491407099468635,0.290295190050447,0.704792660014677
5,"Nordrhein-Westfalen",5758012,"Herford, Stadt",65008,31207,33801,0.48004860940192,63786,30654,33132,0.48057567491299,0.00491407099468635,0.290295190050447,0.704792660014677
5,"Nordrhein-Westfalen",5758016,"Hiddenhausen",19721,9623,10098,0.487957000152122,19753,9558,10195,0.483875866956918,0.00491407099468635,0.290295190050447,0.704792660014677
5,"Nordrhein-Westfalen",5758020,"Kirchlengern",16058,7856,8202,0.489226553742683,15996,7810,8186,0.488247061765441,0.00491407099468635,0.290295190050447,0.704792660014677
5,"Nordrhein-Westfalen",5758024,"Löhne, Stadt",39661,19237,20424,0.485035677365674,40080,19561,20519,0.488048902195609,0.00491407099468635,0.290295190050447,0.704792660014677
5,"Nordrhein-Westfalen",5758028,"Rödinghausen",9785,4845,4940,0.495145631067961,9784,4859,4925,0.496627146361406,0.00491407099468635,0.290295190050447,0.704792660014677
5,"Nordrhein-Westfalen",5758032,"Spenge, Stadt",14797,7146,7651,0.482935730215584,14766,7169,7597,0.485507246376812,0.00491407099468635,0.290295190050447,0.704792660014677
5,"Nordrhein-Westfalen",5758036,"Vlotho, Stadt",19131,9388,9743,0.490721865035806,19075,9264,9811,0.485661861074705,0.00491407099468635,0.290295190050447,0.704792660014677
5,"Nordrhein-Westfalen",5762004,"Bad Driburg, Stadt",18538,8987,9551,0.484788003020822,18802,9081,9721,0.482980533985746,0.00491407099468635,0.290295190050447,0.704792660014677
5,"Nordrhein-Westfalen",5762008,"Beverungen, Stadt",13685,6733,6952,0.491998538545853,13859,6860,6999,0.494985208167977,0.00491407099468635,0.290295190050447,0.704792660014677
5,"Nordrhein-Westfalen",5762012,"Borgentreich, Stadt",9071,4650,4421,0.512622643589461,9008,4670,4338,0.518428063943162,0.00491407099468635,0.290295190050447,0.704792660014677
5,"Nordrhein-Westfalen",5762016,"Brakel, Stadt",16746,8323,8423,0.497014212349218,16704,8288,8416,0.496168582375479,0.00491407099468635,0.290295190050447,0.704792660014677
5,"Nordrhein-Westfalen",5762020,"Höxter, Stadt",30112,14828,15284,0.492428267800213,30991,15251,15740,0.492110612758543,0.00491407099468635,0.290295190050447,0.704792660014677
5,"Nordrhein-Westfalen",5762024,"Marienmünster, Stadt",5314,2678,2636,0.503951825366955,5213,2656,2557,0.509495492039133,0.00491407099468635,0.290295190050447,0.704792660014677
5,"Nordrhein-Westfalen",5762028,"Nieheim, Stadt",6508,3269,3239,0.502304855562385,6466,3263,3203,0.504639653572533,0.00491407099468635,0.290295190050447,0.704792660014677
5,"Nordrhein-Westfalen",5762032,"Steinheim, Stadt",13008,6405,6603,0.492389298892989,13044,6474,6570,0.496320147194112,0.00491407099468635,0.290295190050447,0.704792660014677
5,"Nordrhein-Westfalen",5762036,"Warburg, Stadt",23521,11469,12052,0.487606819437949,23357,11568,11789,0.495269084214582,0.00491407099468635,0.290295190050447,0.704792660014677
5,"Nordrhein-Westfalen",5762040,"Willebadessen, Stadt",8388,4219,4169,0.502980448259418,8447,4334,4113,0.513081567420386,0.00491407099468635,0.290295190050447,0.704792660014677
5,"Nordrhein-Westfalen",5766004,"Augustdorf",9598,4845,4753,0.504792665138571,9557,4817,4740,0.504028460814063,0.00491407099468635,0.290295190050447,0.704792660014677
5,"Nordrhein-Westfalen",5766008,"Bad Salzuflen, Stadt",52303,24773,27530,0.47364395923752,53812,25762,28050,0.478740801308258,0.00491407099468635,0.290295190050447,0.704792660014677
5,"Nordrhein-Westfalen",5766012,"Barntrup, Stadt",8977,4432,4545,0.493706137907987,8785,4302,4483,0.489698349459306,0.00491407099468635,0.290295190050447,0.704792660014677
5,"Nordrhein-Westfalen",5766016,"Blomberg, Stadt",15621,7656,7965,0.490109468023814,15972,7923,8049,0.496055597295267,0.00491407099468635,0.290295190050447,0.704792660014677
5,"Nordrhein-Westfalen",5766020,"Detmold, Stadt",73717,34826,38891,0.472428340816908,72646,34418,38228,0.473776945736861,0.00491407099468635,0.290295190050447,0.704792660014677
5,"Nordrhein-Westfalen",5766024,"Dörentrup",8169,4093,4076,0.501040519035378,8081,4072,4009,0.50389803242173,0.00491407099468635,0.290295190050447,0.704792660014677
5,"Nordrhein-Westfalen",5766028,"Extertal",11787,5898,5889,0.500381776533469,11980,5932,6048,0.495158597662771,0.00491407099468635,0.290295190050447,0.704792660014677
5,"Nordrhein-Westfalen",5766032,"Horn-Bad Meinberg, Stadt",17312,8379,8933,0.483999537892791,17616,8595,9021,0.487908719346049,0.00491407099468635,0.290295190050447,0.704792660014677
5,"Nordrhein-Westfalen",5766036,"Kalletal",14069,6857,7212,0.487383609353899,14228,6980,7248,0.490581951082373,0.00491407099468635,0.290295190050447,0.704792660014677
5,"Nordrhein-Westfalen",5766040,"Lage, Stadt",34761,17060,17701,0.490779897011018,35017,17109,17908,0.488591255675815,0.00491407099468635,0.290295190050447,0.704792660014677
5,"Nordrhein-Westfalen",5766044,"Lemgo, Stadt",40949,20022,20927,0.488949669100589,41186,20215,20971,0.490822124022726,0.00491407099468635,0.290295190050447,0.704792660014677
5,"Nordrhein-Westfalen",5766048,"Leopoldshöhe",15837,7839,7998,0.494980109869293,16040,7925,8115,0.494077306733167,0.00491407099468635,0.290295190050447,0.704792660014677
5,"Nordrhein-Westfalen",5766052,"Lügde, Stadt",10105,4979,5126,0.492726373082632,10224,5091,5133,0.497946009389671,0.00491407099468635,0.290295190050447,0.704792660014677
5,"Nordrhein-Westfalen",5766056,"Oerlinghausen, Stadt",16699,8064,8635,0.482903167854363,16606,8023,8583,0.48313862459352,0.00491407099468635,0.290295190050447,0.704792660014677
5,"Nordrhein-Westfalen",5766060,"Schieder-Schwalenberg, Stadt",8904,4360,4544,0.489667565139263,8681,4241,4440,0.488538186844834,0.00491407099468635,0.290295190050447,0.704792660014677
5,"Nordrhein-Westfalen",5766064,"Schlangen",8921,4466,4455,0.500616522811344,8770,4399,4371,0.501596351197263,0.00491407099468635,0.290295190050447,0.704792660014677
5,"Nordrhein-Westfalen",5770004,"Bad Oeynhausen, Stadt",48360,23317,25043,0.482154673283706,48016,23012,25004,0.479256914361879,0.00491407099468635,0.290295190050447,0.704792660014677
5,"Nordrhein-Westfalen",5770008,"Espelkamp, Stadt",24743,12009,12734,0.485349391747161,25108,12299,12809,0.489843874462323,0.00491407099468635,0.290295190050447,0.704792660014677
5,"Nordrhein-Westfalen",5770012,"Hille",16000,7837,8163,0.4898125,16021,7963,8058,0.497035141376943,0.00491407099468635,0.290295190050447,0.704792660014677
5,"Nordrhein-Westfalen",5770016,"Hüllhorst",13143,6444,6699,0.490299018488929,13246,6590,6656,0.497508681866224,0.00491407099468635,0.290295190050447,0.704792660014677
5,"Nordrhein-Westfalen",5770020,"Lübbecke, Stadt",25426,12150,13276,0.477857311413514,25636,12385,13251,0.483109689499142,0.00491407099468635,0.290295190050447,0.704792660014677
5,"Nordrhein-Westfalen",5770024,"Minden, Stadt",79940,38797,41143,0.485326494871153,81904,40019,41885,0.48860861496386,0.00491407099468635,0.290295190050447,0.704792660014677
5,"Nordrhein-Westfalen",5770028,"Petershagen, Stadt",25915,12949,12966,0.499672004630523,25470,12600,12870,0.49469964664311,0.00491407099468635,0.290295190050447,0.704792660014677
5,"Nordrhein-Westfalen",5770032,"Porta Westfalica, Stadt",35483,17384,18099,0.489924752698475,34918,17095,17823,0.48957557706627,0.00491407099468635,0.290295190050447,0.704792660014677
5,"Nordrhein-Westfalen",5770036,"Preußisch Oldendorf, Stadt",12671,6182,6489,0.487885723305185,12720,6255,6465,0.491745283018868,0.00491407099468635,0.290295190050447,0.704792660014677
5,"Nordrhein-Westfalen",5770040,"Rahden, Stadt",15540,7654,7886,0.492535392535393,15541,7729,7812,0.497329644167042,0.00491407099468635,0.290295190050447,0.704792660014677
5,"Nordrhein-Westfalen",5770044,"Stemwede",13711,6925,6786,0.505068922762745,13628,6950,6678,0.50997945406516,0.00491407099468635,0.290295190050447,0.704792660014677
5,"Nordrhein-Westfalen",5774004,"Altenbeken",9286,4673,4613,0.503230669825544,9204,4634,4570,0.503476749239461,0.00491407099468635,0.290295190050447,0.704792660014677
5,"Nordrhein-Westfalen",5774008,"Bad Lippspringe, Stadt",15051,7243,7808,0.481230483024384,15329,7367,7962,0.48059234131385,0.00491407099468635,0.290295190050447,0.704792660014677
5,"Nordrhein-Westfalen",5774012,"Borchen",13122,6466,6656,0.492760249961896,13353,6573,6780,0.492248932824084,0.00491407099468635,0.290295190050447,0.704792660014677
5,"Nordrhein-Westfalen",5774016,"Büren, Stadt",21627,11006,10621,0.508900910898414,21340,10739,10601,0.503233364573571,0.00491407099468635,0.290295190050447,0.704792660014677
5,"Nordrhein-Westfalen",5774020,"Delbrück, Stadt",30451,15437,15014,0.506945584709862,30049,15139,14910,0.503810442943193,0.00491407099468635,0.290295190050447,0.704792660014677
5,"Nordrhein-Westfalen",5774024,"Hövelhof",15779,7906,7873,0.50104569364345,16144,8068,8076,0.499752229930624,0.00491407099468635,0.290295190050447,0.704792660014677
5,"Nordrhein-Westfalen",5774028,"Lichtenau, Stadt",10498,5363,5135,0.510859211278339,10818,5513,5305,0.509613606951377,0.00491407099468635,0.290295190050447,0.704792660014677
5,"Nordrhein-Westfalen",5774032,"Paderborn, Stadt",143174,70234,72940,0.490549960188302,147688,72756,74932,0.492633118465955,0.00491407099468635,0.290295190050447,0.704792660014677
5,"Nordrhein-Westfalen",5774036,"Salzkotten, Stadt",24541,12016,12525,0.489629599445825,24942,12225,12717,0.490137118114025,0.00491407099468635,0.290295190050447,0.704792660014677
5,"Nordrhein-Westfalen",5774040,"Bad Wünnenberg, Stadt",12085,6020,6065,0.498138187836161,12225,6152,6073,0.503231083844581,0.00491407099468635,0.290295190050447,0.704792660014677
5,"Nordrhein-Westfalen",5911000,"Bochum, Stadt",362585,174486,188099,0.481227850021374,373976,182585,191391,0.488226517209661,0.00491407099468635,0.290295190050447,0.704792660014677
5,"Nordrhein-Westfalen",5913000,"Dortmund, Stadt",571403,277653,293750,0.485914494673637,580956,285444,295512,0.49133497201165,0.00491407099468635,0.290295190050447,0.704792660014677
5,"Nordrhein-Westfalen",5914000,"Hagen, Stadt",187333,90455,96878,0.482856731061799,187447,90456,96991,0.482568406002763,0.00491407099468635,0.290295190050447,0.704792660014677
5,"Nordrhein-Westfalen",5915000,"Hamm, Stadt",176474,85978,90496,0.487199247481215,182112,90817,91295,0.498687620804779,0.00491407099468635,0.290295190050447,0.704792660014677
5,"Nordrhein-Westfalen",5916000,"Herne, Stadt",154887,74647,80240,0.481944901767095,164244,80903,83341,0.492578115486715,0.00491407099468635,0.290295190050447,0.704792660014677
5,"Nordrhein-Westfalen",5954004,"Breckerfeld, Stadt",9029,4398,4631,0.487097131465279,9205,4526,4679,0.491689299293862,0.00491407099468635,0.290295190050447,0.704792660014677
5,"Nordrhein-Westfalen",5954008,"Ennepetal, Stadt",30241,14785,15456,0.488905790152442,30260,14678,15582,0.485062789160608,0.00491407099468635,0.290295190050447,0.704792660014677
5,"Nordrhein-Westfalen",5954012,"Gevelsberg, Stadt",31112,15138,15974,0.486564669580869,31344,15157,16187,0.483569423175089,0.00491407099468635,0.290295190050447,0.704792660014677
5,"Nordrhein-Westfalen",5954016,"Hattingen, Stadt",54241,26144,28097,0.4819970133294,55388,26604,28784,0.480320647071568,0.00491407099468635,0.290295190050447,0.704792660014677
5,"Nordrhein-Westfalen",5954020,"Herdecke, Stadt",22800,10836,11964,0.475263157894737,24210,11507,12703,0.475299463031805,0.00491407099468635,0.290295190050447,0.704792660014677
5,"Nordrhein-Westfalen",5954024,"Schwelm, Stadt",28225,13477,14748,0.47748449955713,28343,13608,14735,0.480118547789578,0.00491407099468635,0.290295190050447,0.704792660014677
5,"Nordrhein-Westfalen",5954028,"Sprockhövel, Stadt",25367,12160,13207,0.479362951866598,25264,12233,13031,0.484206776440785,0.00491407099468635,0.290295190050447,0.704792660014677
5,"Nordrhein-Westfalen",5954032,"Wetter (Ruhr), Stadt",27909,13622,14287,0.488086280411337,28037,13693,14344,0.488390341334665,0.00491407099468635,0.290295190050447,0.704792660014677
5,"Nordrhein-Westfalen",5954036,"Witten, Stadt",96221,46325,49896,0.481443759678241,97819,47135,50684,0.481859352477535,0.00491407099468635,0.290295190050447,0.704792660014677
5,"Nordrhein-Westfalen",5958004,"Arnsberg, Stadt",74125,36079,38046,0.486731871838111,73732,36004,37728,0.488309011012857,0.00491407099468635,0.290295190050447,0.704792660014677
5,"Nordrhein-Westfalen",5958008,"Bestwig",11498,5714,5784,0.496955992346495,11171,5486,5685,0.491093008683198,0.00491407099468635,0.290295190050447,0.704792660014677
5,"Nordrhein-Westfalen",5958012,"Brilon, Stadt",25690,12526,13164,0.48758271701051,26048,12831,13217,0.492590601965602,0.00491407099468635,0.290295190050447,0.704792660014677
5,"Nordrhein-Westfalen",5958016,"Eslohe (Sauerland)",9023,4501,4522,0.498836307214895,9088,4550,4538,0.500660211267606,0.00491407099468635,0.290295190050447,0.704792660014677
5,"Nordrhein-Westfalen",5958020,"Hallenberg, Stadt",4521,2262,2259,0.500331785003318,4421,2209,2212,0.499660710246551,0.00491407099468635,0.290295190050447,0.704792660014677
5,"Nordrhein-Westfalen",5958024,"Marsberg, Stadt",20232,10235,9997,0.505881771451166,20515,10406,10109,0.507238605898123,0.00491407099468635,0.290295190050447,0.704792660014677
5,"Nordrhein-Westfalen",5958028,"Medebach, Stadt",7923,3961,3962,0.49993689259119,7814,3924,3890,0.502175582288201,0.00491407099468635,0.290295190050447,0.704792660014677
5,"Nordrhein-Westfalen",5958032,"Meschede, Stadt",30637,15064,15573,0.491693050886183,30597,15126,15471,0.494362192371801,0.00491407099468635,0.290295190050447,0.704792660014677
5,"Nordrhein-Westfalen",5958036,"Olsberg, Stadt",14941,7295,7646,0.488253798273208,14931,7424,7507,0.497220547853459,0.00491407099468635,0.290295190050447,0.704792660014677
5,"Nordrhein-Westfalen",5958040,"Schmallenberg, Stadt",25277,12658,12619,0.500771452308423,25075,12517,12558,0.499182452642074,0.00491407099468635,0.290295190050447,0.704792660014677
5,"Nordrhein-Westfalen",5958044,"Sundern (Sauerland), Stadt",28365,14168,14197,0.499488806627886,28397,14082,14315,0.495897453956404,0.00491407099468635,0.290295190050447,0.704792660014677
5,"Nordrhein-Westfalen",5958048,"Winterberg, Stadt",12967,6436,6531,0.496336855093699,13456,6621,6835,0.492048156956005,0.00491407099468635,0.290295190050447,0.704792660014677
5,"Nordrhein-Westfalen",5962004,"Altena, Stadt",18079,8814,9265,0.487526964987001,17996,8770,9226,0.487330517892865,0.00491407099468635,0.290295190050447,0.704792660014677
5,"Nordrhein-Westfalen",5962008,"Balve, Stadt",11709,5749,5960,0.490989836877615,11803,5811,5992,0.492332457849699,0.00491407099468635,0.290295190050447,0.704792660014677
5,"Nordrhein-Westfalen",5962012,"Halver, Stadt",16413,8036,8377,0.489611893011637,16582,8157,8425,0.491918948257146,0.00491407099468635,0.290295190050447,0.704792660014677
5,"Nordrhein-Westfalen",5962016,"Hemer, Stadt",35658,17450,18208,0.489371249088564,37920,18964,18956,0.500105485232068,0.00491407099468635,0.290295190050447,0.704792660014677
5,"Nordrhein-Westfalen",5962020,"Herscheid",7305,3589,3716,0.491307323750856,7143,3522,3621,0.493070138597228,0.00491407099468635,0.290295190050447,0.704792660014677
5,"Nordrhein-Westfalen",5962024,"Iserlohn, Stadt",94367,45938,48429,0.486801530195937,94536,46047,48489,0.487084285351612,0.00491407099468635,0.290295190050447,0.704792660014677
5,"Nordrhein-Westfalen",5962028,"Kierspe, Stadt",16265,7936,8329,0.487918844143867,17103,8493,8610,0.496579547447816,0.00491407099468635,0.290295190050447,0.704792660014677
5,"Nordrhein-Westfalen",5962032,"Lüdenscheid, Stadt",73568,35857,37711,0.487399412788169,75199,36859,38340,0.490152794585034,0.00491407099468635,0.290295190050447,0.704792660014677
5,"Nordrhein-Westfalen",5962036,"Meinerzhagen, Stadt",20974,10398,10576,0.495756651091828,20706,10317,10389,0.498261373514923,0.00491407099468635,0.290295190050447,0.704792660014677
5,"Nordrhein-Westfalen",5962040,"Menden (Sauerland), Stadt",54292,26466,27826,0.487475134458115,55096,27125,27971,0.492322491650937,0.00491407099468635,0.290295190050447,0.704792660014677
5,"Nordrhein-Westfalen",5962044,"Nachrodt-Wiblingwerde",6652,3281,3371,0.493235117257968,6634,3260,3374,0.491407898703648,0.00491407099468635,0.290295190050447,0.704792660014677
5,"Nordrhein-Westfalen",5962048,"Neuenrade, Stadt",12120,6010,6110,0.495874587458746,12057,6059,5998,0.502529650825247,0.00491407099468635,0.290295190050447,0.704792660014677
5,"Nordrhein-Westfalen",5962052,"Plettenberg, Stadt",26134,12927,13207,0.494642993801179,26132,12856,13276,0.491963875707944,0.00491407099468635,0.290295190050447,0.704792660014677
5,"Nordrhein-Westfalen",5962056,"Schalksmühle",10727,5281,5446,0.492309126503216,10991,5472,5519,0.497861886998453,0.00491407099468635,0.290295190050447,0.704792660014677
5,"Nordrhein-Westfalen",5962060,"Werdohl, Stadt",18351,8962,9389,0.488365756634516,18487,9057,9430,0.489911829934549,0.00491407099468635,0.290295190050447,0.704792660014677
5,"Nordrhein-Westfalen",5966004,"Attendorn, Stadt",24426,12129,12297,0.496561041513142,24637,12225,12412,0.496204895076511,0.00491407099468635,0.290295190050447,0.704792660014677
5,"Nordrhein-Westfalen",5966008,"Drolshagen, Stadt",11803,5948,5855,0.503939676353469,12030,5988,6042,0.497755610972569,0.00491407099468635,0.290295190050447,0.704792660014677
5,"Nordrhein-Westfalen",5966012,"Finnentrop",17097,8622,8475,0.504298999824531,17446,8852,8594,0.507394245099163,0.00491407099468635,0.290295190050447,0.704792660014677
5,"Nordrhein-Westfalen",5966016,"Kirchhundem",12020,6046,5974,0.502995008319468,12190,6224,5966,0.510582444626743,0.00491407099468635,0.290295190050447,0.704792660014677
5,"Nordrhein-Westfalen",5966020,"Lennestadt, Stadt",26348,13142,13206,0.498785486564445,26888,13553,13335,0.504053853019935,0.00491407099468635,0.290295190050447,0.704792660014677
5,"Nordrhein-Westfalen",5966024,"Olpe, Stadt",24762,12031,12731,0.485865438979081,25322,12395,12927,0.489495300529184,0.00491407099468635,0.290295190050447,0.704792660014677
5,"Nordrhein-Westfalen",5966028,"Wenden",19688,9859,9829,0.500761885412434,19892,9895,9997,0.497436155238287,0.00491407099468635,0.290295190050447,0.704792660014677
5,"Nordrhein-Westfalen",5970004,"Bad Berleburg, Stadt",19616,9672,9944,0.493066884176183,19606,9690,9916,0.494236458227073,0.00491407099468635,0.290295190050447,0.704792660014677
5,"Nordrhein-Westfalen",5970008,"Burbach",14443,7169,7274,0.496365021117496,14317,7091,7226,0.495285325137948,0.00491407099468635,0.290295190050447,0.704792660014677
5,"Nordrhein-Westfalen",5970012,"Erndtebrück",7255,3638,3617,0.50144727773949,7144,3602,3542,0.504199328107503,0.00491407099468635,0.290295190050447,0.704792660014677
5,"Nordrhein-Westfalen",5970016,"Freudenberg, Stadt",18013,8764,9249,0.486537500693943,18349,8945,9404,0.487492506403619,0.00491407099468635,0.290295190050447,0.704792660014677
5,"Nordrhein-Westfalen",5970020,"Hilchenbach, Stadt",15315,7571,7744,0.494351942539993,15394,7666,7728,0.497986228400676,0.00491407099468635,0.290295190050447,0.704792660014677
5,"Nordrhein-Westfalen",5970024,"Kreuztal, Stadt",30792,15134,15658,0.491491296440634,31031,15360,15671,0.494988882085656,0.00491407099468635,0.290295190050447,0.704792660014677
5,"Nordrhein-Westfalen",5970028,"Bad Laasphe, Stadt",14094,6954,7140,0.493401447424436,14222,7112,7110,0.50007031359865,0.00491407099468635,0.290295190050447,0.704792660014677
5,"Nordrhein-Westfalen",5970032,"Netphen, Stadt",23296,11554,11742,0.495964972527473,23961,11950,12011,0.498727098201244,0.00491407099468635,0.290295190050447,0.704792660014677
5,"Nordrhein-Westfalen",5970036,"Neunkirchen",13810,6925,6885,0.501448225923244,13576,6815,6761,0.501988803771361,0.00491407099468635,0.290295190050447,0.704792660014677
5,"Nordrhein-Westfalen",5970040,"Siegen, Stadt",99230,47832,51398,0.482031643656152,103370,51036,52334,0.493721582664216,0.00491407099468635,0.290295190050447,0.704792660014677
5,"Nordrhein-Westfalen",5970044,"Wilnsdorf",20363,10024,10339,0.492265383293228,20615,10172,10443,0.493427116177541,0.00491407099468635,0.290295190050447,0.704792660014677
5,"Nordrhein-Westfalen",5974004,"Anröchte",10402,5207,5195,0.500576812151509,10464,5199,5265,0.496846330275229,0.00491407099468635,0.290295190050447,0.704792660014677
5,"Nordrhein-Westfalen",5974008,"Bad Sassendorf",11486,5468,6018,0.476057809507226,11728,5599,6129,0.477404502046385,0.00491407099468635,0.290295190050447,0.704792660014677
5,"Nordrhein-Westfalen",5974012,"Ense",12261,6148,6113,0.501427289780605,12584,6335,6249,0.503417037507947,0.00491407099468635,0.290295190050447,0.704792660014677
5,"Nordrhein-Westfalen",5974016,"Erwitte, Stadt",15647,7598,8049,0.485588291685307,15711,7675,8036,0.488511234167144,0.00491407099468635,0.290295190050447,0.704792660014677
5,"Nordrhein-Westfalen",5974020,"Geseke, Stadt",20700,10219,10481,0.493671497584541,20747,10315,10432,0.497180315226298,0.00491407099468635,0.290295190050447,0.704792660014677
5,"Nordrhein-Westfalen",5974024,"Lippetal",11923,5908,6015,0.495512874276608,12227,6106,6121,0.499386603418664,0.00491407099468635,0.290295190050447,0.704792660014677
5,"Nordrhein-Westfalen",5974028,"Lippstadt, Stadt",65861,32113,33748,0.487587494875571,66936,32633,34303,0.487525397394526,0.00491407099468635,0.290295190050447,0.704792660014677
5,"Nordrhein-Westfalen",5974032,"Möhnesee",11035,5592,5443,0.506751246035342,11349,5737,5612,0.505507093135959,0.00491407099468635,0.290295190050447,0.704792660014677
5,"Nordrhein-Westfalen",5974036,"Rüthen, Stadt",10577,5222,5355,0.493712772998015,10375,5106,5269,0.492144578313253,0.00491407099468635,0.290295190050447,0.704792660014677
5,"Nordrhein-Westfalen",5974040,"Soest, Stadt",46644,22318,24326,0.478475259411714,48543,23498,25045,0.484065673732567,0.00491407099468635,0.290295190050447,0.704792660014677
5,"Nordrhein-Westfalen",5974044,"Warstein, Stadt",25766,12636,13130,0.490413723511604,26893,13372,13521,0.4972297623917,0.00491407099468635,0.290295190050447,0.704792660014677
5,"Nordrhein-Westfalen",5974048,"Welver",12190,5972,6218,0.489909762100082,12304,6084,6220,0.494473342002601,0.00491407099468635,0.290295190050447,0.704792660014677
5,"Nordrhein-Westfalen",5974052,"Werl, Stadt",30565,15342,15223,0.501946671028955,32018,16173,15845,0.50512211880817,0.00491407099468635,0.290295190050447,0.704792660014677
5,"Nordrhein-Westfalen",5974056,"Wickede (Ruhr)",11483,5550,5933,0.483323173386746,11809,5687,6122,0.481581844356,0.00491407099468635,0.290295190050447,0.704792660014677
5,"Nordrhein-Westfalen",5978004,"Bergkamen, Stadt",48892,23975,24917,0.49036652213041,50267,24977,25290,0.496886625420256,0.00491407099468635,0.290295190050447,0.704792660014677
5,"Nordrhein-Westfalen",5978008,"Bönen",18057,8694,9363,0.481475328127596,18439,8923,9516,0.483919952275069,0.00491407099468635,0.290295190050447,0.704792660014677
5,"Nordrhein-Westfalen",5978012,"Fröndenberg/Ruhr, Stadt",20806,10190,10616,0.489762568489859,21712,10704,11008,0.492999263080324,0.00491407099468635,0.290295190050447,0.704792660014677
5,"Nordrhein-Westfalen",5978016,"Holzwickede",16754,8047,8707,0.480303211173451,17103,8263,8840,0.483131614336666,0.00491407099468635,0.290295190050447,0.704792660014677
5,"Nordrhein-Westfalen",5978020,"Kamen, Stadt",43765,21288,22477,0.486416085913401,44217,21449,22768,0.485084922088789,0.00491407099468635,0.290295190050447,0.704792660014677
5,"Nordrhein-Westfalen",5978024,"Lünen, Stadt",85554,41457,44097,0.484571148046848,87061,42250,44811,0.48529192175601,0.00491407099468635,0.290295190050447,0.704792660014677
5,"Nordrhein-Westfalen",5978028,"Schwerte, Stadt",46518,22408,24110,0.48170600627714,47983,23260,24723,0.484755017401997,0.00491407099468635,0.290295190050447,0.704792660014677
5,"Nordrhein-Westfalen",5978032,"Selm, Stadt",25827,12489,13338,0.483563712394006,26747,13199,13548,0.493475903839683,0.00491407099468635,0.290295190050447,0.704792660014677
5,"Nordrhein-Westfalen",5978036,"Unna, Stadt",59145,28310,30835,0.478654155042692,66202,33419,32783,0.504803480257394,0.00491407099468635,0.290295190050447,0.704792660014677
5,"Nordrhein-Westfalen",5978040,"Werne, Stadt",29555,14296,15259,0.483708340382338,29793,14384,15409,0.482797972678146,0.00491407099468635,0.290295190050447,0.704792660014677
6,"Hessen",6411000,"Darmstadt, Wissenschaftsstadt",145845,72978,72867,0.500380540985293,149052,75293,73759,0.505145855137804,0.00503725622843349,0.244265558308066,0.750697185463501
6,"Hessen",6412000,"Frankfurt am Main, Stadt",676533,331851,344682,0.490517092292615,691518,339541,351977,0.491008187783977,0.00503725622843349,0.244265558308066,0.750697185463501
6,"Hessen",6413000,"Offenbach am Main, Stadt",114855,56247,58608,0.489721823168343,122705,61820,60885,0.503809950694756,0.00503725622843349,0.244265558308066,0.750697185463501
6,"Hessen",6414000,"Wiesbaden, Landeshauptstadt",270952,128926,142026,0.475825976556733,278919,134566,144353,0.482455479906353,0.00503725622843349,0.244265558308066,0.750697185463501
6,"Hessen",6431001,"Abtsteinach",2444,1212,1232,0.495908346972177,2406,1197,1209,0.497506234413965,0.00503725622843349,0.244265558308066,0.750697185463501
6,"Hessen",6431002,"Bensheim, Stadt",39332,18967,20365,0.482228211125801,39805,19456,20349,0.488782816229117,0.00503725622843349,0.244265558308066,0.750697185463501
6,"Hessen",6431003,"Biblis",8863,4484,4379,0.505923502200158,8731,4408,4323,0.504867712747681,0.00503725622843349,0.244265558308066,0.750697185463501
6,"Hessen",6431004,"Birkenau",10059,4861,5198,0.483248831891838,9951,4832,5119,0.485579338759924,0.00503725622843349,0.244265558308066,0.750697185463501
6,"Hessen",6431005,"Bürstadt, Stadt",15297,7462,7835,0.48780806694123,15699,7731,7968,0.492451748519014,0.00503725622843349,0.244265558308066,0.750697185463501
6,"Hessen",6431006,"Einhausen",6171,3094,3077,0.50137741046832,6192,3117,3075,0.503391472868217,0.00503725622843349,0.244265558308066,0.750697185463501
6,"Hessen",6431007,"Fürth",10535,5232,5303,0.496630280018984,10681,5272,5409,0.493586742814343,0.00503725622843349,0.244265558308066,0.750697185463501
6,"Hessen",6431008,"Gorxheimertal",4020,1974,2046,0.491044776119403,3897,1909,1988,0.489863997947139,0.00503725622843349,0.244265558308066,0.750697185463501
6,"Hessen",6431009,"Grasellenbach",3848,1938,1910,0.503638253638254,3772,1939,1833,0.514050901378579,0.00503725622843349,0.244265558308066,0.750697185463501
6,"Hessen",6431010,"Groß-Rohrheim",3727,1878,1849,0.503890528575262,3700,1879,1821,0.507837837837838,0.00503725622843349,0.244265558308066,0.750697185463501
6,"Hessen",6431011,"Heppenheim (Bergstraße), Kreisstadt",24883,12154,12729,0.48844592693807,25204,12332,12872,0.48928741469608,0.00503725622843349,0.244265558308066,0.750697185463501
6,"Hessen",6431012,"Hirschhorn (Neckar), Stadt",3520,1735,1785,0.492897727272727,3533,1741,1792,0.492782337956411,0.00503725622843349,0.244265558308066,0.750697185463501
6,"Hessen",6431013,"Lampertheim, Stadt",31175,15220,15955,0.488211708099439,31422,15409,16013,0.490388899497168,0.00503725622843349,0.244265558308066,0.750697185463501
6,"Hessen",6431014,"Lautertal (Odenwald)",7106,3447,3659,0.485083028426682,7041,3438,3603,0.488282914358756,0.00503725622843349,0.244265558308066,0.750697185463501
6,"Hessen",6431015,"Lindenfels, Stadt",5032,2440,2592,0.48489666136725,4973,2426,2547,0.487834305248341,0.00503725622843349,0.244265558308066,0.750697185463501
6,"Hessen",6431016,"Lorsch, Karolingerstadt",12955,6278,6677,0.484600540331918,13110,6428,6682,0.490312738367658,0.00503725622843349,0.244265558308066,0.750697185463501
6,"Hessen",6431017,"Mörlenbach",9870,4859,5011,0.492299898682877,10123,4986,5137,0.492541736639336,0.00503725622843349,0.244265558308066,0.750697185463501
6,"Hessen",6431018,"Neckarsteinach, Stadt",3812,1889,1923,0.495540398740818,3765,1868,1897,0.496148738379814,0.00503725622843349,0.244265558308066,0.750697185463501
6,"Hessen",6431019,"Rimbach",8526,4162,4364,0.488153882242552,8491,4156,4335,0.489459427629254,0.00503725622843349,0.244265558308066,0.750697185463501
6,"Hessen",6431020,"Viernheim, Stadt",32723,15812,16911,0.483207529871956,32721,15829,16892,0.483756608905596,0.00503725622843349,0.244265558308066,0.750697185463501
6,"Hessen",6431021,"Wald-Michelbach",10606,5287,5319,0.498491419950971,10801,5400,5401,0.499953707990001,0.00503725622843349,0.244265558308066,0.750697185463501
6,"Hessen",6431022,"Zwingenberg, Stadt",6654,3251,3403,0.488578298767659,6784,3319,3465,0.489239386792453,0.00503725622843349,0.244265558308066,0.750697185463501
6,"Hessen",6432001,"Alsbach-Hähnlein",9180,4517,4663,0.492047930283224,9301,4633,4668,0.498118481883668,0.00503725622843349,0.244265558308066,0.750697185463501
6,"Hessen",6432002,"Babenhausen, Stadt",15623,7761,7862,0.49676758625104,16032,8001,8031,0.499064371257485,0.00503725622843349,0.244265558308066,0.750697185463501
6,"Hessen",6432003,"Bickenbach",5457,2647,2810,0.485065054059007,5553,2734,2819,0.492346479380515,0.00503725622843349,0.244265558308066,0.750697185463501
6,"Hessen",6432004,"Dieburg, Stadt",14546,7107,7439,0.488587927952702,15319,7826,7493,0.51086885566943,0.00503725622843349,0.244265558308066,0.750697185463501
6,"Hessen",6432005,"Eppertshausen",6061,2997,3064,0.494472859264148,6051,2968,3083,0.490497438439927,0.00503725622843349,0.244265558308066,0.750697185463501
6,"Hessen",6432006,"Erzhausen",7511,3685,3826,0.490613766475835,7503,3705,3798,0.493802479008397,0.00503725622843349,0.244265558308066,0.750697185463501
6,"Hessen",6432007,"Fischbachtal",2630,1327,1303,0.504562737642586,2659,1326,1333,0.498683715682587,0.00503725622843349,0.244265558308066,0.750697185463501
6,"Hessen",6432008,"Griesheim, Stadt",25779,12713,13066,0.493153341867411,26592,13186,13406,0.495863417569194,0.00503725622843349,0.244265558308066,0.750697185463501
6,"Hessen",6432009,"Groß-Bieberau, Stadt",4580,2272,2308,0.496069868995633,4580,2320,2260,0.506550218340611,0.00503725622843349,0.244265558308066,0.750697185463501
6,"Hessen",6432010,"Groß-Umstadt, Stadt",20707,10215,10492,0.493311440575651,21309,10677,10632,0.501055891876672,0.00503725622843349,0.244265558308066,0.750697185463501
6,"Hessen",6432011,"Groß-Zimmern",13538,6695,6843,0.494533904564928,13823,6939,6884,0.501989437893366,0.00503725622843349,0.244265558308066,0.750697185463501
6,"Hessen",6432012,"Messel",3755,1861,1894,0.49560585885486,3782,1933,1849,0.511105235325225,0.00503725622843349,0.244265558308066,0.750697185463501
6,"Hessen",6432013,"Modautal",4989,2487,2502,0.498496692723993,4958,2510,2448,0.506252521177894,0.00503725622843349,0.244265558308066,0.750697185463501
6,"Hessen",6432014,"Mühltal",13444,6582,6862,0.489586432609342,13813,6778,7035,0.490697169333237,0.00503725622843349,0.244265558308066,0.750697185463501
6,"Hessen",6432015,"Münster",14058,6946,7112,0.494095888462086,14232,7078,7154,0.497329960652052,0.00503725622843349,0.244265558308066,0.750697185463501
6,"Hessen",6432016,"Ober-Ramstadt, Stadt",14559,7167,7392,0.492272820935504,15052,7455,7597,0.495283018867925,0.00503725622843349,0.244265558308066,0.750697185463501
6,"Hessen",6432017,"Otzberg",6325,3164,3161,0.500237154150198,6345,3177,3168,0.500709219858156,0.00503725622843349,0.244265558308066,0.750697185463501
6,"Hessen",6432018,"Pfungstadt, Stadt",23783,11581,12202,0.486944456124122,24590,12026,12564,0.489060593737292,0.00503725622843349,0.244265558308066,0.750697185463501
6,"Hessen",6432019,"Reinheim, Stadt",16251,8011,8240,0.492954279736632,16928,8386,8542,0.49539224952741,0.00503725622843349,0.244265558308066,0.750697185463501
6,"Hessen",6432020,"Roßdorf",11891,5867,6024,0.493398368514002,12027,5993,6034,0.498295501787644,0.00503725622843349,0.244265558308066,0.750697185463501
6,"Hessen",6432021,"Schaafheim",9040,4513,4527,0.499225663716814,8943,4439,4504,0.496365872749637,0.00503725622843349,0.244265558308066,0.750697185463501
6,"Hessen",6432022,"Seeheim-Jugenheim",15786,7586,8200,0.480552388192069,15855,7648,8207,0.482371491643015,0.00503725622843349,0.244265558308066,0.750697185463501
6,"Hessen",6432023,"Weiterstadt, Stadt",23972,12016,11956,0.50125146003671,24785,12174,12611,0.491184183982247,0.00503725622843349,0.244265558308066,0.750697185463501
6,"Hessen",6433001,"Biebesheim am Rhein",6347,3133,3214,0.493619032613833,6420,3204,3216,0.499065420560748,0.00503725622843349,0.244265558308066,0.750697185463501
6,"Hessen",6433002,"Bischofsheim",12542,6104,6438,0.486684739276033,12662,6228,6434,0.491865424103617,0.00503725622843349,0.244265558308066,0.750697185463501
6,"Hessen",6433003,"Büttelborn",13741,6719,7022,0.488974601557383,13916,6915,7001,0.496910031618281,0.00503725622843349,0.244265558308066,0.750697185463501
6,"Hessen",6433004,"Gernsheim, Schöfferstadt",9826,4866,4960,0.495216771829839,9721,4834,4887,0.497273943009978,0.00503725622843349,0.244265558308066,0.750697185463501
6,"Hessen",6433005,"Ginsheim-Gustavsburg",15836,7709,8127,0.486802222783531,15988,7867,8121,0.492056542406805,0.00503725622843349,0.244265558308066,0.750697185463501
6,"Hessen",6433006,"Groß-Gerau, Stadt",23876,11774,12102,0.493131177751717,23502,11440,12062,0.486767083652455,0.00503725622843349,0.244265558308066,0.750697185463501
6,"Hessen",6433007,"Kelsterbach, Stadt",13449,6745,6704,0.501524276897911,13593,6827,6766,0.50224380195689,0.00503725622843349,0.244265558308066,0.750697185463501
6,"Hessen",6433008,"Mörfelden-Walldorf, Stadt",32634,16209,16425,0.49669056811914,34430,17758,16672,0.515771129828638,0.00503725622843349,0.244265558308066,0.750697185463501
6,"Hessen",6433009,"Nauheim",9991,4896,5095,0.49004103693324,10160,5032,5128,0.495275590551181,0.00503725622843349,0.244265558308066,0.750697185463501
6,"Hessen",6433010,"Raunheim, Stadt",14675,7232,7443,0.492810902896082,15125,7519,7606,0.497123966942149,0.00503725622843349,0.244265558308066,0.750697185463501
6,"Hessen",6433011,"Riedstadt, Stadt",21597,10643,10954,0.492799925915636,21575,10677,10898,0.494878331402086,0.00503725622843349,0.244265558308066,0.750697185463501
6,"Hessen",6433012,"Rüsselsheim, Stadt",59307,29103,30204,0.490717790480044,61074,30464,30610,0.498804728689786,0.00503725622843349,0.244265558308066,0.750697185463501
6,"Hessen",6433013,"Stockstadt am Rhein",5821,2880,2941,0.494760350455248,5739,2816,2923,0.490677818435267,0.00503725622843349,0.244265558308066,0.750697185463501
6,"Hessen",6433014,"Trebur",13128,6495,6633,0.494744058500914,13238,6597,6641,0.498338117540414,0.00503725622843349,0.244265558308066,0.750697185463501
6,"Hessen",6434001,"Bad Homburg v. d. Höhe, Stadt",51625,24047,27578,0.465801452784504,52528,24476,28052,0.46596101127018,0.00503725622843349,0.244265558308066,0.750697185463501
6,"Hessen",6434002,"Friedrichsdorf, Stadt",24436,11966,12470,0.489687346537895,24836,12208,12628,0.491544532130778,0.00503725622843349,0.244265558308066,0.750697185463501
6,"Hessen",6434003,"Glashütten",5262,2560,2702,0.48650703154694,5276,2575,2701,0.48805913570887,0.00503725622843349,0.244265558308066,0.750697185463501
6,"Hessen",6434004,"Grävenwiesbach",5219,2647,2572,0.507185284537268,5294,2697,2597,0.509444654325652,0.00503725622843349,0.244265558308066,0.750697185463501
6,"Hessen",6434005,"Königstein im Taunus, Stadt",15836,7403,8433,0.467479161404395,16122,7742,8380,0.480213373030641,0.00503725622843349,0.244265558308066,0.750697185463501
6,"Hessen",6434006,"Kronberg im Taunus, Stadt",17835,8248,9587,0.462461452200729,17711,8213,9498,0.463723109931681,0.00503725622843349,0.244265558308066,0.750697185463501
6,"Hessen",6434007,"Neu-Anspach, Stadt",14652,7215,7437,0.492424242424242,14658,7263,7395,0.495497339336881,0.00503725622843349,0.244265558308066,0.750697185463501
6,"Hessen",6434008,"Oberursel (Taunus), Stadt",44209,21316,22893,0.48216426519487,44075,21217,22858,0.48138400453772,0.00503725622843349,0.244265558308066,0.750697185463501
6,"Hessen",6434009,"Schmitten",8866,4455,4411,0.502481389578164,8793,4401,4392,0.500511770726714,0.00503725622843349,0.244265558308066,0.750697185463501
6,"Hessen",6434010,"Steinbach (Taunus), Stadt",10157,4858,5299,0.47829083390765,10153,4854,5299,0.478085294986703,0.00503725622843349,0.244265558308066,0.750697185463501
6,"Hessen",6434011,"Usingen, Stadt",13356,6509,6847,0.487346510931417,13399,6509,6890,0.485782521083663,0.00503725622843349,0.244265558308066,0.750697185463501
6,"Hessen",6434012,"Wehrheim",9238,4559,4679,0.493505087681316,9300,4623,4677,0.497096774193548,0.00503725622843349,0.244265558308066,0.750697185463501
6,"Hessen",6434013,"Weilrod",6273,3132,3141,0.499282639885222,6187,3112,3075,0.502990140617424,0.00503725622843349,0.244265558308066,0.750697185463501
6,"Hessen",6435001,"Bad Orb, Stadt",9258,4369,4889,0.471916180600562,9820,4687,5133,0.477291242362525,0.00503725622843349,0.244265558308066,0.750697185463501
6,"Hessen",6435002,"Bad Soden-Salmünster, Stadt",13386,6557,6829,0.489840131480651,13573,6809,6764,0.501657702792308,0.00503725622843349,0.244265558308066,0.750697185463501
6,"Hessen",6435003,"Biebergemünd",8380,4185,4195,0.499403341288783,8309,4125,4184,0.49644963292815,0.00503725622843349,0.244265558308066,0.750697185463501
6,"Hessen",6435004,"Birstein",6283,3125,3158,0.497373865987586,6209,3091,3118,0.497825736833629,0.00503725622843349,0.244265558308066,0.750697185463501
6,"Hessen",6435005,"Brachttal",5188,2549,2639,0.491326137239784,5113,2516,2597,0.492079014277332,0.00503725622843349,0.244265558308066,0.750697185463501
6,"Hessen",6435006,"Bruchköbel, Stadt",20326,9825,10501,0.483371051854767,20574,9977,10597,0.48493243900068,0.00503725622843349,0.244265558308066,0.750697185463501
6,"Hessen",6435007,"Erlensee",13138,6419,6719,0.488582737098493,13141,6538,6603,0.497526824442584,0.00503725622843349,0.244265558308066,0.750697185463501
6,"Hessen",6435008,"Flörsbachtal",2464,1231,1233,0.499594155844156,2482,1240,1242,0.499597099113618,0.00503725622843349,0.244265558308066,0.750697185463501
6,"Hessen",6435009,"Freigericht",14344,7003,7341,0.488218070273285,14561,7155,7406,0.491381086463842,0.00503725622843349,0.244265558308066,0.750697185463501
6,"Hessen",6435010,"Gelnhausen, Barbarossast., Krst.",21863,10607,11256,0.485157572153867,21565,10460,11105,0.485045212149316,0.00503725622843349,0.244265558308066,0.750697185463501
6,"Hessen",6435011,"Großkrotzenburg",7307,3593,3714,0.491720268235938,7291,3608,3683,0.494856672610067,0.00503725622843349,0.244265558308066,0.750697185463501
6,"Hessen",6435012,"Gründau",14368,7009,7359,0.487820155902004,14639,7211,7428,0.492588291549969,0.00503725622843349,0.244265558308066,0.750697185463501
6,"Hessen",6435013,"Hammersbach",4731,2364,2367,0.499682942295498,4761,2370,2391,0.497794580970384,0.00503725622843349,0.244265558308066,0.750697185463501
6,"Hessen",6435014,"Hanau, Brüder-Grimm-Stadt",87521,42525,44996,0.485883387986883,89688,43970,45718,0.49025510659174,0.00503725622843349,0.244265558308066,0.750697185463501
6,"Hessen",6435015,"Hasselroth",7282,3605,3677,0.495056303213403,7307,3619,3688,0.495278500068428,0.00503725622843349,0.244265558308066,0.750697185463501
6,"Hessen",6435016,"Jossgrund",3599,1816,1783,0.504584606835232,3581,1862,1719,0.519966489807316,0.00503725622843349,0.244265558308066,0.750697185463501
6,"Hessen",6435017,"Langenselbold, Stadt",13475,6542,6933,0.485491651205937,13512,6523,6989,0.482756068679692,0.00503725622843349,0.244265558308066,0.750697185463501
6,"Hessen",6435018,"Linsengericht",9875,4867,5008,0.492860759493671,9822,4825,4997,0.491244145795154,0.00503725622843349,0.244265558308066,0.750697185463501
6,"Hessen",6435019,"Maintal, Stadt",36021,17306,18715,0.48044196440965,38261,18832,19429,0.492198322051175,0.00503725622843349,0.244265558308066,0.750697185463501
6,"Hessen",6435020,"Neuberg",5222,2574,2648,0.492914592110303,5186,2535,2651,0.488816043193212,0.00503725622843349,0.244265558308066,0.750697185463501
6,"Hessen",6435021,"Nidderau, Stadt",19802,9703,10099,0.49000100999899,19771,9784,9987,0.494866218198371,0.00503725622843349,0.244265558308066,0.750697185463501
6,"Hessen",6435022,"Niederdorfelden",3770,1872,1898,0.496551724137931,3729,1866,1863,0.500402252614642,0.00503725622843349,0.244265558308066,0.750697185463501
6,"Hessen",6435023,"Rodenbach",11199,5456,5743,0.487186355924636,11188,5489,5699,0.490614944583482,0.00503725622843349,0.244265558308066,0.750697185463501
6,"Hessen",6435024,"Ronneburg",3345,1640,1705,0.490284005979073,3248,1595,1653,0.491071428571429,0.00503725622843349,0.244265558308066,0.750697185463501
6,"Hessen",6435025,"Schlüchtern, Stadt",16239,8048,8191,0.495597019520906,16680,8298,8382,0.497482014388489,0.00503725622843349,0.244265558308066,0.750697185463501
6,"Hessen",6435026,"Schöneck",11640,5676,5964,0.487628865979381,12121,6008,6113,0.495668674201799,0.00503725622843349,0.244265558308066,0.750697185463501
6,"Hessen",6435027,"Sinntal",9027,4486,4541,0.496953583693364,9065,4562,4503,0.503254274682846,0.00503725622843349,0.244265558308066,0.750697185463501
6,"Hessen",6435028,"Steinau an der Straße, Brüder-Grimm-Stadt",10512,5158,5354,0.490677321156773,10634,5326,5308,0.500846341922137,0.00503725622843349,0.244265558308066,0.750697185463501
6,"Hessen",6435029,"Wächtersbach, Stadt",12258,5978,6280,0.487681514113232,12269,5987,6282,0.487977830304018,0.00503725622843349,0.244265558308066,0.750697185463501
6,"Hessen",6436001,"Bad Soden am Taunus, Stadt",21102,10027,11075,0.475168230499479,21711,10394,11317,0.478743494081341,0.00503725622843349,0.244265558308066,0.750697185463501
6,"Hessen",6436002,"Eppstein, Stadt",13277,6425,6852,0.483919560141598,13236,6548,6688,0.494711393170142,0.00503725622843349,0.244265558308066,0.750697185463501
6,"Hessen",6436003,"Eschborn, Stadt",20395,9861,10534,0.483500858053444,20907,10183,10724,0.487061749653226,0.00503725622843349,0.244265558308066,0.750697185463501
6,"Hessen",6436004,"Flörsheim am Main, Stadt",19930,9584,10346,0.480883090817863,20393,9901,10492,0.485509733732163,0.00503725622843349,0.244265558308066,0.750697185463501
6,"Hessen",6436005,"Hattersheim am Main, Stadt",24864,12301,12563,0.494731338481338,25777,12747,13030,0.494510610233929,0.00503725622843349,0.244265558308066,0.750697185463501
6,"Hessen",6436006,"Hochheim am Main, Stadt",16914,8223,8691,0.486165306846399,16957,8172,8785,0.481924868785752,0.00503725622843349,0.244265558308066,0.750697185463501
6,"Hessen",6436007,"Hofheim am Taunus, Kreisstadt",37982,18410,19572,0.48470328050129,38437,18740,19697,0.487551057574733,0.00503725622843349,0.244265558308066,0.750697185463501
6,"Hessen",6436008,"Kelkheim (Taunus), Stadt",27777,13477,14300,0.485185585196385,28019,13636,14383,0.486669759805846,0.00503725622843349,0.244265558308066,0.750697185463501
6,"Hessen",6436009,"Kriftel",10530,5160,5370,0.49002849002849,10880,5386,5494,0.495036764705882,0.00503725622843349,0.244265558308066,0.750697185463501
6,"Hessen",6436010,"Liederbach am Taunus",8759,4359,4400,0.497659550176961,8832,4426,4406,0.501132246376812,0.00503725622843349,0.244265558308066,0.750697185463501
6,"Hessen",6436011,"Schwalbach am Taunus, Stadt",14789,7029,7760,0.475285685306647,14846,6939,7907,0.467398625892496,0.00503725622843349,0.244265558308066,0.750697185463501
6,"Hessen",6436012,"Sulzbach (Taunus)",8504,4103,4401,0.482478833490122,8476,4117,4359,0.485724398301085,0.00503725622843349,0.244265558308066,0.750697185463501
6,"Hessen",6437001,"Bad König, Stadt",9352,4544,4808,0.485885372112917,9343,4547,4796,0.486674515680188,0.00503725622843349,0.244265558308066,0.750697185463501
6,"Hessen",6437002,"Beerfelden, Stadt",6440,3232,3208,0.501863354037267,6468,3269,3199,0.505411255411255,0.00503725622843349,0.244265558308066,0.750697185463501
6,"Hessen",6437003,"Brensbach",5138,2557,2581,0.49766446087972,5157,2590,2567,0.502229978669769,0.00503725622843349,0.244265558308066,0.750697185463501
6,"Hessen",6437004,"Breuberg, Stadt",7425,3610,3815,0.486195286195286,7301,3539,3762,0.484728119435694,0.00503725622843349,0.244265558308066,0.750697185463501
6,"Hessen",6437005,"Brombachtal",3556,1729,1827,0.486220472440945,3601,1763,1838,0.48958622604832,0.00503725622843349,0.244265558308066,0.750697185463501
6,"Hessen",6437006,"Erbach, Kreisstadt",13399,6408,6991,0.47824464512277,13476,6506,6970,0.482784208964084,0.00503725622843349,0.244265558308066,0.750697185463501
6,"Hessen",6437007,"Fränkisch-Crumbach",3209,1578,1631,0.491741975693362,3202,1568,1634,0.489693941286696,0.00503725622843349,0.244265558308066,0.750697185463501
6,"Hessen",6437008,"Hesseneck",656,326,330,0.496951219512195,612,313,299,0.511437908496732,0.00503725622843349,0.244265558308066,0.750697185463501
6,"Hessen",6437009,"Höchst i. Odw.",10001,4948,5053,0.494750524947505,9733,4844,4889,0.497688276995788,0.00503725622843349,0.244265558308066,0.750697185463501
6,"Hessen",6437010,"Lützelbach",6838,3414,3424,0.499268792044457,6919,3500,3419,0.505853447029918,0.00503725622843349,0.244265558308066,0.750697185463501
6,"Hessen",6437011,"Michelstadt, Stadt",16311,8148,8163,0.499540187603458,16469,8198,8271,0.497783714858218,0.00503725622843349,0.244265558308066,0.750697185463501
6,"Hessen",6437012,"Mossautal",2585,1315,1270,0.508704061895551,2531,1291,1240,0.510075069142631,0.00503725622843349,0.244265558308066,0.750697185463501
6,"Hessen",6437013,"Reichelsheim (Odenwald)",8565,4220,4345,0.492702860478692,8653,4278,4375,0.494395007511846,0.00503725622843349,0.244265558308066,0.750697185463501
6,"Hessen",6437014,"Rothenberg",2361,1140,1221,0.48284625158831,2364,1152,1212,0.487309644670051,0.00503725622843349,0.244265558308066,0.750697185463501
6,"Hessen",6437015,"Sensbachtal",949,483,466,0.50895679662803,967,503,464,0.520165460186143,0.00503725622843349,0.244265558308066,0.750697185463501
6,"Hessen",6438001,"Dietzenbach, Kreisstadt",32030,15879,16151,0.495753980643147,33479,16724,16755,0.499537023208579,0.00503725622843349,0.244265558308066,0.750697185463501
6,"Hessen",6438002,"Dreieich, Stadt",39526,19142,20384,0.484288822547184,40721,19889,20832,0.488421207730655,0.00503725622843349,0.244265558308066,0.750697185463501
6,"Hessen",6438003,"Egelsbach",11047,5488,5559,0.496786457861863,11101,5523,5578,0.497522745698586,0.00503725622843349,0.244265558308066,0.750697185463501
6,"Hessen",6438004,"Hainburg",13961,6714,7247,0.480911109519375,14360,7074,7286,0.492618384401114,0.00503725622843349,0.244265558308066,0.750697185463501
6,"Hessen",6438005,"Heusenstamm, Stadt",18101,8914,9187,0.492458980166842,18376,9076,9300,0.493905093600348,0.00503725622843349,0.244265558308066,0.750697185463501
6,"Hessen",6438006,"Langen (Hessen), Stadt",35303,17153,18150,0.485879387020933,36031,17630,18401,0.489300879797952,0.00503725622843349,0.244265558308066,0.750697185463501
6,"Hessen",6438007,"Mainhausen",8967,4436,4531,0.494702799152448,8916,4477,4439,0.502131000448632,0.00503725622843349,0.244265558308066,0.750697185463501
6,"Hessen",6438008,"Mühlheim am Main, Stadt",26918,13109,13809,0.486997548109072,27058,13240,13818,0.489319240150787,0.00503725622843349,0.244265558308066,0.750697185463501
6,"Hessen",6438009,"Neu-Isenburg, Stadt",35051,16830,18221,0.480157484807851,36485,17712,18773,0.485459777990955,0.00503725622843349,0.244265558308066,0.750697185463501
6,"Hessen",6438010,"Obertshausen, Stadt",23814,11539,12275,0.484546905181826,24179,11801,12378,0.488068158319203,0.00503725622843349,0.244265558308066,0.750697185463501
6,"Hessen",6438011,"Rodgau, Stadt",42945,21186,21759,0.493328676213762,43237,21347,21890,0.493720655919698,0.00503725622843349,0.244265558308066,0.750697185463501
6,"Hessen",6438012,"Rödermark, Stadt",26297,12795,13502,0.486557401985017,25940,12738,13202,0.491056283731689,0.00503725622843349,0.244265558308066,0.750697185463501
6,"Hessen",6438013,"Seligenstadt, Stadt",20059,9656,10403,0.481379929208834,20231,9841,10390,0.486431713706688,0.00503725622843349,0.244265558308066,0.750697185463501
6,"Hessen",6439001,"Aarbergen",5999,3002,2997,0.500416736122687,5957,3008,2949,0.50495215712607,0.00503725622843349,0.244265558308066,0.750697185463501
6,"Hessen",6439002,"Bad Schwalbach, Kreisstadt",10409,5056,5353,0.485733499855894,10646,5159,5487,0.484595153109149,0.00503725622843349,0.244265558308066,0.750697185463501
6,"Hessen",6439003,"Eltville am Rhein, Stadt",16711,8106,8605,0.485069714559272,17713,8666,9047,0.48924518715068,0.00503725622843349,0.244265558308066,0.750697185463501
6,"Hessen",6439004,"Geisenheim, Stadt",11605,5664,5941,0.488065489013356,11560,5625,5935,0.48659169550173,0.00503725622843349,0.244265558308066,0.750697185463501
6,"Hessen",6439005,"Heidenrod",7859,3945,3914,0.501972261101921,7897,3992,3905,0.505508420919336,0.00503725622843349,0.244265558308066,0.750697185463501
6,"Hessen",6439006,"Hohenstein",6040,3017,3023,0.499503311258278,6105,3079,3026,0.504340704340704,0.00503725622843349,0.244265558308066,0.750697185463501
6,"Hessen",6439007,"Hünstetten",10042,4941,5101,0.492033459470225,10229,5066,5163,0.495258578551178,0.00503725622843349,0.244265558308066,0.750697185463501
6,"Hessen",6439008,"Idstein, Stadt",23409,11336,12073,0.484258191293947,23476,11534,11942,0.491310274322713,0.00503725622843349,0.244265558308066,0.750697185463501
6,"Hessen",6439009,"Kiedrich",3912,1863,2049,0.476226993865031,3925,1874,2051,0.477452229299363,0.00503725622843349,0.244265558308066,0.750697185463501
6,"Hessen",6439010,"Lorch, Stadt",3799,1852,1947,0.487496709660437,3778,1856,1922,0.491265219692959,0.00503725622843349,0.244265558308066,0.750697185463501
6,"Hessen",6439011,"Niedernhausen",14402,7069,7333,0.49083460630468,14431,7049,7382,0.488462338022313,0.00503725622843349,0.244265558308066,0.750697185463501
6,"Hessen",6439012,"Oestrich-Winkel, Stadt",11381,5579,5802,0.490202969862051,11583,5683,5900,0.490632823966157,0.00503725622843349,0.244265558308066,0.750697185463501
6,"Hessen",6439013,"Rüdesheim am Rhein, Stadt",9795,4804,4991,0.490454313425217,9659,4711,4948,0.487731649239052,0.00503725622843349,0.244265558308066,0.750697185463501
6,"Hessen",6439014,"Schlangenbad",6081,3036,3045,0.499259990133202,6208,3152,3056,0.507731958762887,0.00503725622843349,0.244265558308066,0.750697185463501
6,"Hessen",6439015,"Taunusstein, Stadt",28385,13652,14733,0.480958252598203,29000,14080,14920,0.48551724137931,0.00503725622843349,0.244265558308066,0.750697185463501
6,"Hessen",6439016,"Waldems",5175,2545,2630,0.491787439613527,5489,2768,2721,0.504281289852432,0.00503725622843349,0.244265558308066,0.750697185463501
6,"Hessen",6439017,"Walluf",5502,2672,2830,0.485641584878226,5523,2687,2836,0.486510954191563,0.00503725622843349,0.244265558308066,0.750697185463501
6,"Hessen",6440001,"Altenstadt",11825,5861,5964,0.495644820295983,11889,5900,5989,0.496257044326689,0.00503725622843349,0.244265558308066,0.750697185463501
6,"Hessen",6440002,"Bad Nauheim, Stadt",30313,14053,16260,0.463596476759146,31314,14585,16729,0.465766111004662,0.00503725622843349,0.244265558308066,0.750697185463501
6,"Hessen",6440003,"Bad Vilbel, Stadt",31673,15257,16416,0.481703659268146,32238,15707,16531,0.487220050871642,0.00503725622843349,0.244265558308066,0.750697185463501
6,"Hessen",6440004,"Büdingen, Stadt",20897,10287,10610,0.492271617935589,21201,10447,10754,0.492759775482289,0.00503725622843349,0.244265558308066,0.750697185463501
6,"Hessen",6440005,"Butzbach, Stadt",23933,11901,12032,0.497263193080684,24981,12463,12518,0.498899163364157,0.00503725622843349,0.244265558308066,0.750697185463501
6,"Hessen",6440006,"Echzell",5601,2747,2854,0.490448134261739,5730,2884,2846,0.503315881326353,0.00503725622843349,0.244265558308066,0.750697185463501
6,"Hessen",6440007,"Florstadt, Stadt",8788,4326,4462,0.492262175694128,8660,4286,4374,0.494919168591224,0.00503725622843349,0.244265558308066,0.750697185463501
6,"Hessen",6440008,"Friedberg (Hessen), Kreisstadt",27400,13530,13870,0.493795620437956,28043,14006,14037,0.499447277395428,0.00503725622843349,0.244265558308066,0.750697185463501
6,"Hessen",6440009,"Gedern, Stadt",7548,3755,3793,0.497482776894542,7474,3682,3792,0.492641156007493,0.00503725622843349,0.244265558308066,0.750697185463501
6,"Hessen",6440010,"Glauburg",3054,1514,1540,0.495743287491814,3084,1529,1555,0.495784695201038,0.00503725622843349,0.244265558308066,0.750697185463501
6,"Hessen",6440011,"Hirzenhain",2875,1438,1437,0.500173913043478,2797,1376,1421,0.491955666785842,0.00503725622843349,0.244265558308066,0.750697185463501
6,"Hessen",6440012,"Karben, Stadt",21255,10558,10697,0.496730181133851,21892,10963,10929,0.500776539375114,0.00503725622843349,0.244265558308066,0.750697185463501
6,"Hessen",6440013,"Kefenrod",2791,1368,1423,0.490146900752419,2809,1407,1402,0.500889996440014,0.00503725622843349,0.244265558308066,0.750697185463501
6,"Hessen",6440014,"Limeshain",5234,2578,2656,0.492548719908292,5369,2635,2734,0.490780406034643,0.00503725622843349,0.244265558308066,0.750697185463501
6,"Hessen",6440015,"Münzenberg, Stadt",5611,2755,2856,0.490999821778649,5518,2723,2795,0.493475897064154,0.00503725622843349,0.244265558308066,0.750697185463501
6,"Hessen",6440016,"Nidda, Stadt",16848,8301,8547,0.49269943019943,17547,8709,8838,0.496324157975722,0.00503725622843349,0.244265558308066,0.750697185463501
6,"Hessen",6440017,"Niddatal, Stadt",9283,4580,4703,0.493374986534525,9196,4530,4666,0.492605480643758,0.00503725622843349,0.244265558308066,0.750697185463501
6,"Hessen",6440018,"Ober-Mörlen",5745,2841,2904,0.494516971279373,5790,2863,2927,0.49447322970639,0.00503725622843349,0.244265558308066,0.750697185463501
6,"Hessen",6440019,"Ortenberg, Stadt",8898,4351,4547,0.48898628905372,8902,4380,4522,0.49202426421029,0.00503725622843349,0.244265558308066,0.750697185463501
6,"Hessen",6440020,"Ranstadt",4933,2478,2455,0.502331238597203,4916,2485,2431,0.505492270138324,0.00503725622843349,0.244265558308066,0.750697185463501
6,"Hessen",6440021,"Reichelsheim (Wetterau), Stadt",6685,3293,3392,0.492595362752431,6741,3357,3384,0.497997329773031,0.00503725622843349,0.244265558308066,0.750697185463501
6,"Hessen",6440022,"Rockenberg",4242,2108,2134,0.496935407826497,4080,1966,2114,0.481862745098039,0.00503725622843349,0.244265558308066,0.750697185463501
6,"Hessen",6440023,"Rosbach v. d. Höhe, Stadt",11903,5919,5984,0.497269595900193,12357,6273,6084,0.507647487254188,0.00503725622843349,0.244265558308066,0.750697185463501
6,"Hessen",6440024,"Wölfersheim",9658,4781,4877,0.495030026920688,9759,4848,4911,0.496772210267445,0.00503725622843349,0.244265558308066,0.750697185463501
6,"Hessen",6440025,"Wöllstadt",6120,3025,3095,0.494281045751634,6142,3069,3073,0.499674373168349,0.00503725622843349,0.244265558308066,0.750697185463501
6,"Hessen",6531001,"Allendorf (Lumda), Stadt",4161,2111,2050,0.50732996875751,4051,2046,2005,0.5050604788941,0.00503725622843349,0.244265558308066,0.750697185463501
6,"Hessen",6531002,"Biebertal",10040,4900,5140,0.48804780876494,10000,4897,5103,0.4897,0.00503725622843349,0.244265558308066,0.750697185463501
6,"Hessen",6531003,"Buseck",12777,6276,6501,0.491195116224466,12832,6301,6531,0.491038029925187,0.00503725622843349,0.244265558308066,0.750697185463501
6,"Hessen",6531004,"Fernwald",6430,3151,3279,0.4900466562986,6615,3250,3365,0.491307634164777,0.00503725622843349,0.244265558308066,0.750697185463501
6,"Hessen",6531005,"Gießen, Universitätsstadt",76059,36667,39392,0.482086275128519,78584,37649,40935,0.479092436119312,0.00503725622843349,0.244265558308066,0.750697185463501
6,"Hessen",6531006,"Grünberg, Stadt",13728,6742,6986,0.491113053613054,13828,6772,7056,0.489730980619034,0.00503725622843349,0.244265558308066,0.750697185463501
6,"Hessen",6531007,"Heuchelheim",7331,3570,3761,0.486973127813395,7580,3719,3861,0.490633245382586,0.00503725622843349,0.244265558308066,0.750697185463501
6,"Hessen",6531008,"Hungen, Stadt",12535,6127,6408,0.488791384124452,12544,6244,6300,0.497767857142857,0.00503725622843349,0.244265558308066,0.750697185463501
6,"Hessen",6531009,"Langgöns",11607,5676,5931,0.489015249418454,11756,5800,5956,0.493365090166723,0.00503725622843349,0.244265558308066,0.750697185463501
6,"Hessen",6531010,"Laubach, Stadt",9680,4737,4943,0.489359504132231,9818,4820,4998,0.490935017315135,0.00503725622843349,0.244265558308066,0.750697185463501
6,"Hessen",6531011,"Lich, Stadt",13083,6402,6681,0.489337307956891,13280,6520,6760,0.490963855421687,0.00503725622843349,0.244265558308066,0.750697185463501
6,"Hessen",6531012,"Linden, Stadt",12102,5918,6184,0.489010080978351,12288,6024,6264,0.490234375,0.00503725622843349,0.244265558308066,0.750697185463501
6,"Hessen",6531013,"Lollar, Stadt",9868,4870,4998,0.493514389947304,9884,4915,4969,0.49726831242412,0.00503725622843349,0.244265558308066,0.750697185463501
6,"Hessen",6531014,"Pohlheim, Stadt",17452,8440,9012,0.483612193444877,18223,8798,9425,0.4827964660045,0.00503725622843349,0.244265558308066,0.750697185463501
6,"Hessen",6531015,"Rabenau",5152,2553,2599,0.495535714285714,5135,2564,2571,0.499318403115871,0.00503725622843349,0.244265558308066,0.750697185463501
6,"Hessen",6531016,"Reiskirchen",10261,5064,5197,0.493519150180294,10502,5238,5264,0.498762140544658,0.00503725622843349,0.244265558308066,0.750697185463501
6,"Hessen",6531017,"Staufenberg, Stadt",8099,3957,4142,0.488578836893444,8044,3953,4091,0.491422178020885,0.00503725622843349,0.244265558308066,0.750697185463501
6,"Hessen",6531018,"Wettenberg",12222,5920,6302,0.48437244313533,12423,6096,6327,0.490702728809466,0.00503725622843349,0.244265558308066,0.750697185463501
6,"Hessen",6532001,"Aßlar, Stadt",13561,6625,6936,0.488533294004867,13611,6610,7001,0.485636617441775,0.00503725622843349,0.244265558308066,0.750697185463501
6,"Hessen",6532002,"Bischoffen",3406,1672,1734,0.490898414562537,3443,1707,1736,0.495788556491432,0.00503725622843349,0.244265558308066,0.750697185463501
6,"Hessen",6532003,"Braunfels, Stadt",10697,5113,5584,0.477984481630364,10836,5198,5638,0.479697305278701,0.00503725622843349,0.244265558308066,0.750697185463501
6,"Hessen",6532004,"Breitscheid",4917,2448,2469,0.497864551555827,4891,2433,2458,0.497444285422204,0.00503725622843349,0.244265558308066,0.750697185463501
6,"Hessen",6532005,"Dietzhölztal",5959,2972,2987,0.498741399563685,5887,2944,2943,0.500084932903007,0.00503725622843349,0.244265558308066,0.750697185463501
6,"Hessen",6532006,"Dillenburg, Stadt",23790,11631,12159,0.48890290037831,23525,11521,12004,0.489734325185972,0.00503725622843349,0.244265558308066,0.750697185463501
6,"Hessen",6532007,"Driedorf",5104,2542,2562,0.498040752351097,5046,2511,2535,0.497621878715814,0.00503725622843349,0.244265558308066,0.750697185463501
6,"Hessen",6532008,"Ehringshausen",9225,4503,4722,0.488130081300813,9144,4488,4656,0.490813648293963,0.00503725622843349,0.244265558308066,0.750697185463501
6,"Hessen",6532009,"Eschenburg",10223,5220,5003,0.510613322899345,10268,5254,5014,0.511686793922867,0.00503725622843349,0.244265558308066,0.750697185463501
6,"Hessen",6532010,"Greifenstein",6835,3344,3491,0.489246525237747,6950,3441,3509,0.495107913669065,0.00503725622843349,0.244265558308066,0.750697185463501
6,"Hessen",6532011,"Haiger, Stadt",19597,9680,9917,0.493953156095321,18993,9420,9573,0.495972200284315,0.00503725622843349,0.244265558308066,0.750697185463501
6,"Hessen",6532012,"Herborn, Stadt",20577,9982,10595,0.485104728580454,20486,9975,10511,0.486917895147906,0.00503725622843349,0.244265558308066,0.750697185463501
6,"Hessen",6532013,"Hohenahr",4864,2453,2411,0.504317434210526,4824,2441,2383,0.506011608623549,0.00503725622843349,0.244265558308066,0.750697185463501
6,"Hessen",6532014,"Hüttenberg",10544,5078,5466,0.48160091047041,10637,5164,5473,0.485475227977813,0.00503725622843349,0.244265558308066,0.750697185463501
6,"Hessen",6532015,"Lahnau",8076,3996,4080,0.49479940564636,8083,3989,4094,0.493504886799456,0.00503725622843349,0.244265558308066,0.750697185463501
6,"Hessen",6532016,"Leun, Stadt",5781,2845,2936,0.492129389379,5770,2841,2929,0.492374350086655,0.00503725622843349,0.244265558308066,0.750697185463501
6,"Hessen",6532017,"Mittenaar",4886,2417,2469,0.494678673761768,4876,2425,2451,0.497333880229696,0.00503725622843349,0.244265558308066,0.750697185463501
6,"Hessen",6532018,"Schöffengrund",6380,3143,3237,0.492633228840125,6236,3105,3131,0.497915330339961,0.00503725622843349,0.244265558308066,0.750697185463501
6,"Hessen",6532019,"Siegbach",2765,1372,1393,0.49620253164557,2734,1366,1368,0.499634235552304,0.00503725622843349,0.244265558308066,0.750697185463501
6,"Hessen",6532020,"Sinn",6519,3196,3323,0.490259242215064,6479,3182,3297,0.491125173637907,0.00503725622843349,0.244265558308066,0.750697185463501
6,"Hessen",6532021,"Solms, Stadt",13410,6592,6818,0.491573452647278,13337,6511,6826,0.488190747544425,0.00503725622843349,0.244265558308066,0.750697185463501
6,"Hessen",6532022,"Waldsolms",4814,2428,2386,0.504362276692979,4900,2517,2383,0.513673469387755,0.00503725622843349,0.244265558308066,0.750697185463501
6,"Hessen",6532023,"Wetzlar, Stadt",50969,24305,26664,0.476858482607075,51521,24811,26710,0.481570621688244,0.00503725622843349,0.244265558308066,0.750697185463501
6,"Hessen",6533001,"Beselich",5613,2766,2847,0.492784607161945,5663,2775,2888,0.490022956030373,0.00503725622843349,0.244265558308066,0.750697185463501
6,"Hessen",6533002,"Brechen",6643,3245,3398,0.488484118621105,6589,3260,3329,0.494764000607072,0.00503725622843349,0.244265558308066,0.750697185463501
6,"Hessen",6533003,"Bad Camberg, Stadt",13901,6845,7056,0.492410617941155,14053,6959,7094,0.495196755141251,0.00503725622843349,0.244265558308066,0.750697185463501
6,"Hessen",6533004,"Dornburg",8502,4250,4252,0.499882380616326,8375,4194,4181,0.500776119402985,0.00503725622843349,0.244265558308066,0.750697185463501
6,"Hessen",6533005,"Elbtal",2336,1165,1171,0.498715753424658,2378,1185,1193,0.498317914213625,0.00503725622843349,0.244265558308066,0.750697185463501
6,"Hessen",6533006,"Elz",8104,3886,4218,0.479516288252715,8003,3865,4138,0.482943896038985,0.00503725622843349,0.244265558308066,0.750697185463501
6,"Hessen",6533007,"Hadamar, Stadt",12074,5893,6181,0.488073546463475,12281,6043,6238,0.492060907092256,0.00503725622843349,0.244265558308066,0.750697185463501
6,"Hessen",6533008,"Hünfelden",9715,4766,4949,0.4905815748842,9758,4835,4923,0.495490879278541,0.00503725622843349,0.244265558308066,0.750697185463501
6,"Hessen",6533009,"Limburg a.d. Lahn, Kreisstadt",33624,16475,17149,0.489977397097311,33544,16206,17338,0.483126639637491,0.00503725622843349,0.244265558308066,0.750697185463501
6,"Hessen",6533010,"Löhnberg",4284,2084,2200,0.486461251167134,4214,2058,2156,0.488372093023256,0.00503725622843349,0.244265558308066,0.750697185463501
6,"Hessen",6533011,"Mengerskirchen, Marktflecken",5714,2833,2881,0.495799789989499,5700,2839,2861,0.498070175438596,0.00503725622843349,0.244265558308066,0.750697185463501
6,"Hessen",6533012,"Merenberg, Marktflecken",3327,1653,1674,0.496844003606853,3325,1656,1669,0.498045112781955,0.00503725622843349,0.244265558308066,0.750697185463501
6,"Hessen",6533013,"Runkel, Stadt",9656,4813,4843,0.498446561723281,9473,4669,4804,0.4928744853795,0.00503725622843349,0.244265558308066,0.750697185463501
6,"Hessen",6533014,"Selters (Taunus)",8091,4072,4019,0.503275244098381,7993,4044,3949,0.50594269986238,0.00503725622843349,0.244265558308066,0.750697185463501
6,"Hessen",6533015,"Villmar, Marktflecken",6914,3415,3499,0.493925368816893,6882,3389,3493,0.492444056960186,0.00503725622843349,0.244265558308066,0.750697185463501
6,"Hessen",6533016,"Waldbrunn (Westerwald)",5775,2904,2871,0.502857142857143,5677,2868,2809,0.505196406552757,0.00503725622843349,0.244265558308066,0.750697185463501
6,"Hessen",6533017,"Weilburg, Stadt",12681,6251,6430,0.492942196987619,13051,6516,6535,0.499272086430159,0.00503725622843349,0.244265558308066,0.750697185463501
6,"Hessen",6533018,"Weilmünster, Marktflecken",9008,4401,4607,0.488565719360568,8920,4377,4543,0.490695067264574,0.00503725622843349,0.244265558308066,0.750697185463501
6,"Hessen",6533019,"Weinbach",4509,2196,2313,0.487025948103792,4478,2181,2297,0.487047789191603,0.00503725622843349,0.244265558308066,0.750697185463501
6,"Hessen",6534001,"Amöneburg, Stadt",5110,2536,2574,0.496281800391389,5132,2593,2539,0.505261106780982,0.00503725622843349,0.244265558308066,0.750697185463501
6,"Hessen",6534002,"Angelburg",3483,1775,1708,0.50961814527706,3559,1865,1694,0.524023602135431,0.00503725622843349,0.244265558308066,0.750697185463501
6,"Hessen",6534003,"Bad Endbach",8213,4062,4151,0.494581760623402,8238,4076,4162,0.4947802864773,0.00503725622843349,0.244265558308066,0.750697185463501
6,"Hessen",6534004,"Biedenkopf, Stadt",13666,6708,6958,0.490853212351822,13187,6468,6719,0.490483051490104,0.00503725622843349,0.244265558308066,0.750697185463501
6,"Hessen",6534005,"Breidenbach",6947,3541,3406,0.509716424355837,6804,3459,3345,0.508377425044092,0.00503725622843349,0.244265558308066,0.750697185463501
6,"Hessen",6534006,"Cölbe",6701,3315,3386,0.494702283241307,6944,3528,3416,0.508064516129032,0.00503725622843349,0.244265558308066,0.750697185463501
6,"Hessen",6534007,"Dautphetal",11658,5736,5922,0.492022645393721,11669,5746,5923,0.492415802553775,0.00503725622843349,0.244265558308066,0.750697185463501
6,"Hessen",6534008,"Ebsdorfergrund",8945,4414,4531,0.49346003353829,8917,4396,4521,0.492990916227431,0.00503725622843349,0.244265558308066,0.750697185463501
6,"Hessen",6534009,"Fronhausen",4069,1976,2093,0.485623003194888,3983,1930,2053,0.484559377353753,0.00503725622843349,0.244265558308066,0.750697185463501
6,"Hessen",6534010,"Gladenbach, Stadt",12228,5990,6238,0.489859339221459,12123,5925,6198,0.488740410789409,0.00503725622843349,0.244265558308066,0.750697185463501
6,"Hessen",6534011,"Kirchhain, Stadt",16198,7973,8225,0.492221261884183,16145,7934,8211,0.491421492722205,0.00503725622843349,0.244265558308066,0.750697185463501
6,"Hessen",6534012,"Lahntal",6868,3407,3461,0.496068724519511,7018,3477,3541,0.495440296380735,0.00503725622843349,0.244265558308066,0.750697185463501
6,"Hessen",6534013,"Lohra",5591,2797,2794,0.500268288320515,5568,2804,2764,0.503591954022989,0.00503725622843349,0.244265558308066,0.750697185463501
6,"Hessen",6534014,"Marburg, Universitätsstadt",72190,33961,38229,0.47043911899155,81147,38815,42332,0.478329451489273,0.00503725622843349,0.244265558308066,0.750697185463501
6,"Hessen",6534015,"Münchhausen",3465,1733,1732,0.5001443001443,3451,1743,1708,0.505070993914807,0.00503725622843349,0.244265558308066,0.750697185463501
6,"Hessen",6534016,"Neustadt (Hessen), Stadt",8546,4241,4305,0.496255558155862,8737,4438,4299,0.507954675517912,0.00503725622843349,0.244265558308066,0.750697185463501
6,"Hessen",6534017,"Rauschenberg, Stadt",4448,2176,2272,0.489208633093525,4438,2179,2259,0.490986931050023,0.00503725622843349,0.244265558308066,0.750697185463501
6,"Hessen",6534018,"Stadtallendorf, Stadt",20749,10198,10551,0.491493565954986,21212,10571,10641,0.498349990571375,0.00503725622843349,0.244265558308066,0.750697185463501
6,"Hessen",6534019,"Steffenberg",4086,2043,2043,0.5,4140,2076,2064,0.501449275362319,0.00503725622843349,0.244265558308066,0.750697185463501
6,"Hessen",6534020,"Weimar (Lahn)",6967,3424,3543,0.49145973876848,6899,3377,3522,0.489491230613132,0.00503725622843349,0.244265558308066,0.750697185463501
6,"Hessen",6534021,"Wetter (Hessen), Stadt",8990,4473,4517,0.497552836484983,9058,4521,4537,0.499116802826231,0.00503725622843349,0.244265558308066,0.750697185463501
6,"Hessen",6534022,"Wohratal",2456,1235,1221,0.502850162866449,2492,1249,1243,0.501203852327448,0.00503725622843349,0.244265558308066,0.750697185463501
6,"Hessen",6535001,"Alsfeld, Stadt",16299,7923,8376,0.486103441928953,16222,8009,8213,0.493712242633461,0.00503725622843349,0.244265558308066,0.750697185463501
6,"Hessen",6535002,"Antrifttal",2015,1023,992,0.507692307692308,1983,1007,976,0.507816439737771,0.00503725622843349,0.244265558308066,0.750697185463501
6,"Hessen",6535003,"Feldatal",2606,1310,1296,0.502686108979279,2572,1285,1287,0.499611197511664,0.00503725622843349,0.244265558308066,0.750697185463501
6,"Hessen",6535004,"Freiensteinau",3233,1607,1626,0.497061552737396,3303,1643,1660,0.497426581895247,0.00503725622843349,0.244265558308066,0.750697185463501
6,"Hessen",6535005,"Gemünden (Felda)",2869,1415,1454,0.493203206692227,2852,1399,1453,0.490532959326788,0.00503725622843349,0.244265558308066,0.750697185463501
6,"Hessen",6535006,"Grebenau, Stadt",2528,1282,1246,0.507120253164557,2520,1293,1227,0.513095238095238,0.00503725622843349,0.244265558308066,0.750697185463501
6,"Hessen",6535007,"Grebenhain",4792,2387,2405,0.498121869782972,4831,2423,2408,0.501552473607949,0.00503725622843349,0.244265558308066,0.750697185463501
6,"Hessen",6535008,"Herbstein, Stadt",4820,2410,2410,0.5,4817,2444,2373,0.507369732198464,0.00503725622843349,0.244265558308066,0.750697185463501
6,"Hessen",6535009,"Homberg (Ohm), Stadt",7664,3844,3820,0.501565762004175,7619,3839,3780,0.50387189919937,0.00503725622843349,0.244265558308066,0.750697185463501
6,"Hessen",6535010,"Kirtorf, Stadt",3375,1708,1667,0.506074074074074,3255,1643,1612,0.504761904761905,0.00503725622843349,0.244265558308066,0.750697185463501
6,"Hessen",6535011,"Lauterbach (Hessen), Kreisstadt",13235,6336,6899,0.478730638458632,13708,6605,7103,0.481835424569594,0.00503725622843349,0.244265558308066,0.750697185463501
6,"Hessen",6535012,"Lautertal (Vogelsberg)",2452,1258,1194,0.51305057096248,2424,1255,1169,0.517739273927393,0.00503725622843349,0.244265558308066,0.750697185463501
6,"Hessen",6535013,"Mücke",9406,4647,4759,0.494046353391452,9362,4640,4722,0.495620593890194,0.00503725622843349,0.244265558308066,0.750697185463501
6,"Hessen",6535014,"Romrod, Stadt",2867,1413,1454,0.492849668643181,2839,1423,1416,0.501232828460726,0.00503725622843349,0.244265558308066,0.750697185463501
6,"Hessen",6535015,"Schlitz, Stadt",9619,4690,4929,0.487576671171639,9701,4788,4913,0.49355736522008,0.00503725622843349,0.244265558308066,0.750697185463501
6,"Hessen",6535016,"Schotten, Stadt",10259,5176,5083,0.504532605517107,10693,5370,5323,0.502197699429533,0.00503725622843349,0.244265558308066,0.750697185463501
6,"Hessen",6535017,"Schwalmtal",2919,1459,1460,0.499828708461802,2874,1452,1422,0.505219206680585,0.00503725622843349,0.244265558308066,0.750697185463501
6,"Hessen",6535018,"Ulrichstein, Stadt",3059,1535,1524,0.501797973193854,3021,1524,1497,0.504468718967229,0.00503725622843349,0.244265558308066,0.750697185463501
6,"Hessen",6535019,"Wartenberg",3977,1989,1988,0.500125722906714,3942,1955,1987,0.495941146626078,0.00503725622843349,0.244265558308066,0.750697185463501
6,"Hessen",6611000,"Kassel, documenta-Stadt",191854,92023,99831,0.479651193094749,196526,94790,101736,0.482328038020415,0.00503725622843349,0.244265558308066,0.750697185463501
6,"Hessen",6631001,"Bad Salzschlirf",2914,1309,1605,0.449210706932052,2983,1414,1569,0.474019443513242,0.00503725622843349,0.244265558308066,0.750697185463501
6,"Hessen",6631002,"Burghaun",6513,3248,3265,0.498694917856594,6397,3210,3187,0.501797717680163,0.00503725622843349,0.244265558308066,0.750697185463501
6,"Hessen",6631003,"Dipperz",3304,1649,1655,0.49909200968523,3314,1666,1648,0.502715751357876,0.00503725622843349,0.244265558308066,0.750697185463501
6,"Hessen",6631004,"Ebersburg",4511,2240,2271,0.496563954777211,4487,2217,2270,0.494094049476265,0.00503725622843349,0.244265558308066,0.750697185463501
6,"Hessen",6631005,"Ehrenberg (Rhön)",2585,1283,1302,0.496324951644101,2606,1292,1314,0.495778971603991,0.00503725622843349,0.244265558308066,0.750697185463501
6,"Hessen",6631006,"Eichenzell",11061,5470,5591,0.494530331796402,11207,5526,5681,0.493084679218346,0.00503725622843349,0.244265558308066,0.750697185463501
6,"Hessen",6631007,"Eiterfeld",7251,3587,3664,0.494690387532754,7338,3633,3705,0.495094031071137,0.00503725622843349,0.244265558308066,0.750697185463501
6,"Hessen",6631008,"Flieden",8722,4355,4367,0.499312084384316,8615,4303,4312,0.499477655252467,0.00503725622843349,0.244265558308066,0.750697185463501
6,"Hessen",6631009,"Fulda, Stadt",64367,31098,33269,0.483135768328491,64249,30984,33265,0.482248750953322,0.00503725622843349,0.244265558308066,0.750697185463501
6,"Hessen",6631010,"Gersfeld (Rhön), Stadt",5528,2741,2787,0.495839363241679,5896,2931,2965,0.497116689280868,0.00503725622843349,0.244265558308066,0.750697185463501
6,"Hessen",6631011,"Großenlüder",8483,4187,4296,0.49357538606625,8482,4170,4312,0.491629332704551,0.00503725622843349,0.244265558308066,0.750697185463501
6,"Hessen",6631012,"Hilders",4661,2306,2355,0.494743617249517,4702,2381,2321,0.506380263717567,0.00503725622843349,0.244265558308066,0.750697185463501
6,"Hessen",6631013,"Hofbieber",6025,3034,2991,0.50356846473029,6165,3125,3040,0.506893755068938,0.00503725622843349,0.244265558308066,0.750697185463501
6,"Hessen",6631014,"Hosenfeld",4710,2402,2308,0.509978768577495,4589,2332,2257,0.508171714970582,0.00503725622843349,0.244265558308066,0.750697185463501
6,"Hessen",6631015,"Hünfeld, Konrad-Zuse-Stadt",15751,7719,8032,0.490064122912831,15880,7807,8073,0.491624685138539,0.00503725622843349,0.244265558308066,0.750697185463501
6,"Hessen",6631016,"Kalbach",6300,3142,3158,0.498730158730159,6296,3168,3128,0.503176620076239,0.00503725622843349,0.244265558308066,0.750697185463501
6,"Hessen",6631017,"Künzell",16070,7620,8450,0.47417548226509,16391,7839,8552,0.478250259288634,0.00503725622843349,0.244265558308066,0.750697185463501
6,"Hessen",6631018,"Neuhof",10717,5303,5414,0.49482131193431,10789,5403,5386,0.500787839466123,0.00503725622843349,0.244265558308066,0.750697185463501
6,"Hessen",6631019,"Nüsttal",2878,1501,1377,0.521542738012509,2858,1494,1364,0.522743177046886,0.00503725622843349,0.244265558308066,0.750697185463501
6,"Hessen",6631020,"Petersberg",14915,7270,7645,0.487428762990278,14744,7133,7611,0.483790016277808,0.00503725622843349,0.244265558308066,0.750697185463501
6,"Hessen",6631021,"Poppenhausen (Wasserkuppe)",2542,1285,1257,0.505507474429583,2559,1304,1255,0.509574052364205,0.00503725622843349,0.244265558308066,0.750697185463501
6,"Hessen",6631022,"Rasdorf",1647,818,829,0.496660595021251,1767,922,845,0.521788341822298,0.00503725622843349,0.244265558308066,0.750697185463501
6,"Hessen",6631023,"Tann (Rhön), Stadt",4490,2244,2246,0.499777282850779,4403,2204,2199,0.500567794685442,0.00503725622843349,0.244265558308066,0.750697185463501
6,"Hessen",6632001,"Alheim",5087,2561,2526,0.503440141537252,5054,2561,2493,0.506727344677483,0.00503725622843349,0.244265558308066,0.750697185463501
6,"Hessen",6632002,"Bad Hersfeld, Kreisstadt",28597,13656,14941,0.477532608315558,30164,14543,15621,0.482131017106485,0.00503725622843349,0.244265558308066,0.750697185463501
6,"Hessen",6632003,"Bebra, Stadt",13711,6647,7064,0.484793231711764,13598,6694,6904,0.492278276217091,0.00503725622843349,0.244265558308066,0.750697185463501
6,"Hessen",6632004,"Breitenbach a. Herzberg",1789,948,841,0.529904974846283,1788,955,833,0.534116331096197,0.00503725622843349,0.244265558308066,0.750697185463501
6,"Hessen",6632005,"Cornberg",1451,756,695,0.521019986216402,1495,773,722,0.517056856187291,0.00503725622843349,0.244265558308066,0.750697185463501
6,"Hessen",6632006,"Friedewald",2428,1247,1181,0.513591433278418,2432,1252,1180,0.514802631578947,0.00503725622843349,0.244265558308066,0.750697185463501
6,"Hessen",6632007,"Hauneck",3171,1600,1571,0.504572690003154,3215,1620,1595,0.503888024883359,0.00503725622843349,0.244265558308066,0.750697185463501
6,"Hessen",6632008,"Haunetal",3055,1578,1477,0.516530278232406,3035,1576,1459,0.519275123558484,0.00503725622843349,0.244265558308066,0.750697185463501
6,"Hessen",6632009,"Heringen (Werra), Stadt",7527,3723,3804,0.494619370267039,7392,3720,3672,0.503246753246753,0.00503725622843349,0.244265558308066,0.750697185463501
6,"Hessen",6632010,"Hohenroda",3183,1605,1578,0.504241281809614,3227,1631,1596,0.505422993492408,0.00503725622843349,0.244265558308066,0.750697185463501
6,"Hessen",6632011,"Kirchheim",3870,2011,1859,0.519638242894057,3854,2020,1834,0.524130773222626,0.00503725622843349,0.244265558308066,0.750697185463501
6,"Hessen",6632012,"Ludwigsau",5704,2791,2913,0.489305750350631,5656,2766,2890,0.489038189533239,0.00503725622843349,0.244265558308066,0.750697185463501
6,"Hessen",6632013,"Nentershausen",2910,1468,1442,0.50446735395189,2956,1535,1421,0.519282814614344,0.00503725622843349,0.244265558308066,0.750697185463501
6,"Hessen",6632014,"Neuenstein",3025,1537,1488,0.508099173553719,3055,1573,1482,0.514893617021277,0.00503725622843349,0.244265558308066,0.750697185463501
6,"Hessen",6632015,"Niederaula",5481,2686,2795,0.490056559022076,5416,2637,2779,0.486890694239291,0.00503725622843349,0.244265558308066,0.750697185463501
6,"Hessen",6632016,"Philippsthal (Werra)",4261,2136,2125,0.501290776812955,4193,2120,2073,0.505604579060339,0.00503725622843349,0.244265558308066,0.750697185463501
6,"Hessen",6632017,"Ronshausen",2442,1219,1223,0.499180999180999,2377,1191,1186,0.501051745898191,0.00503725622843349,0.244265558308066,0.750697185463501
6,"Hessen",6632018,"Rotenburg a. d. Fulda, Stadt",13466,6564,6902,0.487449873756127,13666,6660,7006,0.487340845894922,0.00503725622843349,0.244265558308066,0.750697185463501
6,"Hessen",6632019,"Schenklengsfeld",4580,2304,2276,0.503056768558952,4568,2284,2284,0.5,0.00503725622843349,0.244265558308066,0.750697185463501
6,"Hessen",6632020,"Wildeck",5038,2446,2592,0.485510123064708,4940,2394,2546,0.484615384615385,0.00503725622843349,0.244265558308066,0.750697185463501
6,"Hessen",6633001,"Ahnatal",8028,3929,4099,0.489412057797708,7931,3877,4054,0.488841255831547,0.00503725622843349,0.244265558308066,0.750697185463501
6,"Hessen",6633002,"Bad Karlshafen, Stadt",3598,1751,1847,0.486659255141745,3778,1876,1902,0.496559025939651,0.00503725622843349,0.244265558308066,0.750697185463501
6,"Hessen",6633003,"Baunatal, Stadt",27443,13311,14132,0.485041722843712,27723,13507,14216,0.487212783609277,0.00503725622843349,0.244265558308066,0.750697185463501
6,"Hessen",6633004,"Breuna",3690,1831,1859,0.496205962059621,3602,1784,1818,0.495280399777901,0.00503725622843349,0.244265558308066,0.750697185463501
6,"Hessen",6633005,"Calden",7474,3704,3770,0.495584693604496,7340,3666,3674,0.499455040871935,0.00503725622843349,0.244265558308066,0.750697185463501
6,"Hessen",6633006,"Bad Emstal",6015,2961,3054,0.492269326683292,6160,3057,3103,0.496266233766234,0.00503725622843349,0.244265558308066,0.750697185463501
6,"Hessen",6633007,"Espenau",4885,2380,2505,0.487205731832139,4867,2359,2508,0.48469282925827,0.00503725622843349,0.244265558308066,0.750697185463501
6,"Hessen",6633008,"Fuldabrück",8736,4242,4494,0.485576923076923,8682,4250,4432,0.489518544114259,0.00503725622843349,0.244265558308066,0.750697185463501
6,"Hessen",6633009,"Fuldatal",11854,5882,5972,0.496203813058883,11853,5883,5970,0.496330043027082,0.00503725622843349,0.244265558308066,0.750697185463501
6,"Hessen",6633010,"Grebenstein, Stadt",5892,2919,2973,0.495417515274949,5907,2940,2967,0.497714575926866,0.00503725622843349,0.244265558308066,0.750697185463501
6,"Hessen",6633011,"Habichtswald",5116,2511,2605,0.490813135261923,5103,2518,2585,0.493435234175975,0.00503725622843349,0.244265558308066,0.750697185463501
6,"Hessen",6633012,"Helsa",5622,2666,2956,0.474208466737816,5507,2622,2885,0.476121300163428,0.00503725622843349,0.244265558308066,0.750697185463501
6,"Hessen",6633013,"Hofgeismar, Stadt",15074,7196,7878,0.477378267215072,15554,7450,8104,0.478976469075479,0.00503725622843349,0.244265558308066,0.750697185463501
6,"Hessen",6633014,"Immenhausen, Stadt",6954,3421,3533,0.491947080816796,6956,3425,3531,0.492380678550891,0.00503725622843349,0.244265558308066,0.750697185463501
6,"Hessen",6633015,"Kaufungen",12514,5952,6562,0.475627297426882,12534,6032,6502,0.481250997287378,0.00503725622843349,0.244265558308066,0.750697185463501
6,"Hessen",6633016,"Liebenau, Stadt",3264,1598,1666,0.489583333333333,3247,1558,1689,0.479827533107484,0.00503725622843349,0.244265558308066,0.750697185463501
6,"Hessen",6633017,"Lohfelden",13609,6545,7064,0.480931736350944,13907,6727,7180,0.483713237937729,0.00503725622843349,0.244265558308066,0.750697185463501
6,"Hessen",6633018,"Naumburg, Stadt",5280,2605,2675,0.493371212121212,5217,2547,2670,0.48821161587119,0.00503725622843349,0.244265558308066,0.750697185463501
6,"Hessen",6633019,"Nieste",1834,912,922,0.497273718647764,1784,881,903,0.493834080717489,0.00503725622843349,0.244265558308066,0.750697185463501
6,"Hessen",6633020,"Niestetal",10382,4980,5402,0.479676362935851,10533,5044,5489,0.47887591379474,0.00503725622843349,0.244265558308066,0.750697185463501
6,"Hessen",6633021,"Oberweser",3296,1649,1647,0.500303398058252,3292,1626,1666,0.493924665856622,0.00503725622843349,0.244265558308066,0.750697185463501
6,"Hessen",6633022,"Reinhardshagen",4607,2262,2345,0.490991968743217,4795,2371,2424,0.494473409801877,0.00503725622843349,0.244265558308066,0.750697185463501
6,"Hessen",6633023,"Schauenburg",10006,4929,5077,0.492604437337597,10245,5090,5155,0.496827720839434,0.00503725622843349,0.244265558308066,0.750697185463501
6,"Hessen",6633024,"Söhrewald",4926,2442,2484,0.495736906211937,4944,2461,2483,0.497775080906149,0.00503725622843349,0.244265558308066,0.750697185463501
6,"Hessen",6633025,"Trendelburg, Stadt",5167,2560,2607,0.495451906328624,5112,2525,2587,0.493935837245696,0.00503725622843349,0.244265558308066,0.750697185463501
6,"Hessen",6633026,"Vellmar, Stadt",18022,8470,9552,0.469981134169349,18162,8594,9568,0.473185772492016,0.00503725622843349,0.244265558308066,0.750697185463501
6,"Hessen",6633027,"Wahlsburg",2127,1025,1102,0.481899388810531,2270,1089,1181,0.479735682819383,0.00503725622843349,0.244265558308066,0.750697185463501
6,"Hessen",6633028,"Wolfhagen, Stadt",12692,6151,6541,0.484635991175544,12802,6255,6547,0.488595531948133,0.00503725622843349,0.244265558308066,0.750697185463501
6,"Hessen",6633029,"Zierenberg, Stadt",6573,3196,3377,0.486231553324205,6580,3217,3363,0.488905775075988,0.00503725622843349,0.244265558308066,0.750697185463501
6,"Hessen",6634001,"Borken (Hessen), Stadt",12784,6313,6471,0.493820400500626,12721,6278,6443,0.493514660797107,0.00503725622843349,0.244265558308066,0.750697185463501
6,"Hessen",6634002,"Edermünde",7281,3635,3646,0.49924460925697,7256,3633,3623,0.500689084895259,0.00503725622843349,0.244265558308066,0.750697185463501
6,"Hessen",6634003,"Felsberg, Stadt",10743,5246,5497,0.48831797449502,10533,5126,5407,0.48666097028387,0.00503725622843349,0.244265558308066,0.750697185463501
6,"Hessen",6634004,"Frielendorf",7746,3911,3835,0.504905757810483,7707,3891,3816,0.504865706500584,0.00503725622843349,0.244265558308066,0.750697185463501
6,"Hessen",6634005,"Fritzlar, Dom- und Kaiserstadt",14416,7079,7337,0.491051609322974,14296,7016,7280,0.49076664801343,0.00503725622843349,0.244265558308066,0.750697185463501
6,"Hessen",6634006,"Gilserberg",3116,1548,1568,0.496790757381258,3251,1650,1601,0.507536142725315,0.00503725622843349,0.244265558308066,0.750697185463501
6,"Hessen",6634007,"Gudensberg, Stadt",9225,4553,4672,0.493550135501355,9193,4567,4626,0.496791036658327,0.00503725622843349,0.244265558308066,0.750697185463501
6,"Hessen",6634008,"Guxhagen",5258,2596,2662,0.493723849372385,5230,2561,2669,0.489674952198853,0.00503725622843349,0.244265558308066,0.750697185463501
6,"Hessen",6634009,"Homberg (Efze), Kreisstadt",13915,6752,7163,0.485231764283148,14173,6951,7222,0.490439568193043,0.00503725622843349,0.244265558308066,0.750697185463501
6,"Hessen",6634010,"Jesberg",2448,1231,1217,0.502859477124183,2481,1243,1238,0.501007658202338,0.00503725622843349,0.244265558308066,0.750697185463501
6,"Hessen",6634011,"Knüllwald",4509,2223,2286,0.493013972055888,4565,2250,2315,0.492880613362541,0.00503725622843349,0.244265558308066,0.750697185463501
6,"Hessen",6634012,"Körle",2906,1459,1447,0.502064693737096,2863,1431,1432,0.499825358016067,0.00503725622843349,0.244265558308066,0.750697185463501
6,"Hessen",6634013,"Malsfeld",3925,1949,1976,0.49656050955414,4049,2046,2003,0.505309953074833,0.00503725622843349,0.244265558308066,0.750697185463501
6,"Hessen",6634014,"Melsungen, Stadt",13339,6463,6876,0.484519079391259,13420,6469,6951,0.48204172876304,0.00503725622843349,0.244265558308066,0.750697185463501
6,"Hessen",6634015,"Morschen",3501,1778,1723,0.5078548986004,3590,1847,1743,0.514484679665738,0.00503725622843349,0.244265558308066,0.750697185463501
6,"Hessen",6634016,"Neuental",3211,1607,1604,0.500467144191841,3126,1571,1555,0.50255918106206,0.00503725622843349,0.244265558308066,0.750697185463501
6,"Hessen",6634017,"Neukirchen, Stadt",7190,3605,3585,0.501390820584145,7125,3542,3583,0.497122807017544,0.00503725622843349,0.244265558308066,0.750697185463501
6,"Hessen",6634018,"Niedenstein, Stadt",5245,2640,2605,0.503336510962822,5252,2661,2591,0.506664127951257,0.00503725622843349,0.244265558308066,0.750697185463501
6,"Hessen",6634019,"Oberaula",3220,1607,1613,0.499068322981366,3157,1560,1597,0.494140006335128,0.00503725622843349,0.244265558308066,0.750697185463501
6,"Hessen",6634020,"Ottrau",2304,1146,1158,0.497395833333333,2314,1171,1143,0.506050129645635,0.00503725622843349,0.244265558308066,0.750697185463501
6,"Hessen",6634021,"Schrecksbach",3214,1576,1638,0.490354698195395,3174,1558,1616,0.490863264020164,0.00503725622843349,0.244265558308066,0.750697185463501
6,"Hessen",6634022,"Schwalmstadt, Stadt",18286,9199,9087,0.503062452149185,18467,9177,9290,0.496940488438837,0.00503725622843349,0.244265558308066,0.750697185463501
6,"Hessen",6634023,"Schwarzenborn, Stadt",1093,580,513,0.530649588289113,1061,548,513,0.516493873704053,0.00503725622843349,0.244265558308066,0.750697185463501
6,"Hessen",6634024,"Spangenberg, Liebenbachstadt",6208,3115,3093,0.501771907216495,6197,3122,3075,0.503792157495562,0.00503725622843349,0.244265558308066,0.750697185463501
6,"Hessen",6634025,"Wabern",7282,3643,3639,0.500274649821478,7253,3636,3617,0.501309802840204,0.00503725622843349,0.244265558308066,0.750697185463501
6,"Hessen",6634026,"Willingshausen",5033,2527,2506,0.502086230876217,5079,2559,2520,0.503839338452451,0.00503725622843349,0.244265558308066,0.750697185463501
6,"Hessen",6634027,"Bad Zwesten",3929,1916,2013,0.4876558920845,3990,1921,2069,0.481453634085213,0.00503725622843349,0.244265558308066,0.750697185463501
6,"Hessen",6635001,"Allendorf (Eder)",5614,2786,2828,0.496259351620948,5480,2720,2760,0.496350364963504,0.00503725622843349,0.244265558308066,0.750697185463501
6,"Hessen",6635002,"Bad Arolsen, Stadt",15529,7511,8018,0.483675703522442,16023,7865,8158,0.490856893216002,0.00503725622843349,0.244265558308066,0.750697185463501
6,"Hessen",6635003,"Bad Wildungen, Stadt",16556,7981,8575,0.482060884271563,17332,8166,9166,0.471151627048234,0.00503725622843349,0.244265558308066,0.750697185463501
6,"Hessen",6635004,"Battenberg (Eder), Stadt",5479,2725,2754,0.497353531666362,5389,2715,2674,0.503804045277417,0.00503725622843349,0.244265558308066,0.750697185463501
6,"Hessen",6635005,"Bromskirchen",1825,939,886,0.514520547945206,1849,961,888,0.519740400216333,0.00503725622843349,0.244265558308066,0.750697185463501
6,"Hessen",6635006,"Burgwald",4845,2441,2404,0.503818369453044,4833,2462,2371,0.509414442375336,0.00503725622843349,0.244265558308066,0.750697185463501
6,"Hessen",6635007,"Diemelsee",4918,2472,2446,0.502643350955673,4948,2495,2453,0.504244139046079,0.00503725622843349,0.244265558308066,0.750697185463501
6,"Hessen",6635008,"Diemelstadt, Stadt",5347,2656,2691,0.496727136712175,5317,2673,2644,0.502727101749107,0.00503725622843349,0.244265558308066,0.750697185463501
6,"Hessen",6635009,"Edertal",6477,3207,3270,0.495136637332098,6505,3199,3306,0.491775557263643,0.00503725622843349,0.244265558308066,0.750697185463501
6,"Hessen",6635010,"Frankenau, Stadt",3046,1524,1522,0.500328299409061,3310,1692,1618,0.511178247734139,0.00503725622843349,0.244265558308066,0.750697185463501
6,"Hessen",6635011,"Frankenberg (Eder), Stadt",17955,8784,9171,0.48922305764411,18641,9102,9539,0.488278525830159,0.00503725622843349,0.244265558308066,0.750697185463501
6,"Hessen",6635012,"Gemünden (Wohra), Stadt",3871,1914,1957,0.49444587961767,3873,1924,1949,0.496772527756261,0.00503725622843349,0.244265558308066,0.750697185463501
6,"Hessen",6635013,"Haina (Kloster)",3725,2001,1724,0.537181208053691,3607,1938,1669,0.537288605489326,0.00503725622843349,0.244265558308066,0.750697185463501
6,"Hessen",6635014,"Hatzfeld (Eder), Stadt",3057,1537,1520,0.502780503761858,3164,1627,1537,0.514222503160556,0.00503725622843349,0.244265558308066,0.750697185463501
6,"Hessen",6635015,"Korbach, Kreisstadt",23493,11193,12300,0.476439790575916,23533,11301,12232,0.480219266561849,0.00503725622843349,0.244265558308066,0.750697185463501
6,"Hessen",6635016,"Lichtenfels, Stadt",4177,2101,2076,0.502992578405554,4084,2054,2030,0.502938295788443,0.00503725622843349,0.244265558308066,0.750697185463501
6,"Hessen",6635017,"Rosenthal, Stadt",2154,1096,1058,0.508820798514392,2168,1127,1041,0.519833948339483,0.00503725622843349,0.244265558308066,0.750697185463501
6,"Hessen",6635018,"Twistetal",4499,2299,2200,0.511002444987775,4494,2304,2190,0.512683578104139,0.00503725622843349,0.244265558308066,0.750697185463501
6,"Hessen",6635019,"Vöhl",5870,2880,2990,0.490630323679727,6019,2981,3038,0.495264994185081,0.00503725622843349,0.244265558308066,0.750697185463501
6,"Hessen",6635020,"Volkmarsen, Stadt",6742,3318,3424,0.492138831207357,6756,3320,3436,0.49141503848431,0.00503725622843349,0.244265558308066,0.750697185463501
6,"Hessen",6635021,"Waldeck, Stadt",7002,3492,3510,0.498714652956298,7034,3571,3463,0.507676997441001,0.00503725622843349,0.244265558308066,0.750697185463501
6,"Hessen",6635022,"Willingen (Upland)",6029,2969,3060,0.492453143141483,6212,3034,3178,0.488409529942048,0.00503725622843349,0.244265558308066,0.750697185463501
6,"Hessen",6636001,"Bad Sooden-Allendorf, Stadt",8214,3964,4250,0.482590698806915,8326,3970,4356,0.476819601249099,0.00503725622843349,0.244265558308066,0.750697185463501
6,"Hessen",6636002,"Berkatal",1673,802,871,0.479378362223551,1643,774,869,0.471089470480828,0.00503725622843349,0.244265558308066,0.750697185463501
6,"Hessen",6636003,"Eschwege, Kreisstadt",19421,9176,10245,0.472478245198496,19805,9490,10315,0.479171926281242,0.00503725622843349,0.244265558308066,0.750697185463501
6,"Hessen",6636004,"Großalmerode, Stadt",6731,3289,3442,0.488634675382558,6807,3342,3465,0.490965182899956,0.00503725622843349,0.244265558308066,0.750697185463501
6,"Hessen",6636005,"Herleshausen",2905,1470,1435,0.506024096385542,2929,1492,1437,0.509388869921475,0.00503725622843349,0.244265558308066,0.750697185463501
6,"Hessen",6636006,"Hessisch Lichtenau, Stadt",12149,6028,6121,0.496172524487612,12564,6311,6253,0.502308182107609,0.00503725622843349,0.244265558308066,0.750697185463501
6,"Hessen",6636007,"Meinhard",4784,2349,2435,0.491011705685619,4781,2342,2439,0.489855678728299,0.00503725622843349,0.244265558308066,0.750697185463501
6,"Hessen",6636008,"Meißner",3191,1599,1592,0.50109683484801,3142,1571,1571,0.5,0.00503725622843349,0.244265558308066,0.750697185463501
6,"Hessen",6636009,"Neu-Eichenberg",1839,872,967,0.474170744970092,1812,861,951,0.475165562913907,0.00503725622843349,0.244265558308066,0.750697185463501
6,"Hessen",6636010,"Ringgau",3103,1588,1515,0.511762810183693,3062,1580,1482,0.516002612671457,0.00503725622843349,0.244265558308066,0.750697185463501
6,"Hessen",6636011,"Sontra, Stadt",7780,3863,3917,0.496529562982005,7918,4011,3907,0.50656731497853,0.00503725622843349,0.244265558308066,0.750697185463501
6,"Hessen",6636012,"Waldkappel, Stadt",4654,2310,2344,0.496347228190804,4531,2257,2274,0.498124034429486,0.00503725622843349,0.244265558308066,0.750697185463501
6,"Hessen",6636013,"Wanfried, Stadt",4267,2105,2162,0.49332083430982,4187,2069,2118,0.494148555051349,0.00503725622843349,0.244265558308066,0.750697185463501
6,"Hessen",6636014,"Wehretal",5127,2518,2609,0.491125414472401,5187,2552,2635,0.491999228841334,0.00503725622843349,0.244265558308066,0.750697185463501
6,"Hessen",6636015,"Weißenborn",1092,531,561,0.486263736263736,1092,531,561,0.486263736263736,0.00503725622843349,0.244265558308066,0.750697185463501
6,"Hessen",6636016,"Witzenhausen, Stadt",14913,7226,7687,0.484543686716288,15323,7541,7782,0.492136004698819,0.00503725622843349,0.244265558308066,0.750697185463501
7,"Rheinland-Pfalz",7111000,"Koblenz, Stadt",107954,51394,56560,0.476073142264298,106677,51312,55365,0.481003402795354,0.0160321593522513,0.348991694068006,0.634976146579743
7,"Rheinland-Pfalz",7131001,"Adenau, Stadt",2887,1379,1508,0.477658468998961,2802,1390,1412,0.496074232690935,0.0160321593522513,0.348991694068006,0.634976146579743
7,"Rheinland-Pfalz",7131002,"Ahrbrück",1209,605,604,0.500413564929694,1211,612,599,0.505367464905037,0.0160321593522513,0.348991694068006,0.634976146579743
7,"Rheinland-Pfalz",7131003,"Altenahr",1851,910,941,0.491626148028093,1648,836,812,0.507281553398058,0.0160321593522513,0.348991694068006,0.634976146579743
7,"Rheinland-Pfalz",7131004,"Antweiler",544,273,271,0.501838235294118,546,282,264,0.516483516483517,0.0160321593522513,0.348991694068006,0.634976146579743
7,"Rheinland-Pfalz",7131005,"Aremberg",219,119,100,0.54337899543379,221,127,94,0.574660633484163,0.0160321593522513,0.348991694068006,0.634976146579743
7,"Rheinland-Pfalz",7131006,"Bad Breisig, Stadt",8853,4207,4646,0.475206144809669,8918,4337,4581,0.486319802646333,0.0160321593522513,0.348991694068006,0.634976146579743
7,"Rheinland-Pfalz",7131007,"Bad Neuenahr-Ahrweiler, Stadt",26946,12468,14478,0.46270318414607,27457,12716,14741,0.463124157773974,0.0160321593522513,0.348991694068006,0.634976146579743
7,"Rheinland-Pfalz",7131008,"Barweiler",411,212,199,0.515815085158151,415,201,214,0.48433734939759,0.0160321593522513,0.348991694068006,0.634976146579743
7,"Rheinland-Pfalz",7131009,"Bauler",62,33,29,0.532258064516129,46,29,17,0.630434782608696,0.0160321593522513,0.348991694068006,0.634976146579743
7,"Rheinland-Pfalz",7131011,"Berg",1329,689,640,0.518434913468773,1407,716,691,0.508884150675195,0.0160321593522513,0.348991694068006,0.634976146579743
7,"Rheinland-Pfalz",7131014,"Brohl-Lützing",2405,1208,1197,0.502286902286902,2469,1241,1228,0.502632644795464,0.0160321593522513,0.348991694068006,0.634976146579743
7,"Rheinland-Pfalz",7131015,"Dankerath",79,44,35,0.556962025316456,76,42,34,0.552631578947368,0.0160321593522513,0.348991694068006,0.634976146579743
7,"Rheinland-Pfalz",7131016,"Dedenbach",435,218,217,0.501149425287356,419,213,206,0.508353221957041,0.0160321593522513,0.348991694068006,0.634976146579743
7,"Rheinland-Pfalz",7131017,"Dernau",1770,864,906,0.488135593220339,1808,908,900,0.502212389380531,0.0160321593522513,0.348991694068006,0.634976146579743
7,"Rheinland-Pfalz",7131018,"Dorsel",182,88,94,0.483516483516484,184,94,90,0.510869565217391,0.0160321593522513,0.348991694068006,0.634976146579743
7,"Rheinland-Pfalz",7131021,"Eichenbach",71,37,34,0.52112676056338,59,27,32,0.457627118644068,0.0160321593522513,0.348991694068006,0.634976146579743
7,"Rheinland-Pfalz",7131022,"Fuchshofen",90,46,44,0.511111111111111,81,41,40,0.506172839506173,0.0160321593522513,0.348991694068006,0.634976146579743
7,"Rheinland-Pfalz",7131025,"Gönnersdorf",630,309,321,0.49047619047619,658,332,326,0.504559270516717,0.0160321593522513,0.348991694068006,0.634976146579743
7,"Rheinland-Pfalz",7131026,"Harscheid",126,66,60,0.523809523809524,129,66,63,0.511627906976744,0.0160321593522513,0.348991694068006,0.634976146579743
7,"Rheinland-Pfalz",7131027,"Heckenbach",255,126,129,0.494117647058824,257,129,128,0.501945525291829,0.0160321593522513,0.348991694068006,0.634976146579743
7,"Rheinland-Pfalz",7131028,"Herschbroich",276,140,136,0.507246376811594,300,158,142,0.526666666666667,0.0160321593522513,0.348991694068006,0.634976146579743
7,"Rheinland-Pfalz",7131029,"Hönningen",1079,519,560,0.481000926784059,1082,530,552,0.489833641404806,0.0160321593522513,0.348991694068006,0.634976146579743
7,"Rheinland-Pfalz",7131030,"Hoffeld",298,154,144,0.516778523489933,295,156,139,0.528813559322034,0.0160321593522513,0.348991694068006,0.634976146579743
7,"Rheinland-Pfalz",7131032,"Honerath",168,88,80,0.523809523809524,212,117,95,0.55188679245283,0.0160321593522513,0.348991694068006,0.634976146579743
7,"Rheinland-Pfalz",7131033,"Hümmel",490,265,225,0.540816326530612,504,273,231,0.541666666666667,0.0160321593522513,0.348991694068006,0.634976146579743
7,"Rheinland-Pfalz",7131034,"Insul",469,225,244,0.479744136460554,487,229,258,0.470225872689938,0.0160321593522513,0.348991694068006,0.634976146579743
7,"Rheinland-Pfalz",7131036,"Kalenborn",623,303,320,0.486356340288925,696,346,350,0.497126436781609,0.0160321593522513,0.348991694068006,0.634976146579743
7,"Rheinland-Pfalz",7131037,"Kaltenborn",378,193,185,0.510582010582011,377,192,185,0.509283819628647,0.0160321593522513,0.348991694068006,0.634976146579743
7,"Rheinland-Pfalz",7131039,"Kesseling",590,293,297,0.496610169491525,595,303,292,0.509243697478992,0.0160321593522513,0.348991694068006,0.634976146579743
7,"Rheinland-Pfalz",7131040,"Kirchsahr",365,193,172,0.528767123287671,389,207,182,0.532133676092545,0.0160321593522513,0.348991694068006,0.634976146579743
7,"Rheinland-Pfalz",7131041,"Königsfeld",654,330,324,0.504587155963303,639,330,309,0.516431924882629,0.0160321593522513,0.348991694068006,0.634976146579743
7,"Rheinland-Pfalz",7131042,"Kottenborn",177,87,90,0.491525423728814,181,94,87,0.519337016574586,0.0160321593522513,0.348991694068006,0.634976146579743
7,"Rheinland-Pfalz",7131044,"Leimbach",503,247,256,0.491053677932406,511,254,257,0.49706457925636,0.0160321593522513,0.348991694068006,0.634976146579743
7,"Rheinland-Pfalz",7131047,"Lind",553,279,274,0.504520795660036,564,287,277,0.50886524822695,0.0160321593522513,0.348991694068006,0.634976146579743
7,"Rheinland-Pfalz",7131049,"Mayschoß",901,458,443,0.508324084350721,917,464,453,0.505997818974918,0.0160321593522513,0.348991694068006,0.634976146579743
7,"Rheinland-Pfalz",7131050,"Meuspath",148,72,76,0.486486486486487,141,68,73,0.482269503546099,0.0160321593522513,0.348991694068006,0.634976146579743
7,"Rheinland-Pfalz",7131051,"Müllenbach",461,234,227,0.507592190889371,458,235,223,0.513100436681223,0.0160321593522513,0.348991694068006,0.634976146579743
7,"Rheinland-Pfalz",7131052,"Müsch",197,95,102,0.482233502538071,202,100,102,0.495049504950495,0.0160321593522513,0.348991694068006,0.634976146579743
7,"Rheinland-Pfalz",7131054,"Niederdürenbach",987,509,478,0.515704154002026,1008,537,471,0.532738095238095,0.0160321593522513,0.348991694068006,0.634976146579743
7,"Rheinland-Pfalz",7131055,"Niederzissen",2653,1302,1351,0.490765171503958,2644,1302,1342,0.492435703479576,0.0160321593522513,0.348991694068006,0.634976146579743
7,"Rheinland-Pfalz",7131058,"Nürburg",179,96,83,0.536312849162011,148,76,72,0.513513513513513,0.0160321593522513,0.348991694068006,0.634976146579743
7,"Rheinland-Pfalz",7131059,"Oberdürenbach",614,315,299,0.513029315960912,602,314,288,0.521594684385382,0.0160321593522513,0.348991694068006,0.634976146579743
7,"Rheinland-Pfalz",7131060,"Oberzissen",1093,545,548,0.498627630375114,1088,544,544,0.5,0.0160321593522513,0.348991694068006,0.634976146579743
7,"Rheinland-Pfalz",7131062,"Ohlenhard",146,72,74,0.493150684931507,133,64,69,0.481203007518797,0.0160321593522513,0.348991694068006,0.634976146579743
7,"Rheinland-Pfalz",7131065,"Pomster",153,78,75,0.509803921568627,161,87,74,0.540372670807453,0.0160321593522513,0.348991694068006,0.634976146579743
7,"Rheinland-Pfalz",7131066,"Quiddelbach",263,131,132,0.498098859315589,286,147,139,0.513986013986014,0.0160321593522513,0.348991694068006,0.634976146579743
7,"Rheinland-Pfalz",7131068,"Rech",563,297,266,0.52753108348135,563,305,258,0.541740674955595,0.0160321593522513,0.348991694068006,0.634976146579743
7,"Rheinland-Pfalz",7131069,"Reifferscheid",528,270,258,0.511363636363636,551,289,262,0.524500907441016,0.0160321593522513,0.348991694068006,0.634976146579743
7,"Rheinland-Pfalz",7131070,"Remagen, Stadt",15862,7752,8110,0.488715168326819,16125,7891,8234,0.489364341085271,0.0160321593522513,0.348991694068006,0.634976146579743
7,"Rheinland-Pfalz",7131072,"Rodder",250,128,122,0.512,251,129,122,0.51394422310757,0.0160321593522513,0.348991694068006,0.634976146579743
7,"Rheinland-Pfalz",7131073,"Schalkenbach",826,416,410,0.50363196125908,832,421,411,0.506009615384615,0.0160321593522513,0.348991694068006,0.634976146579743
7,"Rheinland-Pfalz",7131074,"Schuld",723,343,380,0.474412171507607,717,349,368,0.486750348675035,0.0160321593522513,0.348991694068006,0.634976146579743
7,"Rheinland-Pfalz",7131075,"Senscheid",96,53,43,0.552083333333333,97,51,46,0.525773195876289,0.0160321593522513,0.348991694068006,0.634976146579743
7,"Rheinland-Pfalz",7131076,"Sierscheid",85,48,37,0.564705882352941,88,49,39,0.556818181818182,0.0160321593522513,0.348991694068006,0.634976146579743
7,"Rheinland-Pfalz",7131077,"Sinzig, Stadt",17086,8297,8789,0.485602247454056,17436,8493,8943,0.487095664143152,0.0160321593522513,0.348991694068006,0.634976146579743
7,"Rheinland-Pfalz",7131079,"Trierscheid",69,31,38,0.449275362318841,64,28,36,0.4375,0.0160321593522513,0.348991694068006,0.634976146579743
7,"Rheinland-Pfalz",7131081,"Waldorf",864,431,433,0.498842592592593,833,414,419,0.496998799519808,0.0160321593522513,0.348991694068006,0.634976146579743
7,"Rheinland-Pfalz",7131082,"Wershofen",887,437,450,0.492671927846674,878,437,441,0.497722095671982,0.0160321593522513,0.348991694068006,0.634976146579743
7,"Rheinland-Pfalz",7131083,"Wiesemscheid",246,134,112,0.544715447154472,244,125,119,0.512295081967213,0.0160321593522513,0.348991694068006,0.634976146579743
7,"Rheinland-Pfalz",7131084,"Wimbach",437,216,221,0.494279176201373,430,207,223,0.481395348837209,0.0160321593522513,0.348991694068006,0.634976146579743
7,"Rheinland-Pfalz",7131085,"Winnerath",194,98,96,0.505154639175258,205,107,98,0.521951219512195,0.0160321593522513,0.348991694068006,0.634976146579743
7,"Rheinland-Pfalz",7131086,"Wirft",168,78,90,0.464285714285714,161,71,90,0.440993788819876,0.0160321593522513,0.348991694068006,0.634976146579743
7,"Rheinland-Pfalz",7131090,"Grafschaft",10761,5352,5409,0.497351547253973,10782,5397,5385,0.500556483027268,0.0160321593522513,0.348991694068006,0.634976146579743
7,"Rheinland-Pfalz",7131201,"Brenk",186,101,85,0.543010752688172,181,98,83,0.541436464088398,0.0160321593522513,0.348991694068006,0.634976146579743
7,"Rheinland-Pfalz",7131202,"Burgbrohl",3168,1588,1580,0.501262626262626,3156,1590,1566,0.503802281368821,0.0160321593522513,0.348991694068006,0.634976146579743
7,"Rheinland-Pfalz",7131204,"Galenberg",212,116,96,0.547169811320755,209,117,92,0.559808612440191,0.0160321593522513,0.348991694068006,0.634976146579743
7,"Rheinland-Pfalz",7131205,"Glees",580,307,273,0.529310344827586,578,302,276,0.522491349480969,0.0160321593522513,0.348991694068006,0.634976146579743
7,"Rheinland-Pfalz",7131206,"Hohenleimbach",366,170,196,0.46448087431694,369,169,200,0.457994579945799,0.0160321593522513,0.348991694068006,0.634976146579743
7,"Rheinland-Pfalz",7131208,"Spessart",756,393,363,0.51984126984127,740,388,352,0.524324324324324,0.0160321593522513,0.348991694068006,0.634976146579743
7,"Rheinland-Pfalz",7131209,"Wassenach",1137,567,570,0.49868073878628,1128,563,565,0.499113475177305,0.0160321593522513,0.348991694068006,0.634976146579743
7,"Rheinland-Pfalz",7131210,"Wehr",1129,568,561,0.503100088573959,1110,557,553,0.501801801801802,0.0160321593522513,0.348991694068006,0.634976146579743
7,"Rheinland-Pfalz",7131211,"Weibern",1519,745,774,0.490454246214615,1515,735,780,0.485148514851485,0.0160321593522513,0.348991694068006,0.634976146579743
7,"Rheinland-Pfalz",7131501,"Dümpelfeld",587,281,306,0.47870528109029,616,292,324,0.474025974025974,0.0160321593522513,0.348991694068006,0.634976146579743
7,"Rheinland-Pfalz",7131502,"Kempenich",1894,938,956,0.495248152059134,1871,918,953,0.490646712987707,0.0160321593522513,0.348991694068006,0.634976146579743
7,"Rheinland-Pfalz",7132001,"Almersbach",408,195,213,0.477941176470588,428,198,230,0.462616822429907,0.0160321593522513,0.348991694068006,0.634976146579743
7,"Rheinland-Pfalz",7132002,"Alsdorf",1554,772,782,0.496782496782497,1663,816,847,0.490679494888755,0.0160321593522513,0.348991694068006,0.634976146579743
7,"Rheinland-Pfalz",7132004,"Bachenberg",109,53,56,0.486238532110092,108,53,55,0.490740740740741,0.0160321593522513,0.348991694068006,0.634976146579743
7,"Rheinland-Pfalz",7132005,"Berzhausen",187,81,106,0.433155080213904,191,86,105,0.450261780104712,0.0160321593522513,0.348991694068006,0.634976146579743
7,"Rheinland-Pfalz",7132006,"Betzdorf, Stadt",10018,4925,5093,0.491615092832901,10019,4960,5059,0.495059387164388,0.0160321593522513,0.348991694068006,0.634976146579743
7,"Rheinland-Pfalz",7132007,"Birkenbeul",424,207,217,0.488207547169811,460,225,235,0.489130434782609,0.0160321593522513,0.348991694068006,0.634976146579743
7,"Rheinland-Pfalz",7132008,"Birken-Honigsessen",2485,1214,1271,0.488531187122736,2546,1254,1292,0.492537313432836,0.0160321593522513,0.348991694068006,0.634976146579743
7,"Rheinland-Pfalz",7132009,"Birnbach",599,295,304,0.492487479131886,642,324,318,0.504672897196262,0.0160321593522513,0.348991694068006,0.634976146579743
7,"Rheinland-Pfalz",7132010,"Bitzen",758,383,375,0.505277044854881,779,391,388,0.501925545571245,0.0160321593522513,0.348991694068006,0.634976146579743
7,"Rheinland-Pfalz",7132011,"Mittelhof",1018,514,504,0.504911591355599,1112,570,542,0.512589928057554,0.0160321593522513,0.348991694068006,0.634976146579743
7,"Rheinland-Pfalz",7132012,"Brachbach",2391,1189,1202,0.497281472187369,2353,1176,1177,0.499787505312367,0.0160321593522513,0.348991694068006,0.634976146579743
7,"Rheinland-Pfalz",7132013,"Breitscheidt",944,453,491,0.479872881355932,1009,494,515,0.489593657086224,0.0160321593522513,0.348991694068006,0.634976146579743
7,"Rheinland-Pfalz",7132014,"Bruchertseifen",715,353,362,0.493706293706294,717,362,355,0.504881450488145,0.0160321593522513,0.348991694068006,0.634976146579743
7,"Rheinland-Pfalz",7132015,"Bürdenbach",550,287,263,0.521818181818182,538,283,255,0.526022304832714,0.0160321593522513,0.348991694068006,0.634976146579743
7,"Rheinland-Pfalz",7132016,"Burglahr",500,235,265,0.47,504,239,265,0.474206349206349,0.0160321593522513,0.348991694068006,0.634976146579743
7,"Rheinland-Pfalz",7132017,"Busenhausen",340,172,168,0.505882352941176,326,165,161,0.506134969325153,0.0160321593522513,0.348991694068006,0.634976146579743
7,"Rheinland-Pfalz",7132018,"Daaden",4311,2115,2196,0.490605427974948,4310,2126,2184,0.493271461716937,0.0160321593522513,0.348991694068006,0.634976146579743
7,"Rheinland-Pfalz",7132019,"Derschen",1045,555,490,0.5311004784689,1058,571,487,0.539697542533081,0.0160321593522513,0.348991694068006,0.634976146579743
7,"Rheinland-Pfalz",7132020,"Dickendorf",373,182,191,0.487935656836461,372,178,194,0.478494623655914,0.0160321593522513,0.348991694068006,0.634976146579743
7,"Rheinland-Pfalz",7132022,"Eichelhardt",478,245,233,0.51255230125523,469,241,228,0.513859275053305,0.0160321593522513,0.348991694068006,0.634976146579743
7,"Rheinland-Pfalz",7132023,"Eichen",550,278,272,0.505454545454545,576,299,277,0.519097222222222,0.0160321593522513,0.348991694068006,0.634976146579743
7,"Rheinland-Pfalz",7132024,"Elben",341,173,168,0.50733137829912,320,156,164,0.4875,0.0160321593522513,0.348991694068006,0.634976146579743
7,"Rheinland-Pfalz",7132025,"Elkenroth",1837,917,920,0.49918345127926,1860,932,928,0.501075268817204,0.0160321593522513,0.348991694068006,0.634976146579743
7,"Rheinland-Pfalz",7132026,"Emmerzhausen",702,347,355,0.494301994301994,707,354,353,0.500707213578501,0.0160321593522513,0.348991694068006,0.634976146579743
7,"Rheinland-Pfalz",7132027,"Ersfeld",74,35,39,0.472972972972973,68,33,35,0.485294117647059,0.0160321593522513,0.348991694068006,0.634976146579743
7,"Rheinland-Pfalz",7132028,"Etzbach",1254,649,605,0.517543859649123,1323,689,634,0.520786092214664,0.0160321593522513,0.348991694068006,0.634976146579743
7,"Rheinland-Pfalz",7132029,"Eulenberg",54,30,24,0.555555555555556,59,29,30,0.491525423728814,0.0160321593522513,0.348991694068006,0.634976146579743
7,"Rheinland-Pfalz",7132030,"Fensdorf",422,214,208,0.507109004739337,404,207,197,0.512376237623762,0.0160321593522513,0.348991694068006,0.634976146579743
7,"Rheinland-Pfalz",7132031,"Fiersbach",256,137,119,0.53515625,284,147,137,0.517605633802817,0.0160321593522513,0.348991694068006,0.634976146579743
7,"Rheinland-Pfalz",7132032,"Flammersfeld",1310,615,695,0.469465648854962,1071,475,596,0.443510737628385,0.0160321593522513,0.348991694068006,0.634976146579743
7,"Rheinland-Pfalz",7132033,"Fluterschen",639,305,334,0.477308294209703,677,316,361,0.466765140324963,0.0160321593522513,0.348991694068006,0.634976146579743
7,"Rheinland-Pfalz",7132034,"Forst",606,272,334,0.448844884488449,633,293,340,0.462875197472354,0.0160321593522513,0.348991694068006,0.634976146579743
7,"Rheinland-Pfalz",7132035,"Forstmehren",158,79,79,0.5,165,86,79,0.521212121212121,0.0160321593522513,0.348991694068006,0.634976146579743
7,"Rheinland-Pfalz",7132036,"Friedewald",1112,563,549,0.506294964028777,1137,570,567,0.50131926121372,0.0160321593522513,0.348991694068006,0.634976146579743
7,"Rheinland-Pfalz",7132037,"Friesenhagen",1604,811,793,0.505610972568579,1589,816,773,0.513530522341095,0.0160321593522513,0.348991694068006,0.634976146579743
7,"Rheinland-Pfalz",7132038,"Fürthen",1181,595,586,0.50381033022862,1206,606,600,0.502487562189055,0.0160321593522513,0.348991694068006,0.634976146579743
7,"Rheinland-Pfalz",7132039,"Gebhardshain",1910,932,978,0.487958115183246,1869,925,944,0.494917067950776,0.0160321593522513,0.348991694068006,0.634976146579743
7,"Rheinland-Pfalz",7132040,"Gieleroth",652,341,311,0.523006134969325,672,352,320,0.523809523809524,0.0160321593522513,0.348991694068006,0.634976146579743
7,"Rheinland-Pfalz",7132041,"Giershausen",100,53,47,0.53,97,47,50,0.484536082474227,0.0160321593522513,0.348991694068006,0.634976146579743
7,"Rheinland-Pfalz",7132042,"Grünebach",543,268,275,0.493554327808471,522,260,262,0.498084291187739,0.0160321593522513,0.348991694068006,0.634976146579743
7,"Rheinland-Pfalz",7132043,"Güllesheim",686,353,333,0.514577259475219,673,337,336,0.50074294205052,0.0160321593522513,0.348991694068006,0.634976146579743
7,"Rheinland-Pfalz",7132044,"Hamm (Sieg)",3382,1624,1758,0.480189237137788,3307,1554,1753,0.469912307227094,0.0160321593522513,0.348991694068006,0.634976146579743
7,"Rheinland-Pfalz",7132045,"Harbach",540,269,271,0.498148148148148,532,267,265,0.50187969924812,0.0160321593522513,0.348991694068006,0.634976146579743
7,"Rheinland-Pfalz",7132046,"Hasselbach",326,164,162,0.503067484662577,347,167,180,0.481268011527378,0.0160321593522513,0.348991694068006,0.634976146579743
7,"Rheinland-Pfalz",7132047,"Helmenzen",848,429,419,0.505896226415094,852,437,415,0.512910798122066,0.0160321593522513,0.348991694068006,0.634976146579743
7,"Rheinland-Pfalz",7132048,"Helmeroth",188,85,103,0.452127659574468,204,96,108,0.470588235294118,0.0160321593522513,0.348991694068006,0.634976146579743
7,"Rheinland-Pfalz",7132049,"Hemmelzen",243,127,116,0.522633744855967,235,118,117,0.502127659574468,0.0160321593522513,0.348991694068006,0.634976146579743
7,"Rheinland-Pfalz",7132050,"Herdorf, Stadt",6800,3330,3470,0.489705882352941,6822,3357,3465,0.492084432717678,0.0160321593522513,0.348991694068006,0.634976146579743
7,"Rheinland-Pfalz",7132051,"Heupelzen",257,127,130,0.494163424124514,269,130,139,0.483271375464684,0.0160321593522513,0.348991694068006,0.634976146579743
7,"Rheinland-Pfalz",7132052,"Hilgenroth",301,145,156,0.481727574750831,291,143,148,0.491408934707904,0.0160321593522513,0.348991694068006,0.634976146579743
7,"Rheinland-Pfalz",7132053,"Hirz-Maulsbach",321,156,165,0.485981308411215,319,155,164,0.4858934169279,0.0160321593522513,0.348991694068006,0.634976146579743
7,"Rheinland-Pfalz",7132054,"Hövels",583,281,302,0.481989708404803,616,314,302,0.50974025974026,0.0160321593522513,0.348991694068006,0.634976146579743
7,"Rheinland-Pfalz",7132055,"Horhausen (Westerwald)",1893,913,980,0.48230322239831,1896,909,987,0.479430379746835,0.0160321593522513,0.348991694068006,0.634976146579743
7,"Rheinland-Pfalz",7132056,"Idelberg",57,29,28,0.508771929824561,53,29,24,0.547169811320755,0.0160321593522513,0.348991694068006,0.634976146579743
7,"Rheinland-Pfalz",7132057,"Ingelbach",523,255,268,0.487571701720841,552,271,281,0.490942028985507,0.0160321593522513,0.348991694068006,0.634976146579743
7,"Rheinland-Pfalz",7132058,"Isert",145,78,67,0.537931034482759,181,109,72,0.602209944751381,0.0160321593522513,0.348991694068006,0.634976146579743
7,"Rheinland-Pfalz",7132059,"Kausen",786,396,390,0.50381679389313,791,407,384,0.514538558786346,0.0160321593522513,0.348991694068006,0.634976146579743
7,"Rheinland-Pfalz",7132060,"Kescheid",128,66,62,0.515625,131,71,60,0.541984732824427,0.0160321593522513,0.348991694068006,0.634976146579743
7,"Rheinland-Pfalz",7132061,"Kettenhausen",265,136,129,0.513207547169811,279,143,136,0.512544802867383,0.0160321593522513,0.348991694068006,0.634976146579743
7,"Rheinland-Pfalz",7132062,"Kircheib",547,277,270,0.506398537477148,557,286,271,0.513464991023339,0.0160321593522513,0.348991694068006,0.634976146579743
7,"Rheinland-Pfalz",7132063,"Kirchen (Sieg), Stadt",8648,4250,4398,0.491443108233117,8578,4272,4306,0.498018186057356,0.0160321593522513,0.348991694068006,0.634976146579743
7,"Rheinland-Pfalz",7132064,"Kraam",178,96,82,0.539325842696629,158,80,78,0.506329113924051,0.0160321593522513,0.348991694068006,0.634976146579743
7,"Rheinland-Pfalz",7132065,"Krunkel",616,309,307,0.501623376623377,645,330,315,0.511627906976744,0.0160321593522513,0.348991694068006,0.634976146579743
7,"Rheinland-Pfalz",7132066,"Malberg",1032,519,513,0.502906976744186,1053,537,516,0.50997150997151,0.0160321593522513,0.348991694068006,0.634976146579743
7,"Rheinland-Pfalz",7132067,"Mammelzen",1015,496,519,0.488669950738916,1047,501,546,0.478510028653295,0.0160321593522513,0.348991694068006,0.634976146579743
7,"Rheinland-Pfalz",7132068,"Mauden",110,56,54,0.509090909090909,106,52,54,0.490566037735849,0.0160321593522513,0.348991694068006,0.634976146579743
7,"Rheinland-Pfalz",7132069,"Mehren",504,228,276,0.452380952380952,491,232,259,0.472505091649695,0.0160321593522513,0.348991694068006,0.634976146579743
7,"Rheinland-Pfalz",7132070,"Michelbach (Westerwald)",543,262,281,0.482504604051565,545,259,286,0.475229357798165,0.0160321593522513,0.348991694068006,0.634976146579743
7,"Rheinland-Pfalz",7132071,"Molzhain",537,273,264,0.508379888268156,569,283,286,0.497363796133568,0.0160321593522513,0.348991694068006,0.634976146579743
7,"Rheinland-Pfalz",7132072,"Mudersbach",5913,2904,3009,0.491121258244546,6155,3042,3113,0.494232331437855,0.0160321593522513,0.348991694068006,0.634976146579743
7,"Rheinland-Pfalz",7132073,"Nauroth",1104,544,560,0.492753623188406,1082,530,552,0.489833641404806,0.0160321593522513,0.348991694068006,0.634976146579743
7,"Rheinland-Pfalz",7132074,"Neitersen",765,385,380,0.503267973856209,787,394,393,0.500635324015248,0.0160321593522513,0.348991694068006,0.634976146579743
7,"Rheinland-Pfalz",7132075,"Niederdreisbach",909,459,450,0.504950495049505,908,458,450,0.504405286343612,0.0160321593522513,0.348991694068006,0.634976146579743
7,"Rheinland-Pfalz",7132076,"Niederfischbach",4425,2178,2247,0.492203389830508,4648,2360,2288,0.507745266781411,0.0160321593522513,0.348991694068006,0.634976146579743
7,"Rheinland-Pfalz",7132077,"Niederirsen",100,52,48,0.52,104,58,46,0.557692307692308,0.0160321593522513,0.348991694068006,0.634976146579743
7,"Rheinland-Pfalz",7132078,"Niedersteinebach",212,88,124,0.415094339622642,173,71,102,0.410404624277457,0.0160321593522513,0.348991694068006,0.634976146579743
7,"Rheinland-Pfalz",7132079,"Nisterberg",357,172,185,0.481792717086835,380,188,192,0.494736842105263,0.0160321593522513,0.348991694068006,0.634976146579743
7,"Rheinland-Pfalz",7132080,"Katzwinkel (Sieg)",1863,904,959,0.485238862050456,1913,909,1004,0.475169890224778,0.0160321593522513,0.348991694068006,0.634976146579743
7,"Rheinland-Pfalz",7132081,"Obererbach (Westerwald)",539,272,267,0.504638218923933,535,278,257,0.519626168224299,0.0160321593522513,0.348991694068006,0.634976146579743
7,"Rheinland-Pfalz",7132082,"Oberirsen",638,317,321,0.496865203761755,661,324,337,0.490166414523449,0.0160321593522513,0.348991694068006,0.634976146579743
7,"Rheinland-Pfalz",7132083,"Oberlahr",749,364,385,0.485981308411215,729,352,377,0.482853223593964,0.0160321593522513,0.348991694068006,0.634976146579743
7,"Rheinland-Pfalz",7132084,"Obernau",178,100,78,0.561797752808989,167,94,73,0.562874251497006,0.0160321593522513,0.348991694068006,0.634976146579743
7,"Rheinland-Pfalz",7132085,"Obersteinebach",230,124,106,0.539130434782609,225,120,105,0.533333333333333,0.0160321593522513,0.348991694068006,0.634976146579743
7,"Rheinland-Pfalz",7132086,"Oberwambach",431,227,204,0.526682134570766,445,239,206,0.537078651685393,0.0160321593522513,0.348991694068006,0.634976146579743
7,"Rheinland-Pfalz",7132087,"Ölsen",89,45,44,0.50561797752809,81,41,40,0.506172839506173,0.0160321593522513,0.348991694068006,0.634976146579743
7,"Rheinland-Pfalz",7132088,"Orfgen",238,111,127,0.466386554621849,247,116,131,0.469635627530364,0.0160321593522513,0.348991694068006,0.634976146579743
7,"Rheinland-Pfalz",7132089,"Peterslahr",305,152,153,0.498360655737705,299,146,153,0.488294314381271,0.0160321593522513,0.348991694068006,0.634976146579743
7,"Rheinland-Pfalz",7132090,"Pleckhausen",765,380,385,0.496732026143791,791,394,397,0.498103666245259,0.0160321593522513,0.348991694068006,0.634976146579743
7,"Rheinland-Pfalz",7132091,"Pracht",1502,764,738,0.508655126498003,1566,805,761,0.514048531289911,0.0160321593522513,0.348991694068006,0.634976146579743
7,"Rheinland-Pfalz",7132092,"Racksen",148,77,71,0.52027027027027,155,83,72,0.535483870967742,0.0160321593522513,0.348991694068006,0.634976146579743
7,"Rheinland-Pfalz",7132093,"Reiferscheid",407,197,210,0.484029484029484,401,190,211,0.473815461346633,0.0160321593522513,0.348991694068006,0.634976146579743
7,"Rheinland-Pfalz",7132094,"Rettersen",372,190,182,0.510752688172043,375,194,181,0.517333333333333,0.0160321593522513,0.348991694068006,0.634976146579743
7,"Rheinland-Pfalz",7132095,"Rosenheim (Landkreis Altenkirchen)",779,388,391,0.498074454428755,709,324,385,0.456981664315938,0.0160321593522513,0.348991694068006,0.634976146579743
7,"Rheinland-Pfalz",7132096,"Roth",1474,742,732,0.503392130257802,1528,756,772,0.494764397905759,0.0160321593522513,0.348991694068006,0.634976146579743
7,"Rheinland-Pfalz",7132097,"Rott",363,186,177,0.512396694214876,454,272,182,0.599118942731278,0.0160321593522513,0.348991694068006,0.634976146579743
7,"Rheinland-Pfalz",7132098,"Scheuerfeld",2013,977,1036,0.485345255837059,2054,1012,1042,0.49269717624148,0.0160321593522513,0.348991694068006,0.634976146579743
7,"Rheinland-Pfalz",7132099,"Schöneberg",399,199,200,0.49874686716792,413,202,211,0.48910411622276,0.0160321593522513,0.348991694068006,0.634976146579743
7,"Rheinland-Pfalz",7132100,"Schürdt",260,128,132,0.492307692307692,251,123,128,0.49003984063745,0.0160321593522513,0.348991694068006,0.634976146579743
7,"Rheinland-Pfalz",7132101,"Schutzbach",385,201,184,0.522077922077922,399,217,182,0.543859649122807,0.0160321593522513,0.348991694068006,0.634976146579743
7,"Rheinland-Pfalz",7132102,"Seelbach bei Hamm (Sieg)",138,65,73,0.471014492753623,181,99,82,0.546961325966851,0.0160321593522513,0.348991694068006,0.634976146579743
7,"Rheinland-Pfalz",7132103,"Seelbach (Westerwald)",319,155,164,0.4858934169279,326,157,169,0.48159509202454,0.0160321593522513,0.348991694068006,0.634976146579743
7,"Rheinland-Pfalz",7132104,"Seifen",123,62,61,0.504065040650406,154,82,72,0.532467532467532,0.0160321593522513,0.348991694068006,0.634976146579743
7,"Rheinland-Pfalz",7132105,"Selbach (Sieg)",784,397,387,0.506377551020408,808,400,408,0.495049504950495,0.0160321593522513,0.348991694068006,0.634976146579743
7,"Rheinland-Pfalz",7132106,"Sörth",236,103,133,0.436440677966102,251,112,139,0.446215139442231,0.0160321593522513,0.348991694068006,0.634976146579743
7,"Rheinland-Pfalz",7132107,"Steinebach/ Sieg",1237,631,606,0.510105092966855,1234,633,601,0.512965964343598,0.0160321593522513,0.348991694068006,0.634976146579743
7,"Rheinland-Pfalz",7132108,"Steineroth",582,292,290,0.501718213058419,600,300,300,0.5,0.0160321593522513,0.348991694068006,0.634976146579743
7,"Rheinland-Pfalz",7132109,"Stürzelbach",264,130,134,0.492424242424242,230,106,124,0.460869565217391,0.0160321593522513,0.348991694068006,0.634976146579743
7,"Rheinland-Pfalz",7132110,"Volkerzen",87,48,39,0.551724137931034,86,51,35,0.593023255813954,0.0160321593522513,0.348991694068006,0.634976146579743
7,"Rheinland-Pfalz",7132111,"Wallmenroth",1222,607,615,0.496726677577741,1247,616,631,0.493985565356856,0.0160321593522513,0.348991694068006,0.634976146579743
7,"Rheinland-Pfalz",7132112,"Walterschen",150,80,70,0.533333333333333,158,80,78,0.506329113924051,0.0160321593522513,0.348991694068006,0.634976146579743
7,"Rheinland-Pfalz",7132113,"Weitefeld",2371,1178,1193,0.496836777730915,2408,1221,1187,0.507059800664452,0.0160321593522513,0.348991694068006,0.634976146579743
7,"Rheinland-Pfalz",7132114,"Werkhausen",235,119,116,0.506382978723404,229,115,114,0.502183406113537,0.0160321593522513,0.348991694068006,0.634976146579743
7,"Rheinland-Pfalz",7132115,"Weyerbusch",1372,644,728,0.469387755102041,1398,675,723,0.482832618025751,0.0160321593522513,0.348991694068006,0.634976146579743
7,"Rheinland-Pfalz",7132116,"Willroth",840,435,405,0.517857142857143,834,443,391,0.531175059952038,0.0160321593522513,0.348991694068006,0.634976146579743
7,"Rheinland-Pfalz",7132117,"Wissen, Stadt",8210,4019,4191,0.48952496954933,8056,3963,4093,0.491931479642503,0.0160321593522513,0.348991694068006,0.634976146579743
7,"Rheinland-Pfalz",7132118,"Wölmersen",360,182,178,0.505555555555556,392,200,192,0.510204081632653,0.0160321593522513,0.348991694068006,0.634976146579743
7,"Rheinland-Pfalz",7132119,"Ziegenhain",139,66,73,0.474820143884892,132,61,71,0.462121212121212,0.0160321593522513,0.348991694068006,0.634976146579743
7,"Rheinland-Pfalz",7132201,"Berod bei Hachenburg",552,276,276,0.5,571,290,281,0.507880910683012,0.0160321593522513,0.348991694068006,0.634976146579743
7,"Rheinland-Pfalz",7132501,"Altenkirchen (Westerwald), Stadt",6315,2944,3371,0.466191607284244,5978,2787,3191,0.46620943459351,0.0160321593522513,0.348991694068006,0.634976146579743
7,"Rheinland-Pfalz",7133001,"Abtweiler",210,102,108,0.485714285714286,208,104,104,0.5,0.0160321593522513,0.348991694068006,0.634976146579743
7,"Rheinland-Pfalz",7133002,"Allenfeld",197,104,93,0.527918781725888,195,104,91,0.533333333333333,0.0160321593522513,0.348991694068006,0.634976146579743
7,"Rheinland-Pfalz",7133003,"Altenbamberg",756,366,390,0.484126984126984,760,372,388,0.489473684210526,0.0160321593522513,0.348991694068006,0.634976146579743
7,"Rheinland-Pfalz",7133004,"Argenschwang",349,179,170,0.512893982808023,354,179,175,0.505649717514124,0.0160321593522513,0.348991694068006,0.634976146579743
7,"Rheinland-Pfalz",7133005,"Auen",180,91,89,0.505555555555556,209,108,101,0.516746411483254,0.0160321593522513,0.348991694068006,0.634976146579743
7,"Rheinland-Pfalz",7133006,"Bad Kreuznach, Stadt",43247,20154,23093,0.466020764446089,43958,20846,23112,0.474225396969835,0.0160321593522513,0.348991694068006,0.634976146579743
7,"Rheinland-Pfalz",7133007,"Bad Münster am Stein-Ebernburg, Stadt",4223,1963,2260,0.46483542505328,3972,1850,2122,0.465760322255791,0.0160321593522513,0.348991694068006,0.634976146579743
7,"Rheinland-Pfalz",7133008,"Bärenbach",493,243,250,0.49290060851927,509,250,259,0.491159135559921,0.0160321593522513,0.348991694068006,0.634976146579743
7,"Rheinland-Pfalz",7133009,"Bärweiler",243,127,116,0.522633744855967,242,125,117,0.516528925619835,0.0160321593522513,0.348991694068006,0.634976146579743
7,"Rheinland-Pfalz",7133010,"Becherbach bei Kirn",398,196,202,0.492462311557789,404,209,195,0.517326732673267,0.0160321593522513,0.348991694068006,0.634976146579743
7,"Rheinland-Pfalz",7133011,"Becherbach",913,452,461,0.495071193866375,877,438,439,0.499429874572406,0.0160321593522513,0.348991694068006,0.634976146579743
7,"Rheinland-Pfalz",7133012,"Biebelsheim",663,336,327,0.506787330316742,656,329,327,0.501524390243902,0.0160321593522513,0.348991694068006,0.634976146579743
7,"Rheinland-Pfalz",7133013,"Bockenau",1261,646,615,0.512291831879461,1257,637,620,0.506762132060461,0.0160321593522513,0.348991694068006,0.634976146579743
7,"Rheinland-Pfalz",7133014,"Boos",378,195,183,0.515873015873016,383,201,182,0.524804177545692,0.0160321593522513,0.348991694068006,0.634976146579743
7,"Rheinland-Pfalz",7133015,"Braunweiler",629,303,326,0.481717011128776,614,293,321,0.477198697068404,0.0160321593522513,0.348991694068006,0.634976146579743
7,"Rheinland-Pfalz",7133016,"Brauweiler",69,37,32,0.536231884057971,61,31,30,0.508196721311475,0.0160321593522513,0.348991694068006,0.634976146579743
7,"Rheinland-Pfalz",7133017,"Breitenheim",411,202,209,0.491484184914842,398,194,204,0.487437185929648,0.0160321593522513,0.348991694068006,0.634976146579743
7,"Rheinland-Pfalz",7133018,"Bretzenheim",2498,1267,1231,0.507205764611689,2480,1265,1215,0.51008064516129,0.0160321593522513,0.348991694068006,0.634976146579743
7,"Rheinland-Pfalz",7133019,"Burgsponheim",253,123,130,0.486166007905138,257,123,134,0.478599221789883,0.0160321593522513,0.348991694068006,0.634976146579743
7,"Rheinland-Pfalz",7133020,"Callbach",401,188,213,0.468827930174564,379,180,199,0.474934036939314,0.0160321593522513,0.348991694068006,0.634976146579743
7,"Rheinland-Pfalz",7133021,"Dalberg",248,130,118,0.524193548387097,246,128,118,0.520325203252033,0.0160321593522513,0.348991694068006,0.634976146579743
7,"Rheinland-Pfalz",7133022,"Daubach",226,112,114,0.495575221238938,232,113,119,0.487068965517241,0.0160321593522513,0.348991694068006,0.634976146579743
7,"Rheinland-Pfalz",7133023,"Daxweiler",801,376,425,0.469413233458177,805,388,417,0.481987577639752,0.0160321593522513,0.348991694068006,0.634976146579743
7,"Rheinland-Pfalz",7133024,"Desloch",378,192,186,0.507936507936508,367,189,178,0.514986376021798,0.0160321593522513,0.348991694068006,0.634976146579743
7,"Rheinland-Pfalz",7133025,"Dörrebach",693,347,346,0.500721500721501,704,355,349,0.504261363636364,0.0160321593522513,0.348991694068006,0.634976146579743
7,"Rheinland-Pfalz",7133026,"Dorsheim",726,364,362,0.50137741046832,720,361,359,0.501388888888889,0.0160321593522513,0.348991694068006,0.634976146579743
7,"Rheinland-Pfalz",7133027,"Duchroth",549,262,287,0.477231329690346,558,271,287,0.485663082437276,0.0160321593522513,0.348991694068006,0.634976146579743
7,"Rheinland-Pfalz",7133028,"Eckenroth",228,103,125,0.451754385964912,219,99,120,0.452054794520548,0.0160321593522513,0.348991694068006,0.634976146579743
7,"Rheinland-Pfalz",7133030,"Feilbingert",1616,832,784,0.514851485148515,1606,837,769,0.521170610211706,0.0160321593522513,0.348991694068006,0.634976146579743
7,"Rheinland-Pfalz",7133031,"Frei-Laubersheim",1019,505,514,0.49558390578999,1030,519,511,0.503883495145631,0.0160321593522513,0.348991694068006,0.634976146579743
7,"Rheinland-Pfalz",7133032,"Fürfeld",1552,750,802,0.483247422680412,1521,727,794,0.477975016436555,0.0160321593522513,0.348991694068006,0.634976146579743
7,"Rheinland-Pfalz",7133033,"Gebroth",167,81,86,0.48502994011976,160,78,82,0.4875,0.0160321593522513,0.348991694068006,0.634976146579743
7,"Rheinland-Pfalz",7133035,"Guldental",2545,1252,1293,0.491944990176817,2513,1253,1260,0.498607242339833,0.0160321593522513,0.348991694068006,0.634976146579743
7,"Rheinland-Pfalz",7133036,"Gutenberg",975,480,495,0.492307692307692,957,478,479,0.499477533960293,0.0160321593522513,0.348991694068006,0.634976146579743
7,"Rheinland-Pfalz",7133037,"Hackenheim",2071,1021,1050,0.492998551424433,2053,1000,1053,0.487092060399415,0.0160321593522513,0.348991694068006,0.634976146579743
7,"Rheinland-Pfalz",7133038,"Hahnenbach",541,277,264,0.512014787430684,567,294,273,0.518518518518518,0.0160321593522513,0.348991694068006,0.634976146579743
7,"Rheinland-Pfalz",7133039,"Hallgarten",777,395,382,0.508365508365508,733,372,361,0.507503410641201,0.0160321593522513,0.348991694068006,0.634976146579743
7,"Rheinland-Pfalz",7133040,"Hargesheim",2806,1359,1447,0.48431931575196,2849,1399,1450,0.491049491049491,0.0160321593522513,0.348991694068006,0.634976146579743
7,"Rheinland-Pfalz",7133041,"Heimweiler",423,211,212,0.498817966903073,433,220,213,0.508083140877598,0.0160321593522513,0.348991694068006,0.634976146579743
7,"Rheinland-Pfalz",7133042,"Heinzenberg",33,17,16,0.515151515151515,27,14,13,0.518518518518518,0.0160321593522513,0.348991694068006,0.634976146579743
7,"Rheinland-Pfalz",7133043,"Hennweiler",1247,620,627,0.4971932638332,1272,640,632,0.50314465408805,0.0160321593522513,0.348991694068006,0.634976146579743
7,"Rheinland-Pfalz",7133044,"Hergenfeld",495,232,263,0.468686868686869,495,231,264,0.466666666666667,0.0160321593522513,0.348991694068006,0.634976146579743
7,"Rheinland-Pfalz",7133045,"Hochstätten",624,307,317,0.491987179487179,626,315,311,0.503194888178914,0.0160321593522513,0.348991694068006,0.634976146579743
7,"Rheinland-Pfalz",7133046,"Hochstetten-Dhaun",1649,818,831,0.496058217101274,1600,781,819,0.488125,0.0160321593522513,0.348991694068006,0.634976146579743
7,"Rheinland-Pfalz",7133047,"Horbach",44,25,19,0.568181818181818,41,23,18,0.560975609756098,0.0160321593522513,0.348991694068006,0.634976146579743
7,"Rheinland-Pfalz",7133048,"Hüffelsheim",1298,651,647,0.501540832049307,1276,642,634,0.503134796238245,0.0160321593522513,0.348991694068006,0.634976146579743
7,"Rheinland-Pfalz",7133049,"Hundsbach",388,181,207,0.466494845360825,390,180,210,0.461538461538462,0.0160321593522513,0.348991694068006,0.634976146579743
7,"Rheinland-Pfalz",7133050,"Ippenschied",152,71,81,0.467105263157895,147,66,81,0.448979591836735,0.0160321593522513,0.348991694068006,0.634976146579743
7,"Rheinland-Pfalz",7133051,"Jeckenbach",261,126,135,0.482758620689655,257,129,128,0.501945525291829,0.0160321593522513,0.348991694068006,0.634976146579743
7,"Rheinland-Pfalz",7133052,"Kirn, Stadt",8213,3988,4225,0.485571654693778,8142,4068,4074,0.499631540162122,0.0160321593522513,0.348991694068006,0.634976146579743
7,"Rheinland-Pfalz",7133053,"Kirschroth",269,140,129,0.520446096654275,267,140,127,0.524344569288389,0.0160321593522513,0.348991694068006,0.634976146579743
7,"Rheinland-Pfalz",7133054,"Langenlonsheim",3761,1799,1962,0.478330231321457,3731,1789,1942,0.479496113642455,0.0160321593522513,0.348991694068006,0.634976146579743
7,"Rheinland-Pfalz",7133055,"Langenthal",98,50,48,0.510204081632653,89,46,43,0.51685393258427,0.0160321593522513,0.348991694068006,0.634976146579743
7,"Rheinland-Pfalz",7133056,"Laubenheim",775,380,395,0.490322580645161,748,357,391,0.477272727272727,0.0160321593522513,0.348991694068006,0.634976146579743
7,"Rheinland-Pfalz",7133057,"Lauschied",564,260,304,0.460992907801418,567,267,300,0.470899470899471,0.0160321593522513,0.348991694068006,0.634976146579743
7,"Rheinland-Pfalz",7133058,"Lettweiler",224,114,110,0.508928571428571,220,111,109,0.504545454545455,0.0160321593522513,0.348991694068006,0.634976146579743
7,"Rheinland-Pfalz",7133059,"Limbach",321,154,167,0.479750778816199,323,149,174,0.461300309597523,0.0160321593522513,0.348991694068006,0.634976146579743
7,"Rheinland-Pfalz",7133060,"Löllbach",222,115,107,0.518018018018018,211,115,96,0.545023696682464,0.0160321593522513,0.348991694068006,0.634976146579743
7,"Rheinland-Pfalz",7133061,"Mandel",910,442,468,0.485714285714286,901,442,459,0.490566037735849,0.0160321593522513,0.348991694068006,0.634976146579743
7,"Rheinland-Pfalz",7133062,"Martinstein",302,163,139,0.539735099337748,311,164,147,0.527331189710611,0.0160321593522513,0.348991694068006,0.634976146579743
7,"Rheinland-Pfalz",7133063,"Meckenbach",386,193,193,0.5,403,204,199,0.506203473945409,0.0160321593522513,0.348991694068006,0.634976146579743
7,"Rheinland-Pfalz",7133064,"Meddersheim",1320,669,651,0.506818181818182,1310,665,645,0.50763358778626,0.0160321593522513,0.348991694068006,0.634976146579743
7,"Rheinland-Pfalz",7133065,"Meisenheim, Stadt",2870,1375,1495,0.479094076655052,2799,1355,1444,0.48410146480886,0.0160321593522513,0.348991694068006,0.634976146579743
7,"Rheinland-Pfalz",7133066,"Merxheim",1441,704,737,0.488549618320611,1429,696,733,0.48705388383485,0.0160321593522513,0.348991694068006,0.634976146579743
7,"Rheinland-Pfalz",7133067,"Monzingen",1629,810,819,0.497237569060773,1672,866,806,0.517942583732057,0.0160321593522513,0.348991694068006,0.634976146579743
7,"Rheinland-Pfalz",7133068,"Münchwald",305,150,155,0.491803278688525,308,146,162,0.474025974025974,0.0160321593522513,0.348991694068006,0.634976146579743
7,"Rheinland-Pfalz",7133069,"Neu-Bamberg",918,446,472,0.485838779956427,892,437,455,0.489910313901345,0.0160321593522513,0.348991694068006,0.634976146579743
7,"Rheinland-Pfalz",7133070,"Niederhausen",537,265,272,0.493482309124767,515,260,255,0.504854368932039,0.0160321593522513,0.348991694068006,0.634976146579743
7,"Rheinland-Pfalz",7133071,"Norheim",1487,734,753,0.493611297915266,1461,730,731,0.499657768651608,0.0160321593522513,0.348991694068006,0.634976146579743
7,"Rheinland-Pfalz",7133072,"Nußbaum",456,220,236,0.482456140350877,441,205,236,0.464852607709751,0.0160321593522513,0.348991694068006,0.634976146579743
7,"Rheinland-Pfalz",7133073,"Oberhausen bei Kirn",938,454,484,0.484008528784648,955,466,489,0.487958115183246,0.0160321593522513,0.348991694068006,0.634976146579743
7,"Rheinland-Pfalz",7133074,"Oberhausen an der Nahe",368,187,181,0.508152173913043,394,200,194,0.50761421319797,0.0160321593522513,0.348991694068006,0.634976146579743
7,"Rheinland-Pfalz",7133075,"Oberstreit",278,153,125,0.550359712230216,275,152,123,0.552727272727273,0.0160321593522513,0.348991694068006,0.634976146579743
7,"Rheinland-Pfalz",7133076,"Odernheim am Glan",1722,837,885,0.486062717770035,1755,852,903,0.485470085470085,0.0160321593522513,0.348991694068006,0.634976146579743
7,"Rheinland-Pfalz",7133077,"Otzweiler",213,124,89,0.582159624413146,210,120,90,0.571428571428571,0.0160321593522513,0.348991694068006,0.634976146579743
7,"Rheinland-Pfalz",7133078,"Pfaffen-Schwabenheim",1302,668,634,0.513056835637481,1279,655,624,0.512118842845973,0.0160321593522513,0.348991694068006,0.634976146579743
7,"Rheinland-Pfalz",7133080,"Pleitersheim",339,171,168,0.504424778761062,338,172,166,0.50887573964497,0.0160321593522513,0.348991694068006,0.634976146579743
7,"Rheinland-Pfalz",7133081,"Raumbach",415,209,206,0.503614457831325,403,200,203,0.496277915632754,0.0160321593522513,0.348991694068006,0.634976146579743
7,"Rheinland-Pfalz",7133082,"Rehbach",50,27,23,0.54,48,24,24,0.5,0.0160321593522513,0.348991694068006,0.634976146579743
7,"Rheinland-Pfalz",7133083,"Rehborn",728,359,369,0.493131868131868,707,357,350,0.504950495049505,0.0160321593522513,0.348991694068006,0.634976146579743
7,"Rheinland-Pfalz",7133084,"Reiffelbach",244,129,115,0.528688524590164,244,129,115,0.528688524590164,0.0160321593522513,0.348991694068006,0.634976146579743
7,"Rheinland-Pfalz",7133085,"Roth",270,130,140,0.481481481481481,259,120,139,0.463320463320463,0.0160321593522513,0.348991694068006,0.634976146579743
7,"Rheinland-Pfalz",7133086,"Roxheim",2373,1139,1234,0.479983143699958,2378,1143,1235,0.480656013456686,0.0160321593522513,0.348991694068006,0.634976146579743
7,"Rheinland-Pfalz",7133087,"Rümmelsheim",1359,687,672,0.50551876379691,1359,696,663,0.512141280353201,0.0160321593522513,0.348991694068006,0.634976146579743
7,"Rheinland-Pfalz",7133088,"Sankt Katharinen",370,190,180,0.513513513513513,355,181,174,0.509859154929577,0.0160321593522513,0.348991694068006,0.634976146579743
7,"Rheinland-Pfalz",7133089,"Schloßböckelheim",406,207,199,0.509852216748768,390,202,188,0.517948717948718,0.0160321593522513,0.348991694068006,0.634976146579743
7,"Rheinland-Pfalz",7133090,"Schmittweiler",205,98,107,0.478048780487805,204,98,106,0.480392156862745,0.0160321593522513,0.348991694068006,0.634976146579743
7,"Rheinland-Pfalz",7133091,"Schöneberg",641,309,332,0.482059282371295,619,297,322,0.479806138933764,0.0160321593522513,0.348991694068006,0.634976146579743
7,"Rheinland-Pfalz",7133092,"Schweinschied",169,84,85,0.497041420118343,167,84,83,0.502994011976048,0.0160321593522513,0.348991694068006,0.634976146579743
7,"Rheinland-Pfalz",7133093,"Schweppenhausen",908,469,439,0.516519823788546,875,450,425,0.514285714285714,0.0160321593522513,0.348991694068006,0.634976146579743
7,"Rheinland-Pfalz",7133094,"Seesbach",558,272,286,0.487455197132616,570,285,285,0.5,0.0160321593522513,0.348991694068006,0.634976146579743
7,"Rheinland-Pfalz",7133095,"Seibersbach",1335,662,673,0.495880149812734,1351,661,690,0.489267209474463,0.0160321593522513,0.348991694068006,0.634976146579743
7,"Rheinland-Pfalz",7133096,"Simmertal",1840,931,909,0.505978260869565,1896,967,929,0.510021097046414,0.0160321593522513,0.348991694068006,0.634976146579743
7,"Rheinland-Pfalz",7133098,"Sommerloch",430,215,215,0.5,431,222,209,0.51508120649652,0.0160321593522513,0.348991694068006,0.634976146579743
7,"Rheinland-Pfalz",7133099,"Spabrücken",1140,557,583,0.48859649122807,1146,576,570,0.50261780104712,0.0160321593522513,0.348991694068006,0.634976146579743
7,"Rheinland-Pfalz",7133100,"Spall",171,94,77,0.549707602339181,167,89,78,0.532934131736527,0.0160321593522513,0.348991694068006,0.634976146579743
7,"Rheinland-Pfalz",7133101,"Sponheim",795,395,400,0.49685534591195,800,404,396,0.505,0.0160321593522513,0.348991694068006,0.634976146579743
7,"Rheinland-Pfalz",7133102,"Staudernheim",1424,688,736,0.48314606741573,1459,719,740,0.492803289924606,0.0160321593522513,0.348991694068006,0.634976146579743
7,"Rheinland-Pfalz",7133103,"Stromberg, Stadt",3184,1553,1631,0.487751256281407,3129,1547,1582,0.494407158836689,0.0160321593522513,0.348991694068006,0.634976146579743
7,"Rheinland-Pfalz",7133104,"Tiefenthal",128,62,66,0.484375,129,64,65,0.496124031007752,0.0160321593522513,0.348991694068006,0.634976146579743
7,"Rheinland-Pfalz",7133105,"Traisen",543,271,272,0.499079189686924,545,275,270,0.504587155963303,0.0160321593522513,0.348991694068006,0.634976146579743
7,"Rheinland-Pfalz",7133106,"Volxheim",1078,528,550,0.489795918367347,1076,539,537,0.50092936802974,0.0160321593522513,0.348991694068006,0.634976146579743
7,"Rheinland-Pfalz",7133107,"Waldböckelheim",2236,1119,1117,0.500447227191413,2255,1130,1125,0.501108647450111,0.0160321593522513,0.348991694068006,0.634976146579743
7,"Rheinland-Pfalz",7133108,"Waldlaubersheim",796,399,397,0.501256281407035,775,396,379,0.510967741935484,0.0160321593522513,0.348991694068006,0.634976146579743
7,"Rheinland-Pfalz",7133109,"Wallhausen",1592,766,826,0.481155778894472,1593,772,821,0.484620213433773,0.0160321593522513,0.348991694068006,0.634976146579743
7,"Rheinland-Pfalz",7133110,"Warmsroth",435,215,220,0.494252873563218,430,215,215,0.5,0.0160321593522513,0.348991694068006,0.634976146579743
7,"Rheinland-Pfalz",7133111,"Weiler bei Monzingen",471,229,242,0.48619957537155,456,229,227,0.50219298245614,0.0160321593522513,0.348991694068006,0.634976146579743
7,"Rheinland-Pfalz",7133112,"Weinsheim",1854,908,946,0.48975188781014,1841,908,933,0.493210211841391,0.0160321593522513,0.348991694068006,0.634976146579743
7,"Rheinland-Pfalz",7133113,"Weitersborn",235,121,114,0.514893617021277,258,137,121,0.531007751937985,0.0160321593522513,0.348991694068006,0.634976146579743
7,"Rheinland-Pfalz",7133114,"Windesheim",1782,906,876,0.508417508417508,1807,922,885,0.510237963475374,0.0160321593522513,0.348991694068006,0.634976146579743
7,"Rheinland-Pfalz",7133115,"Winterbach",479,243,236,0.507306889352818,466,230,236,0.493562231759657,0.0160321593522513,0.348991694068006,0.634976146579743
7,"Rheinland-Pfalz",7133116,"Winterburg",202,100,102,0.495049504950495,199,103,96,0.517587939698492,0.0160321593522513,0.348991694068006,0.634976146579743
7,"Rheinland-Pfalz",7133117,"Rüdesheim",2472,1201,1271,0.48584142394822,2378,1143,1235,0.480656013456686,0.0160321593522513,0.348991694068006,0.634976146579743
7,"Rheinland-Pfalz",7133201,"Bruschied",275,129,146,0.469090909090909,288,137,151,0.475694444444444,0.0160321593522513,0.348991694068006,0.634976146579743
7,"Rheinland-Pfalz",7133202,"Kellenbach",257,124,133,0.482490272373541,265,129,136,0.486792452830189,0.0160321593522513,0.348991694068006,0.634976146579743
7,"Rheinland-Pfalz",7133203,"Königsau",75,37,38,0.493333333333333,72,38,34,0.527777777777778,0.0160321593522513,0.348991694068006,0.634976146579743
7,"Rheinland-Pfalz",7133204,"Schneppenbach",256,121,135,0.47265625,264,127,137,0.481060606060606,0.0160321593522513,0.348991694068006,0.634976146579743
7,"Rheinland-Pfalz",7133205,"Schwarzerden",252,132,120,0.523809523809524,258,137,121,0.531007751937985,0.0160321593522513,0.348991694068006,0.634976146579743
7,"Rheinland-Pfalz",7133501,"Bad Sobernheim, Stadt",6499,3143,3356,0.483612863517464,6566,3240,3326,0.493451111787999,0.0160321593522513,0.348991694068006,0.634976146579743
7,"Rheinland-Pfalz",7134001,"Abentheuer",459,234,225,0.509803921568627,441,218,223,0.494331065759637,0.0160321593522513,0.348991694068006,0.634976146579743
7,"Rheinland-Pfalz",7134002,"Achtelsbach",429,210,219,0.48951048951049,432,220,212,0.509259259259259,0.0160321593522513,0.348991694068006,0.634976146579743
7,"Rheinland-Pfalz",7134003,"Allenbach",650,323,327,0.496923076923077,637,322,315,0.505494505494505,0.0160321593522513,0.348991694068006,0.634976146579743
7,"Rheinland-Pfalz",7134004,"Asbach",172,79,93,0.459302325581395,123,59,64,0.479674796747967,0.0160321593522513,0.348991694068006,0.634976146579743
7,"Rheinland-Pfalz",7134005,"Baumholder, Stadt",4359,2095,2264,0.480614819912824,4054,1934,2120,0.477059694129255,0.0160321593522513,0.348991694068006,0.634976146579743
7,"Rheinland-Pfalz",7134006,"Bergen",450,224,226,0.497777777777778,431,211,220,0.489559164733179,0.0160321593522513,0.348991694068006,0.634976146579743
7,"Rheinland-Pfalz",7134007,"Berglangenbach",450,226,224,0.502222222222222,449,234,215,0.521158129175947,0.0160321593522513,0.348991694068006,0.634976146579743
7,"Rheinland-Pfalz",7134008,"Berschweiler bei Baumholder",517,266,251,0.514506769825919,539,289,250,0.536178107606679,0.0160321593522513,0.348991694068006,0.634976146579743
7,"Rheinland-Pfalz",7134009,"Berschweiler bei Kirn",266,134,132,0.503759398496241,261,135,126,0.517241379310345,0.0160321593522513,0.348991694068006,0.634976146579743
7,"Rheinland-Pfalz",7134010,"Birkenfeld, Stadt",6676,3281,3395,0.491461953265428,6657,3405,3252,0.511491662911221,0.0160321593522513,0.348991694068006,0.634976146579743
7,"Rheinland-Pfalz",7134011,"Börfink",192,97,95,0.505208333333333,181,91,90,0.502762430939227,0.0160321593522513,0.348991694068006,0.634976146579743
7,"Rheinland-Pfalz",7134012,"Bollenbach",141,67,74,0.475177304964539,151,73,78,0.483443708609272,0.0160321593522513,0.348991694068006,0.634976146579743
7,"Rheinland-Pfalz",7134013,"Breitenthal",311,151,160,0.485530546623794,322,161,161,0.5,0.0160321593522513,0.348991694068006,0.634976146579743
7,"Rheinland-Pfalz",7134014,"Bruchweiler",510,245,265,0.480392156862745,509,248,261,0.487229862475442,0.0160321593522513,0.348991694068006,0.634976146579743
7,"Rheinland-Pfalz",7134015,"Brücken",1231,615,616,0.499593826157595,1227,618,609,0.503667481662592,0.0160321593522513,0.348991694068006,0.634976146579743
7,"Rheinland-Pfalz",7134016,"Buhlenberg",478,237,241,0.49581589958159,484,242,242,0.5,0.0160321593522513,0.348991694068006,0.634976146579743
7,"Rheinland-Pfalz",7134017,"Bundenbach",936,448,488,0.478632478632479,936,460,476,0.491452991452991,0.0160321593522513,0.348991694068006,0.634976146579743
7,"Rheinland-Pfalz",7134018,"Dambach",154,77,77,0.5,150,74,76,0.493333333333333,0.0160321593522513,0.348991694068006,0.634976146579743
7,"Rheinland-Pfalz",7134019,"Dickesbach",433,223,210,0.515011547344111,430,219,211,0.509302325581395,0.0160321593522513,0.348991694068006,0.634976146579743
7,"Rheinland-Pfalz",7134020,"Dienstweiler",294,147,147,0.5,295,145,150,0.491525423728814,0.0160321593522513,0.348991694068006,0.634976146579743
7,"Rheinland-Pfalz",7134021,"Eckersweiler",147,77,70,0.523809523809524,136,73,63,0.536764705882353,0.0160321593522513,0.348991694068006,0.634976146579743
7,"Rheinland-Pfalz",7134022,"Elchweiler",92,50,42,0.543478260869565,94,50,44,0.531914893617021,0.0160321593522513,0.348991694068006,0.634976146579743
7,"Rheinland-Pfalz",7134023,"Ellenberg",98,46,52,0.469387755102041,95,44,51,0.463157894736842,0.0160321593522513,0.348991694068006,0.634976146579743
7,"Rheinland-Pfalz",7134024,"Ellweiler",301,147,154,0.488372093023256,299,142,157,0.474916387959866,0.0160321593522513,0.348991694068006,0.634976146579743
7,"Rheinland-Pfalz",7134025,"Fischbach",918,459,459,0.5,832,411,421,0.493990384615385,0.0160321593522513,0.348991694068006,0.634976146579743
7,"Rheinland-Pfalz",7134026,"Fohren-Linden",342,178,164,0.52046783625731,345,176,169,0.510144927536232,0.0160321593522513,0.348991694068006,0.634976146579743
7,"Rheinland-Pfalz",7134027,"Frauenberg",406,202,204,0.497536945812808,400,197,203,0.4925,0.0160321593522513,0.348991694068006,0.634976146579743
7,"Rheinland-Pfalz",7134028,"Gerach",239,128,111,0.535564853556485,235,121,114,0.514893617021277,0.0160321593522513,0.348991694068006,0.634976146579743
7,"Rheinland-Pfalz",7134029,"Gimbweiler",418,191,227,0.456937799043062,414,185,229,0.446859903381642,0.0160321593522513,0.348991694068006,0.634976146579743
7,"Rheinland-Pfalz",7134030,"Gösenroth",263,120,143,0.456273764258555,260,120,140,0.461538461538462,0.0160321593522513,0.348991694068006,0.634976146579743
7,"Rheinland-Pfalz",7134031,"Gollenberg",136,64,72,0.470588235294118,133,61,72,0.458646616541353,0.0160321593522513,0.348991694068006,0.634976146579743
7,"Rheinland-Pfalz",7134032,"Griebelschied",180,98,82,0.544444444444444,191,100,91,0.523560209424084,0.0160321593522513,0.348991694068006,0.634976146579743
7,"Rheinland-Pfalz",7134033,"Hahnweiler",208,104,104,0.5,219,107,112,0.488584474885845,0.0160321593522513,0.348991694068006,0.634976146579743
7,"Rheinland-Pfalz",7134034,"Hattgenstein",262,124,138,0.473282442748092,243,110,133,0.452674897119342,0.0160321593522513,0.348991694068006,0.634976146579743
7,"Rheinland-Pfalz",7134035,"Hausen",190,94,96,0.494736842105263,182,93,89,0.510989010989011,0.0160321593522513,0.348991694068006,0.634976146579743
7,"Rheinland-Pfalz",7134036,"Heimbach",1090,531,559,0.487155963302752,1071,509,562,0.475256769374416,0.0160321593522513,0.348991694068006,0.634976146579743
7,"Rheinland-Pfalz",7134037,"Hellertshausen",204,99,105,0.485294117647059,204,101,103,0.495098039215686,0.0160321593522513,0.348991694068006,0.634976146579743
7,"Rheinland-Pfalz",7134038,"Herborn",537,268,269,0.499068901303538,482,240,242,0.49792531120332,0.0160321593522513,0.348991694068006,0.634976146579743
7,"Rheinland-Pfalz",7134039,"Herrstein",853,415,438,0.48651817116061,774,371,403,0.479328165374677,0.0160321593522513,0.348991694068006,0.634976146579743
7,"Rheinland-Pfalz",7134040,"Hettenrodt",704,350,354,0.497159090909091,697,350,347,0.502152080344333,0.0160321593522513,0.348991694068006,0.634976146579743
7,"Rheinland-Pfalz",7134041,"Hintertiefenbach",376,188,188,0.5,376,188,188,0.5,0.0160321593522513,0.348991694068006,0.634976146579743
7,"Rheinland-Pfalz",7134042,"Hoppstädten-Weiersbach",2917,1506,1411,0.516283853273912,2699,1318,1381,0.48832901074472,0.0160321593522513,0.348991694068006,0.634976146579743
7,"Rheinland-Pfalz",7134043,"Horbruch",364,182,182,0.5,364,186,178,0.510989010989011,0.0160321593522513,0.348991694068006,0.634976146579743
7,"Rheinland-Pfalz",7134044,"Hottenbach",614,301,313,0.490228013029316,608,304,304,0.5,0.0160321593522513,0.348991694068006,0.634976146579743
7,"Rheinland-Pfalz",7134045,"Idar-Oberstein, Stadt",28878,14007,14871,0.485040515271141,30100,14706,15394,0.488571428571429,0.0160321593522513,0.348991694068006,0.634976146579743
7,"Rheinland-Pfalz",7134046,"Kempfeld",838,424,414,0.505966587112172,805,412,393,0.511801242236025,0.0160321593522513,0.348991694068006,0.634976146579743
7,"Rheinland-Pfalz",7134047,"Kirschweiler",1108,533,575,0.481046931407942,1086,514,572,0.47329650092081,0.0160321593522513,0.348991694068006,0.634976146579743
7,"Rheinland-Pfalz",7134048,"Kronweiler",328,167,161,0.509146341463415,330,172,158,0.521212121212121,0.0160321593522513,0.348991694068006,0.634976146579743
7,"Rheinland-Pfalz",7134049,"Krummenau",171,88,83,0.514619883040936,167,83,84,0.497005988023952,0.0160321593522513,0.348991694068006,0.634976146579743
7,"Rheinland-Pfalz",7134050,"Leisel",577,281,296,0.487001733102253,567,280,287,0.493827160493827,0.0160321593522513,0.348991694068006,0.634976146579743
7,"Rheinland-Pfalz",7134051,"Leitzweiler",107,62,45,0.579439252336449,106,59,47,0.556603773584906,0.0160321593522513,0.348991694068006,0.634976146579743
7,"Rheinland-Pfalz",7134052,"Mackenrodt",426,208,218,0.488262910798122,438,214,224,0.488584474885845,0.0160321593522513,0.348991694068006,0.634976146579743
7,"Rheinland-Pfalz",7134053,"Meckenbach",115,54,61,0.469565217391304,109,46,63,0.422018348623853,0.0160321593522513,0.348991694068006,0.634976146579743
7,"Rheinland-Pfalz",7134054,"Mettweiler",256,129,127,0.50390625,252,126,126,0.5,0.0160321593522513,0.348991694068006,0.634976146579743
7,"Rheinland-Pfalz",7134055,"Mittelreidenbach",780,399,381,0.511538461538461,755,392,363,0.519205298013245,0.0160321593522513,0.348991694068006,0.634976146579743
7,"Rheinland-Pfalz",7134056,"Mörschied",805,398,407,0.494409937888199,836,406,430,0.485645933014354,0.0160321593522513,0.348991694068006,0.634976146579743
7,"Rheinland-Pfalz",7134057,"Niederbrombach",483,235,248,0.486542443064182,460,224,236,0.48695652173913,0.0160321593522513,0.348991694068006,0.634976146579743
7,"Rheinland-Pfalz",7134058,"Niederhambach",330,168,162,0.509090909090909,319,164,155,0.5141065830721,0.0160321593522513,0.348991694068006,0.634976146579743
7,"Rheinland-Pfalz",7134059,"Niederhosenbach",315,166,149,0.526984126984127,311,166,145,0.533762057877814,0.0160321593522513,0.348991694068006,0.634976146579743
7,"Rheinland-Pfalz",7134060,"Niederwörresbach",902,422,480,0.467849223946785,912,424,488,0.464912280701754,0.0160321593522513,0.348991694068006,0.634976146579743
7,"Rheinland-Pfalz",7134061,"Nohen",392,201,191,0.512755102040816,402,208,194,0.517412935323383,0.0160321593522513,0.348991694068006,0.634976146579743
7,"Rheinland-Pfalz",7134062,"Oberbrombach",444,216,228,0.486486486486487,428,203,225,0.474299065420561,0.0160321593522513,0.348991694068006,0.634976146579743
7,"Rheinland-Pfalz",7134063,"Oberhambach",294,161,133,0.547619047619048,288,160,128,0.555555555555556,0.0160321593522513,0.348991694068006,0.634976146579743
7,"Rheinland-Pfalz",7134064,"Oberhosenbach",152,77,75,0.506578947368421,153,78,75,0.509803921568627,0.0160321593522513,0.348991694068006,0.634976146579743
7,"Rheinland-Pfalz",7134065,"Oberkirn",323,159,164,0.492260061919505,324,162,162,0.5,0.0160321593522513,0.348991694068006,0.634976146579743
7,"Rheinland-Pfalz",7134066,"Oberreidenbach",626,297,329,0.47444089456869,601,285,316,0.474209650582363,0.0160321593522513,0.348991694068006,0.634976146579743
7,"Rheinland-Pfalz",7134067,"Oberwörresbach",145,71,74,0.489655172413793,146,73,73,0.5,0.0160321593522513,0.348991694068006,0.634976146579743
7,"Rheinland-Pfalz",7134068,"Reichenbach",603,295,308,0.48922056384743,622,300,322,0.482315112540193,0.0160321593522513,0.348991694068006,0.634976146579743
7,"Rheinland-Pfalz",7134069,"Rhaunen",2187,1048,1139,0.479195244627343,2232,1084,1148,0.485663082437276,0.0160321593522513,0.348991694068006,0.634976146579743
7,"Rheinland-Pfalz",7134070,"Rimsberg",130,64,66,0.492307692307692,123,60,63,0.48780487804878,0.0160321593522513,0.348991694068006,0.634976146579743
7,"Rheinland-Pfalz",7134071,"Rinzenberg",308,157,151,0.50974025974026,298,156,142,0.523489932885906,0.0160321593522513,0.348991694068006,0.634976146579743
7,"Rheinland-Pfalz",7134072,"Rötsweiler-Nockenthal",477,235,242,0.492662473794549,465,235,230,0.505376344086022,0.0160321593522513,0.348991694068006,0.634976146579743
7,"Rheinland-Pfalz",7134073,"Rohrbach",207,105,102,0.507246376811594,193,93,100,0.481865284974093,0.0160321593522513,0.348991694068006,0.634976146579743
7,"Rheinland-Pfalz",7134074,"Rückweiler",410,198,212,0.482926829268293,402,198,204,0.492537313432836,0.0160321593522513,0.348991694068006,0.634976146579743
7,"Rheinland-Pfalz",7134075,"Ruschberg",822,423,399,0.514598540145985,810,413,397,0.509876543209877,0.0160321593522513,0.348991694068006,0.634976146579743
7,"Rheinland-Pfalz",7134076,"Schauren",520,257,263,0.494230769230769,529,262,267,0.495274102079395,0.0160321593522513,0.348991694068006,0.634976146579743
7,"Rheinland-Pfalz",7134077,"Schmidthachenbach",385,194,191,0.503896103896104,374,190,184,0.508021390374332,0.0160321593522513,0.348991694068006,0.634976146579743
7,"Rheinland-Pfalz",7134078,"Schmißberg",208,101,107,0.485576923076923,219,108,111,0.493150684931507,0.0160321593522513,0.348991694068006,0.634976146579743
7,"Rheinland-Pfalz",7134079,"Schwerbach",51,25,26,0.490196078431373,50,24,26,0.48,0.0160321593522513,0.348991694068006,0.634976146579743
7,"Rheinland-Pfalz",7134080,"Schwollen",471,239,232,0.507430997876858,477,237,240,0.49685534591195,0.0160321593522513,0.348991694068006,0.634976146579743
7,"Rheinland-Pfalz",7134081,"Sensweiler",445,223,222,0.501123595505618,443,228,215,0.514672686230248,0.0160321593522513,0.348991694068006,0.634976146579743
7,"Rheinland-Pfalz",7134082,"Sien",517,243,274,0.470019342359768,526,251,275,0.477186311787072,0.0160321593522513,0.348991694068006,0.634976146579743
7,"Rheinland-Pfalz",7134083,"Sienhachenbach",211,109,102,0.516587677725118,205,108,97,0.526829268292683,0.0160321593522513,0.348991694068006,0.634976146579743
7,"Rheinland-Pfalz",7134084,"Siesbach",380,185,195,0.486842105263158,378,186,192,0.492063492063492,0.0160321593522513,0.348991694068006,0.634976146579743
7,"Rheinland-Pfalz",7134085,"Sonnenberg-Winnenberg",477,234,243,0.490566037735849,482,234,248,0.485477178423237,0.0160321593522513,0.348991694068006,0.634976146579743
7,"Rheinland-Pfalz",7134086,"Sonnschied",124,63,61,0.508064516129032,127,62,65,0.488188976377953,0.0160321593522513,0.348991694068006,0.634976146579743
7,"Rheinland-Pfalz",7134087,"Stipshausen",891,440,451,0.493827160493827,899,452,447,0.502780867630701,0.0160321593522513,0.348991694068006,0.634976146579743
7,"Rheinland-Pfalz",7134088,"Sulzbach",308,164,144,0.532467532467532,305,166,139,0.544262295081967,0.0160321593522513,0.348991694068006,0.634976146579743
7,"Rheinland-Pfalz",7134089,"Veitsrodt",657,336,321,0.511415525114155,660,347,313,0.525757575757576,0.0160321593522513,0.348991694068006,0.634976146579743
7,"Rheinland-Pfalz",7134090,"Vollmersbach",502,228,274,0.454183266932271,494,224,270,0.453441295546559,0.0160321593522513,0.348991694068006,0.634976146579743
7,"Rheinland-Pfalz",7134091,"Weiden",103,54,49,0.524271844660194,87,45,42,0.517241379310345,0.0160321593522513,0.348991694068006,0.634976146579743
7,"Rheinland-Pfalz",7134092,"Weitersbach",80,38,42,0.475,78,35,43,0.448717948717949,0.0160321593522513,0.348991694068006,0.634976146579743
7,"Rheinland-Pfalz",7134093,"Wickenrodt",165,82,83,0.496969696969697,169,86,83,0.50887573964497,0.0160321593522513,0.348991694068006,0.634976146579743
7,"Rheinland-Pfalz",7134094,"Wilzenberg-Hußweiler",319,168,151,0.526645768025078,299,158,141,0.528428093645485,0.0160321593522513,0.348991694068006,0.634976146579743
7,"Rheinland-Pfalz",7134095,"Wirschweiler",335,163,172,0.486567164179104,328,160,168,0.48780487804878,0.0160321593522513,0.348991694068006,0.634976146579743
7,"Rheinland-Pfalz",7134502,"Langweiler",268,136,132,0.507462686567164,261,136,125,0.521072796934866,0.0160321593522513,0.348991694068006,0.634976146579743
7,"Rheinland-Pfalz",7135001,"Alf",871,405,466,0.464982778415614,866,407,459,0.469976905311778,0.0160321593522513,0.348991694068006,0.634976146579743
7,"Rheinland-Pfalz",7135002,"Alflen",845,426,419,0.50414201183432,838,426,412,0.508353221957041,0.0160321593522513,0.348991694068006,0.634976146579743
7,"Rheinland-Pfalz",7135003,"Altlay",476,249,227,0.523109243697479,475,253,222,0.532631578947368,0.0160321593522513,0.348991694068006,0.634976146579743
7,"Rheinland-Pfalz",7135004,"Altstrimmig",341,164,177,0.480938416422287,344,166,178,0.482558139534884,0.0160321593522513,0.348991694068006,0.634976146579743
7,"Rheinland-Pfalz",7135005,"Auderath",605,300,305,0.495867768595041,635,319,316,0.502362204724409,0.0160321593522513,0.348991694068006,0.634976146579743
7,"Rheinland-Pfalz",7135007,"Beilstein",134,71,63,0.529850746268657,127,63,64,0.496062992125984,0.0160321593522513,0.348991694068006,0.634976146579743
7,"Rheinland-Pfalz",7135008,"Beuren",454,220,234,0.484581497797357,453,214,239,0.472406181015453,0.0160321593522513,0.348991694068006,0.634976146579743
7,"Rheinland-Pfalz",7135009,"Binningen",704,364,340,0.517045454545455,685,358,327,0.522627737226277,0.0160321593522513,0.348991694068006,0.634976146579743
7,"Rheinland-Pfalz",7135010,"Blankenrath",1726,835,891,0.4837775202781,1682,815,867,0.484542211652794,0.0160321593522513,0.348991694068006,0.634976146579743
7,"Rheinland-Pfalz",7135011,"Brachtendorf",268,139,129,0.51865671641791,265,146,119,0.550943396226415,0.0160321593522513,0.348991694068006,0.634976146579743
7,"Rheinland-Pfalz",7135012,"Bremm",808,395,413,0.488861386138614,809,394,415,0.487021013597033,0.0160321593522513,0.348991694068006,0.634976146579743
7,"Rheinland-Pfalz",7135013,"Briedel",1001,507,494,0.506493506493506,992,506,486,0.51008064516129,0.0160321593522513,0.348991694068006,0.634976146579743
7,"Rheinland-Pfalz",7135014,"Brieden",138,70,68,0.507246376811594,140,71,69,0.507142857142857,0.0160321593522513,0.348991694068006,0.634976146579743
7,"Rheinland-Pfalz",7135015,"Briedern",335,174,161,0.519402985074627,321,163,158,0.507788161993769,0.0160321593522513,0.348991694068006,0.634976146579743
7,"Rheinland-Pfalz",7135016,"Brohl",386,192,194,0.49740932642487,362,179,183,0.494475138121547,0.0160321593522513,0.348991694068006,0.634976146579743
7,"Rheinland-Pfalz",7135017,"Bruttig-Fankel",1089,536,553,0.492194674012856,1132,565,567,0.499116607773852,0.0160321593522513,0.348991694068006,0.634976146579743
7,"Rheinland-Pfalz",7135018,"Büchel",1143,577,566,0.504811898512686,1131,562,569,0.496905393457118,0.0160321593522513,0.348991694068006,0.634976146579743
7,"Rheinland-Pfalz",7135019,"Bullay",1500,714,786,0.476,1509,733,776,0.485752153744201,0.0160321593522513,0.348991694068006,0.634976146579743
7,"Rheinland-Pfalz",7135020,"Cochem, Stadt",5234,2629,2605,0.502292701566679,4942,2492,2450,0.504249291784703,0.0160321593522513,0.348991694068006,0.634976146579743
7,"Rheinland-Pfalz",7135021,"Dohr",667,342,325,0.512743628185907,666,340,326,0.510510510510511,0.0160321593522513,0.348991694068006,0.634976146579743
7,"Rheinland-Pfalz",7135022,"Dünfus",305,151,154,0.495081967213115,294,147,147,0.5,0.0160321593522513,0.348991694068006,0.634976146579743
7,"Rheinland-Pfalz",7135023,"Düngenheim",1307,705,602,0.539403213465953,1276,699,577,0.547805642633229,0.0160321593522513,0.348991694068006,0.634976146579743
7,"Rheinland-Pfalz",7135024,"Ediger-Eller",1046,547,499,0.522944550669216,1023,530,493,0.518084066471163,0.0160321593522513,0.348991694068006,0.634976146579743
7,"Rheinland-Pfalz",7135025,"Ellenz-Poltersdorf",867,425,442,0.490196078431373,845,417,428,0.493491124260355,0.0160321593522513,0.348991694068006,0.634976146579743
7,"Rheinland-Pfalz",7135026,"Eppenberg",238,122,116,0.512605042016807,234,112,122,0.478632478632479,0.0160321593522513,0.348991694068006,0.634976146579743
7,"Rheinland-Pfalz",7135027,"Ernst",545,276,269,0.506422018348624,542,266,276,0.490774907749078,0.0160321593522513,0.348991694068006,0.634976146579743
7,"Rheinland-Pfalz",7135028,"Eulgem",222,121,101,0.545045045045045,220,124,96,0.563636363636364,0.0160321593522513,0.348991694068006,0.634976146579743
7,"Rheinland-Pfalz",7135029,"Faid",1093,557,536,0.5096065873742,1100,558,542,0.507272727272727,0.0160321593522513,0.348991694068006,0.634976146579743
7,"Rheinland-Pfalz",7135030,"Filz",90,47,43,0.522222222222222,86,44,42,0.511627906976744,0.0160321593522513,0.348991694068006,0.634976146579743
7,"Rheinland-Pfalz",7135031,"Forst (Eifel)",377,182,195,0.482758620689655,379,181,198,0.477572559366755,0.0160321593522513,0.348991694068006,0.634976146579743
7,"Rheinland-Pfalz",7135032,"Forst (Hunsrück)",67,37,30,0.552238805970149,60,33,27,0.55,0.0160321593522513,0.348991694068006,0.634976146579743
7,"Rheinland-Pfalz",7135033,"Gamlen",539,276,263,0.512059369202226,533,271,262,0.50844277673546,0.0160321593522513,0.348991694068006,0.634976146579743
7,"Rheinland-Pfalz",7135034,"Gevenich",638,324,314,0.507836990595611,635,317,318,0.499212598425197,0.0160321593522513,0.348991694068006,0.634976146579743
7,"Rheinland-Pfalz",7135035,"Gillenbeuren",246,126,120,0.51219512195122,233,113,120,0.484978540772532,0.0160321593522513,0.348991694068006,0.634976146579743
7,"Rheinland-Pfalz",7135036,"Greimersburg",692,332,360,0.479768786127168,690,328,362,0.47536231884058,0.0160321593522513,0.348991694068006,0.634976146579743
7,"Rheinland-Pfalz",7135037,"Grenderich",392,193,199,0.49234693877551,398,195,203,0.489949748743719,0.0160321593522513,0.348991694068006,0.634976146579743
7,"Rheinland-Pfalz",7135038,"Hambuch",742,380,362,0.512129380053908,725,366,359,0.504827586206897,0.0160321593522513,0.348991694068006,0.634976146579743
7,"Rheinland-Pfalz",7135039,"Haserich",211,104,107,0.492890995260663,213,113,100,0.530516431924883,0.0160321593522513,0.348991694068006,0.634976146579743
7,"Rheinland-Pfalz",7135040,"Hauroth",306,152,154,0.496732026143791,308,155,153,0.503246753246753,0.0160321593522513,0.348991694068006,0.634976146579743
7,"Rheinland-Pfalz",7135041,"Hesweiler",129,69,60,0.534883720930233,125,66,59,0.528,0.0160321593522513,0.348991694068006,0.634976146579743
7,"Rheinland-Pfalz",7135042,"Illerich",718,355,363,0.494428969359331,714,349,365,0.488795518207283,0.0160321593522513,0.348991694068006,0.634976146579743
7,"Rheinland-Pfalz",7135043,"Kaifenheim",816,405,411,0.496323529411765,817,398,419,0.487148102815177,0.0160321593522513,0.348991694068006,0.634976146579743
7,"Rheinland-Pfalz",7135044,"Kail",296,156,140,0.527027027027027,287,145,142,0.505226480836237,0.0160321593522513,0.348991694068006,0.634976146579743
7,"Rheinland-Pfalz",7135045,"Kaisersesch, Stadt",3022,1450,1572,0.479814692256784,2968,1412,1556,0.475741239892183,0.0160321593522513,0.348991694068006,0.634976146579743
7,"Rheinland-Pfalz",7135046,"Kalenborn",217,113,104,0.52073732718894,213,112,101,0.525821596244131,0.0160321593522513,0.348991694068006,0.634976146579743
7,"Rheinland-Pfalz",7135048,"Kliding",227,116,111,0.511013215859031,229,118,111,0.51528384279476,0.0160321593522513,0.348991694068006,0.634976146579743
7,"Rheinland-Pfalz",7135049,"Klotten",1286,625,661,0.486003110419907,1278,630,648,0.492957746478873,0.0160321593522513,0.348991694068006,0.634976146579743
7,"Rheinland-Pfalz",7135050,"Lahr",178,91,87,0.51123595505618,170,83,87,0.488235294117647,0.0160321593522513,0.348991694068006,0.634976146579743
7,"Rheinland-Pfalz",7135051,"Landkern",930,461,469,0.495698924731183,914,452,462,0.4945295404814,0.0160321593522513,0.348991694068006,0.634976146579743
7,"Rheinland-Pfalz",7135052,"Laubach",678,320,358,0.471976401179941,681,314,367,0.461086637298091,0.0160321593522513,0.348991694068006,0.634976146579743
7,"Rheinland-Pfalz",7135053,"Lieg",398,204,194,0.512562814070352,390,196,194,0.502564102564103,0.0160321593522513,0.348991694068006,0.634976146579743
7,"Rheinland-Pfalz",7135054,"Liesenich",315,146,169,0.463492063492064,300,138,162,0.46,0.0160321593522513,0.348991694068006,0.634976146579743
7,"Rheinland-Pfalz",7135056,"Lütz",332,172,160,0.518072289156627,369,193,176,0.523035230352303,0.0160321593522513,0.348991694068006,0.634976146579743
7,"Rheinland-Pfalz",7135057,"Lutzerath",1518,736,782,0.484848484848485,1455,713,742,0.490034364261168,0.0160321593522513,0.348991694068006,0.634976146579743
7,"Rheinland-Pfalz",7135058,"Masburg",1099,558,541,0.507734303912648,1071,534,537,0.49859943977591,0.0160321593522513,0.348991694068006,0.634976146579743
7,"Rheinland-Pfalz",7135060,"Mesenich",309,154,155,0.498381877022654,298,145,153,0.486577181208054,0.0160321593522513,0.348991694068006,0.634976146579743
7,"Rheinland-Pfalz",7135061,"Mittelstrimmig",415,216,199,0.520481927710843,414,215,199,0.519323671497585,0.0160321593522513,0.348991694068006,0.634976146579743
7,"Rheinland-Pfalz",7135062,"Möntenich",136,63,73,0.463235294117647,135,64,71,0.474074074074074,0.0160321593522513,0.348991694068006,0.634976146579743
7,"Rheinland-Pfalz",7135063,"Mörsdorf",626,303,323,0.484025559105431,623,307,316,0.492776886035313,0.0160321593522513,0.348991694068006,0.634976146579743
7,"Rheinland-Pfalz",7135064,"Moritzheim",137,71,66,0.518248175182482,117,62,55,0.52991452991453,0.0160321593522513,0.348991694068006,0.634976146579743
7,"Rheinland-Pfalz",7135065,"Moselkern",591,299,292,0.505922165820643,593,300,293,0.505902192242833,0.0160321593522513,0.348991694068006,0.634976146579743
7,"Rheinland-Pfalz",7135066,"Müden (Mosel)",672,326,346,0.485119047619048,648,314,334,0.484567901234568,0.0160321593522513,0.348991694068006,0.634976146579743
7,"Rheinland-Pfalz",7135067,"Müllenbach",656,331,325,0.504573170731707,664,330,334,0.496987951807229,0.0160321593522513,0.348991694068006,0.634976146579743
7,"Rheinland-Pfalz",7135068,"Neef",464,225,239,0.484913793103448,465,214,251,0.460215053763441,0.0160321593522513,0.348991694068006,0.634976146579743
7,"Rheinland-Pfalz",7135069,"Nehren",112,58,54,0.517857142857143,96,50,46,0.520833333333333,0.0160321593522513,0.348991694068006,0.634976146579743
7,"Rheinland-Pfalz",7135070,"Panzweiler",268,144,124,0.537313432835821,264,141,123,0.534090909090909,0.0160321593522513,0.348991694068006,0.634976146579743
7,"Rheinland-Pfalz",7135071,"Peterswald-Löffelscheid",748,373,375,0.498663101604278,755,378,377,0.500662251655629,0.0160321593522513,0.348991694068006,0.634976146579743
7,"Rheinland-Pfalz",7135072,"Pommern",443,221,222,0.498871331828442,444,229,215,0.515765765765766,0.0160321593522513,0.348991694068006,0.634976146579743
7,"Rheinland-Pfalz",7135073,"Pünderich",892,439,453,0.492152466367713,866,428,438,0.494226327944573,0.0160321593522513,0.348991694068006,0.634976146579743
7,"Rheinland-Pfalz",7135074,"Reidenhausen",189,97,92,0.513227513227513,193,98,95,0.507772020725389,0.0160321593522513,0.348991694068006,0.634976146579743
7,"Rheinland-Pfalz",7135075,"Roes",509,254,255,0.49901768172888,509,257,252,0.504911591355599,0.0160321593522513,0.348991694068006,0.634976146579743
7,"Rheinland-Pfalz",7135076,"Sankt Aldegund",642,307,335,0.478193146417445,641,305,336,0.47581903276131,0.0160321593522513,0.348991694068006,0.634976146579743
7,"Rheinland-Pfalz",7135077,"Schauren",407,215,192,0.528255528255528,411,217,194,0.527980535279805,0.0160321593522513,0.348991694068006,0.634976146579743
7,"Rheinland-Pfalz",7135078,"Schmitt",126,64,62,0.507936507936508,133,69,64,0.518796992481203,0.0160321593522513,0.348991694068006,0.634976146579743
7,"Rheinland-Pfalz",7135079,"Senheim",589,297,292,0.504244482173175,578,296,282,0.512110726643599,0.0160321593522513,0.348991694068006,0.634976146579743
7,"Rheinland-Pfalz",7135080,"Sosberg",174,93,81,0.53448275862069,171,92,79,0.538011695906433,0.0160321593522513,0.348991694068006,0.634976146579743
7,"Rheinland-Pfalz",7135081,"Tellig",278,141,137,0.507194244604317,270,136,134,0.503703703703704,0.0160321593522513,0.348991694068006,0.634976146579743
7,"Rheinland-Pfalz",7135082,"Treis-Karden",2262,1076,1186,0.475685234305924,2182,1043,1139,0.478001833180568,0.0160321593522513,0.348991694068006,0.634976146579743
7,"Rheinland-Pfalz",7135083,"Ulmen, Stadt",3328,1627,1701,0.488882211538462,3268,1573,1695,0.481334149326805,0.0160321593522513,0.348991694068006,0.634976146579743
7,"Rheinland-Pfalz",7135084,"Urmersbach",428,211,217,0.492990654205608,429,215,214,0.501165501165501,0.0160321593522513,0.348991694068006,0.634976146579743
7,"Rheinland-Pfalz",7135085,"Urschmitt",208,104,104,0.5,250,143,107,0.572,0.0160321593522513,0.348991694068006,0.634976146579743
7,"Rheinland-Pfalz",7135086,"Valwig",434,208,226,0.47926267281106,443,213,230,0.480812641083521,0.0160321593522513,0.348991694068006,0.634976146579743
7,"Rheinland-Pfalz",7135087,"Wagenhausen",59,28,31,0.474576271186441,61,29,32,0.475409836065574,0.0160321593522513,0.348991694068006,0.634976146579743
7,"Rheinland-Pfalz",7135088,"Walhausen",222,119,103,0.536036036036036,203,113,90,0.556650246305419,0.0160321593522513,0.348991694068006,0.634976146579743
7,"Rheinland-Pfalz",7135089,"Weiler",319,162,157,0.507836990595611,308,154,154,0.5,0.0160321593522513,0.348991694068006,0.634976146579743
7,"Rheinland-Pfalz",7135090,"Wirfus",191,110,81,0.575916230366492,182,103,79,0.565934065934066,0.0160321593522513,0.348991694068006,0.634976146579743
7,"Rheinland-Pfalz",7135091,"Wollmerath",205,111,94,0.541463414634146,202,110,92,0.544554455445545,0.0160321593522513,0.348991694068006,0.634976146579743
7,"Rheinland-Pfalz",7135092,"Zell (Mosel), Stadt",4150,2057,2093,0.49566265060241,4103,2023,2080,0.493053863027053,0.0160321593522513,0.348991694068006,0.634976146579743
7,"Rheinland-Pfalz",7135093,"Zettingen",262,134,128,0.511450381679389,260,133,127,0.511538461538461,0.0160321593522513,0.348991694068006,0.634976146579743
7,"Rheinland-Pfalz",7135094,"Zilshausen",289,140,149,0.484429065743945,288,140,148,0.486111111111111,0.0160321593522513,0.348991694068006,0.634976146579743
7,"Rheinland-Pfalz",7135501,"Bad Bertrich",1009,470,539,0.465807730426165,974,445,529,0.456878850102669,0.0160321593522513,0.348991694068006,0.634976146579743
7,"Rheinland-Pfalz",7135502,"Leienkaul",334,166,168,0.497005988023952,359,184,175,0.512534818941504,0.0160321593522513,0.348991694068006,0.634976146579743
7,"Rheinland-Pfalz",7137001,"Acht",79,43,36,0.544303797468354,74,42,32,0.567567567567568,0.0160321593522513,0.348991694068006,0.634976146579743
7,"Rheinland-Pfalz",7137003,"Andernach, Stadt",29051,13984,15067,0.481360366252453,29452,14446,15006,0.490493005568382,0.0160321593522513,0.348991694068006,0.634976146579743
7,"Rheinland-Pfalz",7137004,"Anschau",290,145,145,0.5,298,151,147,0.506711409395973,0.0160321593522513,0.348991694068006,0.634976146579743
7,"Rheinland-Pfalz",7137006,"Arft",269,122,147,0.453531598513011,260,116,144,0.446153846153846,0.0160321593522513,0.348991694068006,0.634976146579743
7,"Rheinland-Pfalz",7137007,"Baar",774,393,381,0.507751937984496,788,398,390,0.50507614213198,0.0160321593522513,0.348991694068006,0.634976146579743
7,"Rheinland-Pfalz",7137008,"Bell",1381,686,695,0.496741491672701,1373,682,691,0.496722505462491,0.0160321593522513,0.348991694068006,0.634976146579743
7,"Rheinland-Pfalz",7137011,"Bermel",369,180,189,0.48780487804878,371,181,190,0.487870619946092,0.0160321593522513,0.348991694068006,0.634976146579743
7,"Rheinland-Pfalz",7137014,"Boos",622,311,311,0.5,614,312,302,0.50814332247557,0.0160321593522513,0.348991694068006,0.634976146579743
7,"Rheinland-Pfalz",7137019,"Ditscheid",268,139,129,0.51865671641791,267,140,127,0.524344569288389,0.0160321593522513,0.348991694068006,0.634976146579743
7,"Rheinland-Pfalz",7137023,"Einig",145,73,72,0.503448275862069,141,73,68,0.517730496453901,0.0160321593522513,0.348991694068006,0.634976146579743
7,"Rheinland-Pfalz",7137025,"Ettringen",2757,1384,1373,0.501994922016685,2723,1369,1354,0.502754315093647,0.0160321593522513,0.348991694068006,0.634976146579743
7,"Rheinland-Pfalz",7137027,"Gappenach",318,156,162,0.490566037735849,307,148,159,0.482084690553746,0.0160321593522513,0.348991694068006,0.634976146579743
7,"Rheinland-Pfalz",7137029,"Gering",403,214,189,0.531017369727047,410,215,195,0.524390243902439,0.0160321593522513,0.348991694068006,0.634976146579743
7,"Rheinland-Pfalz",7137030,"Gierschnach",287,135,152,0.470383275261324,276,129,147,0.467391304347826,0.0160321593522513,0.348991694068006,0.634976146579743
7,"Rheinland-Pfalz",7137034,"Hausten",402,199,203,0.495024875621891,378,189,189,0.5,0.0160321593522513,0.348991694068006,0.634976146579743
7,"Rheinland-Pfalz",7137035,"Herresbach",480,242,238,0.504166666666667,466,241,225,0.517167381974249,0.0160321593522513,0.348991694068006,0.634976146579743
7,"Rheinland-Pfalz",7137036,"Hirten",263,129,134,0.490494296577947,258,128,130,0.496124031007752,0.0160321593522513,0.348991694068006,0.634976146579743
7,"Rheinland-Pfalz",7137041,"Kalt",466,233,233,0.5,473,241,232,0.509513742071882,0.0160321593522513,0.348991694068006,0.634976146579743
7,"Rheinland-Pfalz",7137043,"Kehrig",1198,600,598,0.500834724540901,1182,589,593,0.498307952622673,0.0160321593522513,0.348991694068006,0.634976146579743
7,"Rheinland-Pfalz",7137048,"Kerben",454,238,216,0.524229074889868,437,229,208,0.524027459954233,0.0160321593522513,0.348991694068006,0.634976146579743
7,"Rheinland-Pfalz",7137049,"Kirchwald",945,450,495,0.476190476190476,970,468,502,0.482474226804124,0.0160321593522513,0.348991694068006,0.634976146579743
7,"Rheinland-Pfalz",7137053,"Kollig",504,259,245,0.513888888888889,506,261,245,0.515810276679842,0.0160321593522513,0.348991694068006,0.634976146579743
7,"Rheinland-Pfalz",7137055,"Kottenheim",2703,1326,1377,0.490566037735849,2720,1335,1385,0.490808823529412,0.0160321593522513,0.348991694068006,0.634976146579743
7,"Rheinland-Pfalz",7137056,"Kretz",724,354,370,0.488950276243094,700,339,361,0.484285714285714,0.0160321593522513,0.348991694068006,0.634976146579743
7,"Rheinland-Pfalz",7137057,"Kruft",3939,1961,1978,0.497842091901498,3935,1958,1977,0.497585768742058,0.0160321593522513,0.348991694068006,0.634976146579743
7,"Rheinland-Pfalz",7137060,"Langenfeld",684,336,348,0.491228070175439,605,302,303,0.499173553719008,0.0160321593522513,0.348991694068006,0.634976146579743
7,"Rheinland-Pfalz",7137061,"Langscheid",97,51,46,0.525773195876289,91,46,45,0.505494505494505,0.0160321593522513,0.348991694068006,0.634976146579743
7,"Rheinland-Pfalz",7137063,"Lind",51,31,20,0.607843137254902,53,33,20,0.622641509433962,0.0160321593522513,0.348991694068006,0.634976146579743
7,"Rheinland-Pfalz",7137065,"Lonnig",1177,571,606,0.485131690739167,1197,581,616,0.485380116959064,0.0160321593522513,0.348991694068006,0.634976146579743
7,"Rheinland-Pfalz",7137066,"Luxem",301,158,143,0.524916943521595,299,163,136,0.545150501672241,0.0160321593522513,0.348991694068006,0.634976146579743
7,"Rheinland-Pfalz",7137068,"Mayen, Stadt",18614,9113,9501,0.489577737187063,18615,9103,9512,0.489014235831319,0.0160321593522513,0.348991694068006,0.634976146579743
7,"Rheinland-Pfalz",7137069,"Mendig, Stadt",8634,4268,4366,0.494324762566597,8447,4139,4308,0.489996448443234,0.0160321593522513,0.348991694068006,0.634976146579743
7,"Rheinland-Pfalz",7137070,"Mertloch",1401,680,721,0.485367594575303,1443,712,731,0.493416493416493,0.0160321593522513,0.348991694068006,0.634976146579743
7,"Rheinland-Pfalz",7137074,"Monreal",836,417,419,0.498803827751196,838,424,414,0.505966587112172,0.0160321593522513,0.348991694068006,0.634976146579743
7,"Rheinland-Pfalz",7137077,"Münk",252,127,125,0.503968253968254,253,125,128,0.494071146245059,0.0160321593522513,0.348991694068006,0.634976146579743
7,"Rheinland-Pfalz",7137079,"Nachtsheim",557,282,275,0.506283662477558,549,281,268,0.51183970856102,0.0160321593522513,0.348991694068006,0.634976146579743
7,"Rheinland-Pfalz",7137080,"Naunheim",441,222,219,0.503401360544218,421,214,207,0.508313539192399,0.0160321593522513,0.348991694068006,0.634976146579743
7,"Rheinland-Pfalz",7137081,"Nickenich",3663,1827,1836,0.498771498771499,3642,1818,1824,0.499176276771005,0.0160321593522513,0.348991694068006,0.634976146579743
7,"Rheinland-Pfalz",7137086,"Ochtendung",5238,2548,2690,0.486445208094693,5187,2528,2659,0.487372276845961,0.0160321593522513,0.348991694068006,0.634976146579743
7,"Rheinland-Pfalz",7137087,"Pillig",481,242,239,0.503118503118503,479,236,243,0.492693110647182,0.0160321593522513,0.348991694068006,0.634976146579743
7,"Rheinland-Pfalz",7137088,"Plaidt",5809,2873,2936,0.494577379927698,5764,2855,2909,0.495315752949341,0.0160321593522513,0.348991694068006,0.634976146579743
7,"Rheinland-Pfalz",7137089,"Polch, Stadt",6623,3301,3322,0.498414615733052,6512,3248,3264,0.498771498771499,0.0160321593522513,0.348991694068006,0.634976146579743
7,"Rheinland-Pfalz",7137092,"Reudelsterz",382,201,181,0.526178010471204,399,210,189,0.526315789473684,0.0160321593522513,0.348991694068006,0.634976146579743
7,"Rheinland-Pfalz",7137093,"Rieden",1222,601,621,0.491816693944354,1304,668,636,0.512269938650307,0.0160321593522513,0.348991694068006,0.634976146579743
7,"Rheinland-Pfalz",7137095,"Rüber",881,431,450,0.489216799091941,856,414,442,0.483644859813084,0.0160321593522513,0.348991694068006,0.634976146579743
7,"Rheinland-Pfalz",7137096,"Saffig",2213,1189,1024,0.537279710799819,2145,1125,1020,0.524475524475524,0.0160321593522513,0.348991694068006,0.634976146579743
7,"Rheinland-Pfalz",7137097,"Sankt Johann",930,433,497,0.465591397849462,951,453,498,0.476340694006309,0.0160321593522513,0.348991694068006,0.634976146579743
7,"Rheinland-Pfalz",7137099,"Siebenbach",200,108,92,0.54,198,112,86,0.565656565656566,0.0160321593522513,0.348991694068006,0.634976146579743
7,"Rheinland-Pfalz",7137101,"Thür",1520,737,783,0.484868421052632,1528,751,777,0.491492146596859,0.0160321593522513,0.348991694068006,0.634976146579743
7,"Rheinland-Pfalz",7137102,"Trimbs",616,290,326,0.470779220779221,636,303,333,0.476415094339623,0.0160321593522513,0.348991694068006,0.634976146579743
7,"Rheinland-Pfalz",7137105,"Virneburg",381,189,192,0.496062992125984,384,190,194,0.494791666666667,0.0160321593522513,0.348991694068006,0.634976146579743
7,"Rheinland-Pfalz",7137106,"Volkesfeld",575,299,276,0.52,569,293,276,0.51493848857645,0.0160321593522513,0.348991694068006,0.634976146579743
7,"Rheinland-Pfalz",7137110,"Weiler",494,256,238,0.518218623481781,504,265,239,0.525793650793651,0.0160321593522513,0.348991694068006,0.634976146579743
7,"Rheinland-Pfalz",7137112,"Welling",898,436,462,0.485523385300668,893,433,460,0.48488241881299,0.0160321593522513,0.348991694068006,0.634976146579743
7,"Rheinland-Pfalz",7137113,"Welschenbach",53,25,28,0.471698113207547,54,24,30,0.444444444444444,0.0160321593522513,0.348991694068006,0.634976146579743
7,"Rheinland-Pfalz",7137114,"Wierschem",340,174,166,0.511764705882353,327,164,163,0.501529051987768,0.0160321593522513,0.348991694068006,0.634976146579743
7,"Rheinland-Pfalz",7137201,"Alken",661,316,345,0.478063540090772,654,317,337,0.484709480122324,0.0160321593522513,0.348991694068006,0.634976146579743
7,"Rheinland-Pfalz",7137202,"Bassenheim",2982,1470,1512,0.492957746478873,2930,1456,1474,0.496928327645051,0.0160321593522513,0.348991694068006,0.634976146579743
7,"Rheinland-Pfalz",7137203,"Bendorf, Stadt",16549,8008,8541,0.483896307934014,17053,8329,8724,0.488418460094998,0.0160321593522513,0.348991694068006,0.634976146579743
7,"Rheinland-Pfalz",7137204,"Brey",1556,757,799,0.486503856041131,1549,751,798,0.484828921885087,0.0160321593522513,0.348991694068006,0.634976146579743
7,"Rheinland-Pfalz",7137205,"Brodenbach",596,296,300,0.496644295302013,579,298,281,0.514680483592401,0.0160321593522513,0.348991694068006,0.634976146579743
7,"Rheinland-Pfalz",7137206,"Burgen",756,386,370,0.510582010582011,760,386,374,0.507894736842105,0.0160321593522513,0.348991694068006,0.634976146579743
7,"Rheinland-Pfalz",7137207,"Dieblich",2376,1177,1199,0.49537037037037,2351,1154,1197,0.490854955338154,0.0160321593522513,0.348991694068006,0.634976146579743
7,"Rheinland-Pfalz",7137208,"Hatzenport",622,307,315,0.493569131832797,636,313,323,0.492138364779874,0.0160321593522513,0.348991694068006,0.634976146579743
7,"Rheinland-Pfalz",7137209,"Kaltenengers",2061,1046,1015,0.507520621057739,2049,1034,1015,0.504636408003904,0.0160321593522513,0.348991694068006,0.634976146579743
7,"Rheinland-Pfalz",7137211,"Kettig",3317,1635,1682,0.49291528489599,3274,1613,1661,0.492669517409896,0.0160321593522513,0.348991694068006,0.634976146579743
7,"Rheinland-Pfalz",7137212,"Kobern-Gondorf",3240,1612,1628,0.497530864197531,3178,1578,1600,0.496538703587162,0.0160321593522513,0.348991694068006,0.634976146579743
7,"Rheinland-Pfalz",7137214,"Löf",1412,695,717,0.492209631728045,1430,705,725,0.493006993006993,0.0160321593522513,0.348991694068006,0.634976146579743
7,"Rheinland-Pfalz",7137215,"Macken",366,185,181,0.505464480874317,360,176,184,0.488888888888889,0.0160321593522513,0.348991694068006,0.634976146579743
7,"Rheinland-Pfalz",7137216,"Mülheim-Kärlich, Stadt",10776,5251,5525,0.487286562731997,10985,5355,5630,0.487482931269914,0.0160321593522513,0.348991694068006,0.634976146579743
7,"Rheinland-Pfalz",7137217,"Niederfell",1038,399,639,0.384393063583815,1011,409,602,0.404549950544016,0.0160321593522513,0.348991694068006,0.634976146579743
7,"Rheinland-Pfalz",7137218,"Niederwerth",1362,682,680,0.500734214390602,1369,690,679,0.504017531044558,0.0160321593522513,0.348991694068006,0.634976146579743
7,"Rheinland-Pfalz",7137219,"Nörtershausen",1138,577,561,0.507029876977153,1143,587,556,0.513560804899388,0.0160321593522513,0.348991694068006,0.634976146579743
7,"Rheinland-Pfalz",7137220,"Oberfell",1095,538,557,0.491324200913242,1107,556,551,0.502258355916892,0.0160321593522513,0.348991694068006,0.634976146579743
7,"Rheinland-Pfalz",7137221,"Rhens, Stadt",2929,1409,1520,0.481051553431205,2894,1391,1503,0.480649619903248,0.0160321593522513,0.348991694068006,0.634976146579743
7,"Rheinland-Pfalz",7137222,"Sankt Sebastian",2509,1215,1294,0.484256675966521,2497,1206,1291,0.482979575490589,0.0160321593522513,0.348991694068006,0.634976146579743
7,"Rheinland-Pfalz",7137223,"Spay",1891,893,998,0.472236911686938,1894,915,979,0.483104540654699,0.0160321593522513,0.348991694068006,0.634976146579743
7,"Rheinland-Pfalz",7137224,"Urbar",3200,1591,1609,0.4971875,3184,1566,1618,0.491834170854271,0.0160321593522513,0.348991694068006,0.634976146579743
7,"Rheinland-Pfalz",7137225,"Urmitz",3509,1740,1769,0.495867768595041,3473,1724,1749,0.496400806219407,0.0160321593522513,0.348991694068006,0.634976146579743
7,"Rheinland-Pfalz",7137226,"Vallendar, Stadt",8416,3988,4428,0.473859315589354,8195,3843,4352,0.468944478340451,0.0160321593522513,0.348991694068006,0.634976146579743
7,"Rheinland-Pfalz",7137227,"Waldesch",2222,1081,1141,0.486498649864986,2182,1064,1118,0.48762603116407,0.0160321593522513,0.348991694068006,0.634976146579743
7,"Rheinland-Pfalz",7137228,"Weißenthurm, Stadt",8215,4171,4044,0.507729762629337,7791,3842,3949,0.493133102297523,0.0160321593522513,0.348991694068006,0.634976146579743
7,"Rheinland-Pfalz",7137229,"Weitersburg",2349,1124,1225,0.478501489995743,2319,1122,1197,0.483829236739974,0.0160321593522513,0.348991694068006,0.634976146579743
7,"Rheinland-Pfalz",7137230,"Winningen",2483,1177,1306,0.474023358840113,2455,1163,1292,0.473727087576375,0.0160321593522513,0.348991694068006,0.634976146579743
7,"Rheinland-Pfalz",7137231,"Wolken",1087,522,565,0.480220791168353,1077,514,563,0.477251624883937,0.0160321593522513,0.348991694068006,0.634976146579743
7,"Rheinland-Pfalz",7137501,"Münstermaifeld, Stadt",3495,1697,1798,0.48555078683834,3438,1678,1760,0.488074461896451,0.0160321593522513,0.348991694068006,0.634976146579743
7,"Rheinland-Pfalz",7137504,"Lehmen",1383,688,695,0.497469269703543,1379,689,690,0.499637418419144,0.0160321593522513,0.348991694068006,0.634976146579743
7,"Rheinland-Pfalz",7138002,"Anhausen",1323,631,692,0.476946334089191,1313,615,698,0.468392993145468,0.0160321593522513,0.348991694068006,0.634976146579743
7,"Rheinland-Pfalz",7138003,"Asbach",7140,3587,3553,0.502380952380952,6928,3486,3442,0.503175519630485,0.0160321593522513,0.348991694068006,0.634976146579743
7,"Rheinland-Pfalz",7138004,"Bad Hönningen, Stadt",5785,2798,2987,0.483664649956785,5712,2776,2936,0.485994397759104,0.0160321593522513,0.348991694068006,0.634976146579743
7,"Rheinland-Pfalz",7138005,"Bonefeld",968,483,485,0.49896694214876,977,491,486,0.502558853633572,0.0160321593522513,0.348991694068006,0.634976146579743
7,"Rheinland-Pfalz",7138006,"Breitscheid",2135,1049,1086,0.491334894613583,2169,1040,1129,0.479483633010604,0.0160321593522513,0.348991694068006,0.634976146579743
7,"Rheinland-Pfalz",7138007,"Hausen (Wied)",1921,978,943,0.509109838625716,1945,998,947,0.513110539845758,0.0160321593522513,0.348991694068006,0.634976146579743
7,"Rheinland-Pfalz",7138008,"Bruchhausen",893,445,448,0.498320268756999,922,461,461,0.5,0.0160321593522513,0.348991694068006,0.634976146579743
7,"Rheinland-Pfalz",7138009,"Dattenberg",1565,777,788,0.496485623003195,1557,759,798,0.48747591522158,0.0160321593522513,0.348991694068006,0.634976146579743
7,"Rheinland-Pfalz",7138010,"Datzeroth",236,106,130,0.449152542372881,233,99,134,0.424892703862661,0.0160321593522513,0.348991694068006,0.634976146579743
7,"Rheinland-Pfalz",7138011,"Dernbach",1011,484,527,0.478733926805143,985,486,499,0.493401015228426,0.0160321593522513,0.348991694068006,0.634976146579743
7,"Rheinland-Pfalz",7138012,"Dierdorf, Stadt",5818,2860,2958,0.491577861808182,5872,2907,2965,0.495061307901907,0.0160321593522513,0.348991694068006,0.634976146579743
7,"Rheinland-Pfalz",7138013,"Döttesfeld",618,304,314,0.491909385113269,656,325,331,0.495426829268293,0.0160321593522513,0.348991694068006,0.634976146579743
7,"Rheinland-Pfalz",7138014,"Dürrholz",1239,623,616,0.502824858757062,1299,661,638,0.508852963818322,0.0160321593522513,0.348991694068006,0.634976146579743
7,"Rheinland-Pfalz",7138015,"Ehlscheid",1294,631,663,0.487635239567233,1343,662,681,0.492926284437826,0.0160321593522513,0.348991694068006,0.634976146579743
7,"Rheinland-Pfalz",7138019,"Erpel",2531,1239,1292,0.489529830106677,2557,1252,1305,0.489636292530309,0.0160321593522513,0.348991694068006,0.634976146579743
7,"Rheinland-Pfalz",7138023,"Großmaischeid",2346,1157,1189,0.493179880647911,2358,1165,1193,0.494062765055131,0.0160321593522513,0.348991694068006,0.634976146579743
7,"Rheinland-Pfalz",7138024,"Hammerstein",324,152,172,0.469135802469136,336,154,182,0.458333333333333,0.0160321593522513,0.348991694068006,0.634976146579743
7,"Rheinland-Pfalz",7138025,"Hanroth",618,304,314,0.491909385113269,621,304,317,0.489533011272142,0.0160321593522513,0.348991694068006,0.634976146579743
7,"Rheinland-Pfalz",7138026,"Hardert",794,387,407,0.487405541561713,784,384,400,0.489795918367347,0.0160321593522513,0.348991694068006,0.634976146579743
7,"Rheinland-Pfalz",7138027,"Harschbach",414,205,209,0.495169082125604,419,204,215,0.486873508353222,0.0160321593522513,0.348991694068006,0.634976146579743
7,"Rheinland-Pfalz",7138030,"Hümmerich",785,386,399,0.49171974522293,776,383,393,0.493556701030928,0.0160321593522513,0.348991694068006,0.634976146579743
7,"Rheinland-Pfalz",7138031,"Isenburg",611,300,311,0.490998363338789,602,305,297,0.506644518272425,0.0160321593522513,0.348991694068006,0.634976146579743
7,"Rheinland-Pfalz",7138034,"Kleinmaischeid",1373,655,718,0.477057538237436,1350,642,708,0.475555555555556,0.0160321593522513,0.348991694068006,0.634976146579743
7,"Rheinland-Pfalz",7138036,"Kurtscheid",948,469,479,0.494725738396624,936,468,468,0.5,0.0160321593522513,0.348991694068006,0.634976146579743
7,"Rheinland-Pfalz",7138037,"Leubsdorf",1614,799,815,0.495043370508055,1618,805,813,0.497527812113721,0.0160321593522513,0.348991694068006,0.634976146579743
7,"Rheinland-Pfalz",7138038,"Leutesdorf",1860,931,929,0.500537634408602,1831,907,924,0.495357728017477,0.0160321593522513,0.348991694068006,0.634976146579743
7,"Rheinland-Pfalz",7138040,"Linkenbach",466,232,234,0.497854077253219,478,241,237,0.50418410041841,0.0160321593522513,0.348991694068006,0.634976146579743
7,"Rheinland-Pfalz",7138041,"Linz am Rhein, Stadt",5894,2771,3123,0.470139124533424,5758,2726,3032,0.473428273706148,0.0160321593522513,0.348991694068006,0.634976146579743
7,"Rheinland-Pfalz",7138042,"Meinborn",501,258,243,0.514970059880239,502,259,243,0.51593625498008,0.0160321593522513,0.348991694068006,0.634976146579743
7,"Rheinland-Pfalz",7138043,"Melsbach",1996,957,1039,0.479458917835671,2000,957,1043,0.4785,0.0160321593522513,0.348991694068006,0.634976146579743
7,"Rheinland-Pfalz",7138044,"Neustadt (Wied)",6280,3092,3188,0.492356687898089,6344,3169,3175,0.49952711223203,0.0160321593522513,0.348991694068006,0.634976146579743
7,"Rheinland-Pfalz",7138045,"Neuwied, Stadt",64091,31060,33031,0.484623426066062,64184,31272,32912,0.487224230337779,0.0160321593522513,0.348991694068006,0.634976146579743
7,"Rheinland-Pfalz",7138047,"Niederbreitbach",1568,784,784,0.5,1587,787,800,0.495904221802142,0.0160321593522513,0.348991694068006,0.634976146579743
7,"Rheinland-Pfalz",7138048,"Niederhofen",394,199,195,0.50507614213198,376,192,184,0.51063829787234,0.0160321593522513,0.348991694068006,0.634976146579743
7,"Rheinland-Pfalz",7138050,"Niederwambach",437,228,209,0.521739130434783,504,274,230,0.543650793650794,0.0160321593522513,0.348991694068006,0.634976146579743
7,"Rheinland-Pfalz",7138052,"Oberdreis",871,423,448,0.48564867967853,876,425,451,0.485159817351598,0.0160321593522513,0.348991694068006,0.634976146579743
7,"Rheinland-Pfalz",7138053,"Oberhonnefeld-Gierend",1020,496,524,0.486274509803922,1052,519,533,0.493346007604563,0.0160321593522513,0.348991694068006,0.634976146579743
7,"Rheinland-Pfalz",7138054,"Oberraden",634,325,309,0.512618296529968,665,347,318,0.521804511278195,0.0160321593522513,0.348991694068006,0.634976146579743
7,"Rheinland-Pfalz",7138055,"Ockenfels",1028,509,519,0.495136186770428,1072,523,549,0.487873134328358,0.0160321593522513,0.348991694068006,0.634976146579743
7,"Rheinland-Pfalz",7138057,"Puderbach",2425,1162,1263,0.479175257731959,2188,1047,1141,0.478519195612431,0.0160321593522513,0.348991694068006,0.634976146579743
7,"Rheinland-Pfalz",7138058,"Ratzert",242,120,122,0.495867768595041,249,126,123,0.506024096385542,0.0160321593522513,0.348991694068006,0.634976146579743
7,"Rheinland-Pfalz",7138059,"Raubach",1925,912,1013,0.473766233766234,1941,938,1003,0.483256053580629,0.0160321593522513,0.348991694068006,0.634976146579743
7,"Rheinland-Pfalz",7138061,"Rengsdorf",2620,1296,1324,0.494656488549618,2642,1312,1330,0.496593489780469,0.0160321593522513,0.348991694068006,0.634976146579743
7,"Rheinland-Pfalz",7138062,"Rheinbreitbach",4447,2183,2264,0.490892736676411,4492,2211,2281,0.492208370436331,0.0160321593522513,0.348991694068006,0.634976146579743
7,"Rheinland-Pfalz",7138063,"Rheinbrohl",3892,1907,1985,0.489979445015416,3874,1916,1958,0.494579246257099,0.0160321593522513,0.348991694068006,0.634976146579743
7,"Rheinland-Pfalz",7138064,"Rodenbach bei Puderbach",685,345,340,0.503649635036496,655,325,330,0.49618320610687,0.0160321593522513,0.348991694068006,0.634976146579743
7,"Rheinland-Pfalz",7138065,"Roßbach",1502,758,744,0.504660452729694,1470,763,707,0.519047619047619,0.0160321593522513,0.348991694068006,0.634976146579743
7,"Rheinland-Pfalz",7138066,"Rüscheid",783,393,390,0.501915708812261,773,387,386,0.500646830530401,0.0160321593522513,0.348991694068006,0.634976146579743
7,"Rheinland-Pfalz",7138068,"Sankt Katharinen (Landkreis Neuwied)",3407,1707,1700,0.501027296742002,3479,1739,1740,0.499856280540385,0.0160321593522513,0.348991694068006,0.634976146579743
7,"Rheinland-Pfalz",7138069,"Stebach",308,153,155,0.496753246753247,303,149,154,0.491749174917492,0.0160321593522513,0.348991694068006,0.634976146579743
7,"Rheinland-Pfalz",7138070,"Steimel",1233,626,607,0.507704785077048,1249,645,604,0.516413130504404,0.0160321593522513,0.348991694068006,0.634976146579743
7,"Rheinland-Pfalz",7138071,"Straßenhaus",1884,925,959,0.490976645435244,1936,963,973,0.497417355371901,0.0160321593522513,0.348991694068006,0.634976146579743
7,"Rheinland-Pfalz",7138072,"Thalhausen",743,376,367,0.506056527590848,741,382,359,0.515519568151147,0.0160321593522513,0.348991694068006,0.634976146579743
7,"Rheinland-Pfalz",7138073,"Unkel, Stadt",5046,2372,2674,0.470075307173999,4960,2327,2633,0.469153225806452,0.0160321593522513,0.348991694068006,0.634976146579743
7,"Rheinland-Pfalz",7138074,"Urbach",1529,758,771,0.495748855461086,1557,790,767,0.507385998715479,0.0160321593522513,0.348991694068006,0.634976146579743
7,"Rheinland-Pfalz",7138075,"Vettelschoß",3445,1683,1762,0.488534107402032,3347,1598,1749,0.477442485808186,0.0160321593522513,0.348991694068006,0.634976146579743
7,"Rheinland-Pfalz",7138076,"Waldbreitbach",1880,838,1042,0.445744680851064,1825,796,1029,0.436164383561644,0.0160321593522513,0.348991694068006,0.634976146579743
7,"Rheinland-Pfalz",7138077,"Windhagen",4244,2107,2137,0.496465598491989,4280,2112,2168,0.493457943925234,0.0160321593522513,0.348991694068006,0.634976146579743
7,"Rheinland-Pfalz",7138078,"Woldert",592,296,296,0.5,609,303,306,0.497536945812808,0.0160321593522513,0.348991694068006,0.634976146579743
7,"Rheinland-Pfalz",7138080,"Buchholz (Westerwald)",4464,2251,2213,0.504256272401434,4631,2317,2314,0.500323904124379,0.0160321593522513,0.348991694068006,0.634976146579743
7,"Rheinland-Pfalz",7138201,"Marienhausen",509,243,266,0.477406679764244,490,237,253,0.483673469387755,0.0160321593522513,0.348991694068006,0.634976146579743
7,"Rheinland-Pfalz",7138501,"Kasbach-Ohlenberg",1348,662,686,0.491097922848665,1350,658,692,0.487407407407407,0.0160321593522513,0.348991694068006,0.634976146579743
7,"Rheinland-Pfalz",7140001,"Alterkülz",413,209,204,0.506053268765133,428,209,219,0.488317757009346,0.0160321593522513,0.348991694068006,0.634976146579743
7,"Rheinland-Pfalz",7140002,"Altweidelbach",240,118,122,0.491666666666667,244,118,126,0.483606557377049,0.0160321593522513,0.348991694068006,0.634976146579743
7,"Rheinland-Pfalz",7140003,"Argenthal",1661,810,851,0.487658037326911,1627,800,827,0.491702519975415,0.0160321593522513,0.348991694068006,0.634976146579743
7,"Rheinland-Pfalz",7140005,"Badenhard",143,73,70,0.510489510489511,129,65,64,0.503875968992248,0.0160321593522513,0.348991694068006,0.634976146579743
7,"Rheinland-Pfalz",7140006,"Bärenbach",439,213,226,0.485193621867882,445,216,229,0.485393258426966,0.0160321593522513,0.348991694068006,0.634976146579743
7,"Rheinland-Pfalz",7140007,"Belg",140,74,66,0.528571428571429,136,68,68,0.5,0.0160321593522513,0.348991694068006,0.634976146579743
7,"Rheinland-Pfalz",7140008,"Belgweiler",211,106,105,0.502369668246445,204,103,101,0.504901960784314,0.0160321593522513,0.348991694068006,0.634976146579743
7,"Rheinland-Pfalz",7140009,"Bell (Hunsrück)",1470,739,731,0.502721088435374,1481,749,732,0.50573936529372,0.0160321593522513,0.348991694068006,0.634976146579743
7,"Rheinland-Pfalz",7140010,"Beltheim",1981,963,1018,0.486118122160525,1953,953,1000,0.487967229902714,0.0160321593522513,0.348991694068006,0.634976146579743
7,"Rheinland-Pfalz",7140011,"Benzweiler",202,93,109,0.46039603960396,203,96,107,0.472906403940887,0.0160321593522513,0.348991694068006,0.634976146579743
7,"Rheinland-Pfalz",7140012,"Bergenhausen",119,60,59,0.504201680672269,117,58,59,0.495726495726496,0.0160321593522513,0.348991694068006,0.634976146579743
7,"Rheinland-Pfalz",7140014,"Bickenbach",340,176,164,0.517647058823529,326,168,158,0.515337423312883,0.0160321593522513,0.348991694068006,0.634976146579743
7,"Rheinland-Pfalz",7140015,"Biebern",317,169,148,0.533123028391167,313,167,146,0.533546325878594,0.0160321593522513,0.348991694068006,0.634976146579743
7,"Rheinland-Pfalz",7140016,"Birkheim",144,72,72,0.5,144,76,68,0.527777777777778,0.0160321593522513,0.348991694068006,0.634976146579743
7,"Rheinland-Pfalz",7140018,"Braunshorn",595,301,294,0.505882352941176,584,298,286,0.51027397260274,0.0160321593522513,0.348991694068006,0.634976146579743
7,"Rheinland-Pfalz",7140020,"Bubach",289,142,147,0.491349480968858,267,133,134,0.49812734082397,0.0160321593522513,0.348991694068006,0.634976146579743
7,"Rheinland-Pfalz",7140021,"Buch",936,474,462,0.506410256410256,924,470,454,0.508658008658009,0.0160321593522513,0.348991694068006,0.634976146579743
7,"Rheinland-Pfalz",7140023,"Budenbach",177,98,79,0.553672316384181,173,96,77,0.554913294797688,0.0160321593522513,0.348991694068006,0.634976146579743
7,"Rheinland-Pfalz",7140024,"Büchenbeuren",1646,817,829,0.496354799513973,1651,801,850,0.485160508782556,0.0160321593522513,0.348991694068006,0.634976146579743
7,"Rheinland-Pfalz",7140025,"Damscheid",628,301,327,0.479299363057325,634,300,334,0.473186119873817,0.0160321593522513,0.348991694068006,0.634976146579743
7,"Rheinland-Pfalz",7140027,"Dichtelbach",674,344,330,0.510385756676558,711,384,327,0.540084388185654,0.0160321593522513,0.348991694068006,0.634976146579743
7,"Rheinland-Pfalz",7140028,"Dickenschied",734,369,365,0.502724795640327,725,367,358,0.506206896551724,0.0160321593522513,0.348991694068006,0.634976146579743
7,"Rheinland-Pfalz",7140029,"Dill",191,94,97,0.492146596858639,190,95,95,0.5,0.0160321593522513,0.348991694068006,0.634976146579743
7,"Rheinland-Pfalz",7140030,"Dillendorf",604,300,304,0.496688741721854,621,310,311,0.499194847020934,0.0160321593522513,0.348991694068006,0.634976146579743
7,"Rheinland-Pfalz",7140031,"Dörth",520,278,242,0.534615384615385,510,276,234,0.541176470588235,0.0160321593522513,0.348991694068006,0.634976146579743
7,"Rheinland-Pfalz",7140035,"Ellern (Hunsrück)",819,422,397,0.515262515262515,821,428,393,0.521315468940317,0.0160321593522513,0.348991694068006,0.634976146579743
7,"Rheinland-Pfalz",7140036,"Emmelshausen, Stadt",4798,2320,2478,0.483534806169237,4614,2235,2379,0.484395318595579,0.0160321593522513,0.348991694068006,0.634976146579743
7,"Rheinland-Pfalz",7140037,"Erbach",264,125,139,0.473484848484849,235,103,132,0.438297872340426,0.0160321593522513,0.348991694068006,0.634976146579743
7,"Rheinland-Pfalz",7140039,"Fronhofen",225,111,114,0.493333333333333,210,106,104,0.504761904761905,0.0160321593522513,0.348991694068006,0.634976146579743
7,"Rheinland-Pfalz",7140040,"Gehlweiler",238,121,117,0.508403361344538,234,114,120,0.487179487179487,0.0160321593522513,0.348991694068006,0.634976146579743
7,"Rheinland-Pfalz",7140041,"Gemünden",1268,598,670,0.471608832807571,1200,577,623,0.480833333333333,0.0160321593522513,0.348991694068006,0.634976146579743
7,"Rheinland-Pfalz",7140042,"Gödenroth",487,248,239,0.509240246406571,473,244,229,0.515856236786469,0.0160321593522513,0.348991694068006,0.634976146579743
7,"Rheinland-Pfalz",7140043,"Gondershausen",1254,627,627,0.5,1253,621,632,0.49561053471668,0.0160321593522513,0.348991694068006,0.634976146579743
7,"Rheinland-Pfalz",7140044,"Hahn",178,91,87,0.51123595505618,161,83,78,0.515527950310559,0.0160321593522513,0.348991694068006,0.634976146579743
7,"Rheinland-Pfalz",7140045,"Halsenbach",1231,662,569,0.537774167343623,1241,680,561,0.547945205479452,0.0160321593522513,0.348991694068006,0.634976146579743
7,"Rheinland-Pfalz",7140046,"Hasselbach",176,87,89,0.494318181818182,176,86,90,0.488636363636364,0.0160321593522513,0.348991694068006,0.634976146579743
7,"Rheinland-Pfalz",7140047,"Hausbay",197,98,99,0.49746192893401,192,97,95,0.505208333333333,0.0160321593522513,0.348991694068006,0.634976146579743
7,"Rheinland-Pfalz",7140048,"Hecken",119,64,55,0.53781512605042,124,61,63,0.491935483870968,0.0160321593522513,0.348991694068006,0.634976146579743
7,"Rheinland-Pfalz",7140049,"Heinzenbach",415,197,218,0.474698795180723,412,193,219,0.468446601941748,0.0160321593522513,0.348991694068006,0.634976146579743
7,"Rheinland-Pfalz",7140050,"Henau",148,65,83,0.439189189189189,155,65,90,0.419354838709677,0.0160321593522513,0.348991694068006,0.634976146579743
7,"Rheinland-Pfalz",7140053,"Hirschfeld (Hunsrück)",314,159,155,0.506369426751592,298,150,148,0.503355704697987,0.0160321593522513,0.348991694068006,0.634976146579743
7,"Rheinland-Pfalz",7140055,"Hollnich",294,140,154,0.476190476190476,272,127,145,0.466911764705882,0.0160321593522513,0.348991694068006,0.634976146579743
7,"Rheinland-Pfalz",7140056,"Holzbach",522,257,265,0.492337164750958,553,281,272,0.508137432188065,0.0160321593522513,0.348991694068006,0.634976146579743
7,"Rheinland-Pfalz",7140058,"Horn",360,171,189,0.475,343,165,178,0.481049562682216,0.0160321593522513,0.348991694068006,0.634976146579743
7,"Rheinland-Pfalz",7140060,"Hungenroth",241,130,111,0.539419087136929,221,116,105,0.524886877828054,0.0160321593522513,0.348991694068006,0.634976146579743
7,"Rheinland-Pfalz",7140062,"Kappel",486,252,234,0.518518518518518,466,248,218,0.532188841201717,0.0160321593522513,0.348991694068006,0.634976146579743
7,"Rheinland-Pfalz",7140063,"Karbach",582,299,283,0.513745704467354,581,304,277,0.523235800344234,0.0160321593522513,0.348991694068006,0.634976146579743
7,"Rheinland-Pfalz",7140064,"Kastellaun, Stadt",5116,2493,2623,0.487294761532447,5081,2548,2533,0.501476087384373,0.0160321593522513,0.348991694068006,0.634976146579743
7,"Rheinland-Pfalz",7140065,"Keidelheim",298,145,153,0.486577181208054,302,150,152,0.496688741721854,0.0160321593522513,0.348991694068006,0.634976146579743
7,"Rheinland-Pfalz",7140067,"Kirchberg (Hunsrück), Stadt",3787,1867,1920,0.49300237655136,3713,1844,1869,0.496633450040399,0.0160321593522513,0.348991694068006,0.634976146579743
7,"Rheinland-Pfalz",7140068,"Kisselbach",558,285,273,0.510752688172043,554,279,275,0.503610108303249,0.0160321593522513,0.348991694068006,0.634976146579743
7,"Rheinland-Pfalz",7140070,"Klosterkumbd",281,150,131,0.533807829181495,284,149,135,0.524647887323944,0.0160321593522513,0.348991694068006,0.634976146579743
7,"Rheinland-Pfalz",7140071,"Kludenbach",108,50,58,0.462962962962963,114,56,58,0.491228070175439,0.0160321593522513,0.348991694068006,0.634976146579743
7,"Rheinland-Pfalz",7140073,"Korweiler",85,44,41,0.517647058823529,83,41,42,0.493975903614458,0.0160321593522513,0.348991694068006,0.634976146579743
7,"Rheinland-Pfalz",7140075,"Kratzenburg",405,206,199,0.508641975308642,397,203,194,0.511335012594458,0.0160321593522513,0.348991694068006,0.634976146579743
7,"Rheinland-Pfalz",7140076,"Külz (Hunsrück)",501,249,252,0.497005988023952,479,228,251,0.475991649269311,0.0160321593522513,0.348991694068006,0.634976146579743
7,"Rheinland-Pfalz",7140077,"Kümbdchen",508,257,251,0.505905511811024,510,259,251,0.507843137254902,0.0160321593522513,0.348991694068006,0.634976146579743
7,"Rheinland-Pfalz",7140079,"Laubach",433,211,222,0.48729792147806,417,210,207,0.503597122302158,0.0160321593522513,0.348991694068006,0.634976146579743
7,"Rheinland-Pfalz",7140080,"Laudert",401,206,195,0.513715710723192,399,211,188,0.528822055137845,0.0160321593522513,0.348991694068006,0.634976146579743
7,"Rheinland-Pfalz",7140081,"Laufersweiler",851,434,417,0.509988249118684,842,429,413,0.509501187648456,0.0160321593522513,0.348991694068006,0.634976146579743
7,"Rheinland-Pfalz",7140082,"Lautzenhausen",352,169,183,0.480113636363636,342,163,179,0.476608187134503,0.0160321593522513,0.348991694068006,0.634976146579743
7,"Rheinland-Pfalz",7140084,"Leiningen",742,378,364,0.509433962264151,762,393,369,0.515748031496063,0.0160321593522513,0.348991694068006,0.634976146579743
7,"Rheinland-Pfalz",7140085,"Liebshausen",498,241,257,0.483935742971888,496,234,262,0.471774193548387,0.0160321593522513,0.348991694068006,0.634976146579743
7,"Rheinland-Pfalz",7140086,"Lindenschied",203,100,103,0.492610837438424,199,101,98,0.507537688442211,0.0160321593522513,0.348991694068006,0.634976146579743
7,"Rheinland-Pfalz",7140087,"Lingerhahn",473,244,229,0.515856236786469,470,242,228,0.514893617021277,0.0160321593522513,0.348991694068006,0.634976146579743
7,"Rheinland-Pfalz",7140089,"Maisborn",130,67,63,0.515384615384615,127,63,64,0.496062992125984,0.0160321593522513,0.348991694068006,0.634976146579743
7,"Rheinland-Pfalz",7140090,"Maitzborn",109,51,58,0.467889908256881,114,54,60,0.473684210526316,0.0160321593522513,0.348991694068006,0.634976146579743
7,"Rheinland-Pfalz",7140092,"Mengerschied",730,377,353,0.516438356164384,732,379,353,0.51775956284153,0.0160321593522513,0.348991694068006,0.634976146579743
7,"Rheinland-Pfalz",7140093,"Mermuth",265,134,131,0.505660377358491,274,141,133,0.514598540145985,0.0160321593522513,0.348991694068006,0.634976146579743
7,"Rheinland-Pfalz",7140094,"Metzenhausen",126,64,62,0.507936507936508,125,63,62,0.504,0.0160321593522513,0.348991694068006,0.634976146579743
7,"Rheinland-Pfalz",7140095,"Michelbach",172,86,86,0.5,161,80,81,0.496894409937888,0.0160321593522513,0.348991694068006,0.634976146579743
7,"Rheinland-Pfalz",7140096,"Mörschbach",325,169,156,0.52,324,168,156,0.518518518518518,0.0160321593522513,0.348991694068006,0.634976146579743
7,"Rheinland-Pfalz",7140098,"Mühlpfad",71,35,36,0.492957746478873,68,32,36,0.470588235294118,0.0160321593522513,0.348991694068006,0.634976146579743
7,"Rheinland-Pfalz",7140099,"Mutterschied",502,255,247,0.50796812749004,520,279,241,0.536538461538462,0.0160321593522513,0.348991694068006,0.634976146579743
7,"Rheinland-Pfalz",7140100,"Nannhausen",509,251,258,0.493123772102161,504,249,255,0.494047619047619,0.0160321593522513,0.348991694068006,0.634976146579743
7,"Rheinland-Pfalz",7140101,"Neuerkirch",289,145,144,0.501730103806228,274,138,136,0.503649635036496,0.0160321593522513,0.348991694068006,0.634976146579743
7,"Rheinland-Pfalz",7140102,"Ney",358,170,188,0.474860335195531,380,180,200,0.473684210526316,0.0160321593522513,0.348991694068006,0.634976146579743
7,"Rheinland-Pfalz",7140104,"Niederburg",698,344,354,0.492836676217765,691,340,351,0.492040520984081,0.0160321593522513,0.348991694068006,0.634976146579743
7,"Rheinland-Pfalz",7140105,"Nieder Kostenz",190,99,91,0.521052631578947,207,107,100,0.516908212560386,0.0160321593522513,0.348991694068006,0.634976146579743
7,"Rheinland-Pfalz",7140106,"Niederkumbd",311,179,132,0.57556270096463,302,168,134,0.556291390728477,0.0160321593522513,0.348991694068006,0.634976146579743
7,"Rheinland-Pfalz",7140107,"Niedersohren",454,239,215,0.526431718061674,455,238,217,0.523076923076923,0.0160321593522513,0.348991694068006,0.634976146579743
7,"Rheinland-Pfalz",7140108,"Niedert",141,63,78,0.446808510638298,139,66,73,0.474820143884892,0.0160321593522513,0.348991694068006,0.634976146579743
7,"Rheinland-Pfalz",7140109,"Niederweiler",392,191,201,0.487244897959184,384,190,194,0.494791666666667,0.0160321593522513,0.348991694068006,0.634976146579743
7,"Rheinland-Pfalz",7140110,"Norath",455,224,231,0.492307692307692,461,226,235,0.490238611713666,0.0160321593522513,0.348991694068006,0.634976146579743
7,"Rheinland-Pfalz",7140111,"Ober Kostenz",265,139,126,0.524528301886792,272,142,130,0.522058823529412,0.0160321593522513,0.348991694068006,0.634976146579743
7,"Rheinland-Pfalz",7140112,"Oberwesel, Stadt",2877,1360,1517,0.472714633298575,2811,1315,1496,0.467805051583067,0.0160321593522513,0.348991694068006,0.634976146579743
7,"Rheinland-Pfalz",7140113,"Ohlweiler",338,173,165,0.511834319526627,333,169,164,0.507507507507508,0.0160321593522513,0.348991694068006,0.634976146579743
7,"Rheinland-Pfalz",7140115,"Oppertshausen",124,67,57,0.540322580645161,128,68,60,0.53125,0.0160321593522513,0.348991694068006,0.634976146579743
7,"Rheinland-Pfalz",7140116,"Perscheid",376,173,203,0.460106382978723,381,176,205,0.461942257217848,0.0160321593522513,0.348991694068006,0.634976146579743
7,"Rheinland-Pfalz",7140117,"Pfalzfeld",606,321,285,0.52970297029703,577,295,282,0.511265164644714,0.0160321593522513,0.348991694068006,0.634976146579743
7,"Rheinland-Pfalz",7140118,"Pleizenhausen",246,127,119,0.516260162601626,245,124,121,0.506122448979592,0.0160321593522513,0.348991694068006,0.634976146579743
7,"Rheinland-Pfalz",7140119,"Ravengiersburg",314,146,168,0.464968152866242,474,208,266,0.438818565400844,0.0160321593522513,0.348991694068006,0.634976146579743
7,"Rheinland-Pfalz",7140120,"Raversbeuren",124,61,63,0.491935483870968,122,60,62,0.491803278688525,0.0160321593522513,0.348991694068006,0.634976146579743
7,"Rheinland-Pfalz",7140121,"Rayerschied",113,54,59,0.47787610619469,115,54,61,0.469565217391304,0.0160321593522513,0.348991694068006,0.634976146579743
7,"Rheinland-Pfalz",7140122,"Reckershausen",386,193,193,0.5,379,190,189,0.50131926121372,0.0160321593522513,0.348991694068006,0.634976146579743
7,"Rheinland-Pfalz",7140123,"Reich",352,178,174,0.505681818181818,343,178,165,0.518950437317784,0.0160321593522513,0.348991694068006,0.634976146579743
7,"Rheinland-Pfalz",7140125,"Rheinböllen, Stadt",3969,1949,2020,0.491055681531872,4010,1989,2021,0.496009975062344,0.0160321593522513,0.348991694068006,0.634976146579743
7,"Rheinland-Pfalz",7140126,"Riegenroth",198,93,105,0.46969696969697,206,103,103,0.5,0.0160321593522513,0.348991694068006,0.634976146579743
7,"Rheinland-Pfalz",7140127,"Riesweiler",741,369,372,0.497975708502024,759,396,363,0.521739130434783,0.0160321593522513,0.348991694068006,0.634976146579743
7,"Rheinland-Pfalz",7140128,"Rödelhausen",151,71,80,0.470198675496689,151,73,78,0.483443708609272,0.0160321593522513,0.348991694068006,0.634976146579743
7,"Rheinland-Pfalz",7140129,"Rödern",208,99,109,0.475961538461538,205,95,110,0.463414634146341,0.0160321593522513,0.348991694068006,0.634976146579743
7,"Rheinland-Pfalz",7140130,"Rohrbach",174,91,83,0.522988505747126,174,92,82,0.528735632183908,0.0160321593522513,0.348991694068006,0.634976146579743
7,"Rheinland-Pfalz",7140131,"Roth",254,133,121,0.523622047244094,246,132,114,0.536585365853659,0.0160321593522513,0.348991694068006,0.634976146579743
7,"Rheinland-Pfalz",7140133,"Sankt Goar, Stadt",2743,1333,1410,0.485964272694131,2710,1306,1404,0.481918819188192,0.0160321593522513,0.348991694068006,0.634976146579743
7,"Rheinland-Pfalz",7140134,"Sargenroth",440,223,217,0.506818181818182,448,232,216,0.517857142857143,0.0160321593522513,0.348991694068006,0.634976146579743
7,"Rheinland-Pfalz",7140135,"Schlierschied",183,86,97,0.469945355191257,180,84,96,0.466666666666667,0.0160321593522513,0.348991694068006,0.634976146579743
7,"Rheinland-Pfalz",7140138,"Schnorbach",234,116,118,0.495726495726496,229,112,117,0.489082969432314,0.0160321593522513,0.348991694068006,0.634976146579743
7,"Rheinland-Pfalz",7140139,"Schönborn",264,126,138,0.477272727272727,264,127,137,0.481060606060606,0.0160321593522513,0.348991694068006,0.634976146579743
7,"Rheinland-Pfalz",7140140,"Schwall",351,164,187,0.467236467236467,339,152,187,0.448377581120944,0.0160321593522513,0.348991694068006,0.634976146579743
7,"Rheinland-Pfalz",7140141,"Schwarzen",132,63,69,0.477272727272727,134,64,70,0.477611940298507,0.0160321593522513,0.348991694068006,0.634976146579743
7,"Rheinland-Pfalz",7140144,"Simmern/ Hunsrück, Stadt",7613,3627,3986,0.476421909890976,7600,3631,3969,0.477763157894737,0.0160321593522513,0.348991694068006,0.634976146579743
7,"Rheinland-Pfalz",7140145,"Sohren",3280,1587,1693,0.483841463414634,3193,1533,1660,0.48011274663326,0.0160321593522513,0.348991694068006,0.634976146579743
7,"Rheinland-Pfalz",7140146,"Sohrschied",90,40,50,0.444444444444444,85,36,49,0.423529411764706,0.0160321593522513,0.348991694068006,0.634976146579743
7,"Rheinland-Pfalz",7140147,"Spesenroth",149,80,69,0.536912751677852,143,75,68,0.524475524475524,0.0160321593522513,0.348991694068006,0.634976146579743
7,"Rheinland-Pfalz",7140148,"Steinbach",131,68,63,0.519083969465649,122,64,58,0.524590163934426,0.0160321593522513,0.348991694068006,0.634976146579743
7,"Rheinland-Pfalz",7140149,"Thörlingen",156,83,73,0.532051282051282,156,82,74,0.525641025641026,0.0160321593522513,0.348991694068006,0.634976146579743
7,"Rheinland-Pfalz",7140150,"Tiefenbach",762,404,358,0.530183727034121,762,408,354,0.535433070866142,0.0160321593522513,0.348991694068006,0.634976146579743
7,"Rheinland-Pfalz",7140151,"Todenroth",91,45,46,0.494505494505495,91,45,46,0.494505494505495,0.0160321593522513,0.348991694068006,0.634976146579743
7,"Rheinland-Pfalz",7140153,"Uhler",389,196,193,0.503856041131105,389,205,184,0.526992287917738,0.0160321593522513,0.348991694068006,0.634976146579743
7,"Rheinland-Pfalz",7140154,"Unzenberg",428,214,214,0.5,426,211,215,0.495305164319249,0.0160321593522513,0.348991694068006,0.634976146579743
7,"Rheinland-Pfalz",7140155,"Urbar",734,349,385,0.475476839237057,759,359,400,0.472990777338603,0.0160321593522513,0.348991694068006,0.634976146579743
7,"Rheinland-Pfalz",7140156,"Utzenhain",117,62,55,0.52991452991453,111,59,52,0.531531531531532,0.0160321593522513,0.348991694068006,0.634976146579743
7,"Rheinland-Pfalz",7140158,"Wahlbach",168,83,85,0.494047619047619,155,75,80,0.483870967741935,0.0160321593522513,0.348991694068006,0.634976146579743
7,"Rheinland-Pfalz",7140159,"Wahlenau",200,93,107,0.465,201,94,107,0.467661691542289,0.0160321593522513,0.348991694068006,0.634976146579743
7,"Rheinland-Pfalz",7140161,"Wiebelsheim",662,390,272,0.589123867069486,569,330,239,0.579964850615114,0.0160321593522513,0.348991694068006,0.634976146579743
7,"Rheinland-Pfalz",7140163,"Womrath",213,106,107,0.497652582159624,206,101,105,0.490291262135922,0.0160321593522513,0.348991694068006,0.634976146579743
7,"Rheinland-Pfalz",7140164,"Woppenroth",270,130,140,0.481481481481481,271,135,136,0.498154981549816,0.0160321593522513,0.348991694068006,0.634976146579743
7,"Rheinland-Pfalz",7140165,"Würrich",150,70,80,0.466666666666667,149,67,82,0.449664429530201,0.0160321593522513,0.348991694068006,0.634976146579743
7,"Rheinland-Pfalz",7140166,"Wüschheim",296,156,140,0.527027027027027,318,164,154,0.515723270440252,0.0160321593522513,0.348991694068006,0.634976146579743
7,"Rheinland-Pfalz",7140201,"Beulich",489,244,245,0.498977505112474,466,240,226,0.515021459227468,0.0160321593522513,0.348991694068006,0.634976146579743
7,"Rheinland-Pfalz",7140202,"Dommershausen",1130,563,567,0.498230088495575,1116,548,568,0.491039426523298,0.0160321593522513,0.348991694068006,0.634976146579743
7,"Rheinland-Pfalz",7140204,"Mastershausen",1015,495,520,0.487684729064039,1011,489,522,0.483679525222552,0.0160321593522513,0.348991694068006,0.634976146579743
7,"Rheinland-Pfalz",7140205,"Morshausen",362,196,166,0.541436464088398,351,190,161,0.541310541310541,0.0160321593522513,0.348991694068006,0.634976146579743
7,"Rheinland-Pfalz",7140501,"Boppard, Stadt",15324,7379,7945,0.481532237013835,15611,7488,8123,0.479661776952149,0.0160321593522513,0.348991694068006,0.634976146579743
7,"Rheinland-Pfalz",7141001,"Allendorf",656,339,317,0.516768292682927,652,338,314,0.51840490797546,0.0160321593522513,0.348991694068006,0.634976146579743
7,"Rheinland-Pfalz",7141002,"Altendiez",2217,1065,1152,0.480378890392422,2222,1059,1163,0.476597659765977,0.0160321593522513,0.348991694068006,0.634976146579743
7,"Rheinland-Pfalz",7141003,"Attenhausen",422,209,213,0.495260663507109,403,200,203,0.496277915632754,0.0160321593522513,0.348991694068006,0.634976146579743
7,"Rheinland-Pfalz",7141004,"Auel",196,93,103,0.474489795918367,206,101,105,0.490291262135922,0.0160321593522513,0.348991694068006,0.634976146579743
7,"Rheinland-Pfalz",7141005,"Aull",425,206,219,0.484705882352941,443,212,231,0.478555304740406,0.0160321593522513,0.348991694068006,0.634976146579743
7,"Rheinland-Pfalz",7141006,"Bad Ems, Stadt",8978,4280,4698,0.476720873245712,8962,4241,4721,0.473220263334077,0.0160321593522513,0.348991694068006,0.634976146579743
7,"Rheinland-Pfalz",7141008,"Becheln",656,329,327,0.501524390243902,641,317,324,0.494539781591264,0.0160321593522513,0.348991694068006,0.634976146579743
7,"Rheinland-Pfalz",7141009,"Berg",248,137,111,0.55241935483871,239,133,106,0.556485355648536,0.0160321593522513,0.348991694068006,0.634976146579743
7,"Rheinland-Pfalz",7141010,"Berghausen",320,159,161,0.496875,308,153,155,0.496753246753247,0.0160321593522513,0.348991694068006,0.634976146579743
7,"Rheinland-Pfalz",7141011,"Berndroth",397,197,200,0.496221662468514,397,204,193,0.513853904282116,0.0160321593522513,0.348991694068006,0.634976146579743
7,"Rheinland-Pfalz",7141012,"Bettendorf",342,179,163,0.523391812865497,343,178,165,0.518950437317784,0.0160321593522513,0.348991694068006,0.634976146579743
7,"Rheinland-Pfalz",7141013,"Biebrich",336,174,162,0.517857142857143,325,162,163,0.498461538461538,0.0160321593522513,0.348991694068006,0.634976146579743
7,"Rheinland-Pfalz",7141014,"Birlenbach",1487,741,746,0.49831876260928,1500,746,754,0.497333333333333,0.0160321593522513,0.348991694068006,0.634976146579743
7,"Rheinland-Pfalz",7141015,"Bogel",767,365,402,0.475880052151239,779,383,396,0.491655969191271,0.0160321593522513,0.348991694068006,0.634976146579743
7,"Rheinland-Pfalz",7141016,"Bornich",1049,542,507,0.516682554814109,1044,542,502,0.519157088122605,0.0160321593522513,0.348991694068006,0.634976146579743
7,"Rheinland-Pfalz",7141018,"Bremberg",272,139,133,0.511029411764706,276,139,137,0.503623188405797,0.0160321593522513,0.348991694068006,0.634976146579743
7,"Rheinland-Pfalz",7141019,"Buch",596,296,300,0.496644295302013,623,315,308,0.50561797752809,0.0160321593522513,0.348991694068006,0.634976146579743
7,"Rheinland-Pfalz",7141020,"Burgschwalbach",1025,511,514,0.498536585365854,1071,542,529,0.506069094304388,0.0160321593522513,0.348991694068006,0.634976146579743
7,"Rheinland-Pfalz",7141021,"Charlottenberg",159,74,85,0.465408805031447,159,78,81,0.490566037735849,0.0160321593522513,0.348991694068006,0.634976146579743
7,"Rheinland-Pfalz",7141022,"Cramberg",511,250,261,0.489236790606654,489,240,249,0.49079754601227,0.0160321593522513,0.348991694068006,0.634976146579743
7,"Rheinland-Pfalz",7141023,"Dachsenhausen",1042,519,523,0.498080614203455,1030,526,504,0.510679611650485,0.0160321593522513,0.348991694068006,0.634976146579743
7,"Rheinland-Pfalz",7141024,"Dahlheim",864,439,425,0.508101851851852,848,431,417,0.508254716981132,0.0160321593522513,0.348991694068006,0.634976146579743
7,"Rheinland-Pfalz",7141025,"Dausenau",1277,643,634,0.503523884103367,1313,650,663,0.495049504950495,0.0160321593522513,0.348991694068006,0.634976146579743
7,"Rheinland-Pfalz",7141026,"Dessighofen",185,88,97,0.475675675675676,183,86,97,0.469945355191257,0.0160321593522513,0.348991694068006,0.634976146579743
7,"Rheinland-Pfalz",7141027,"Dienethal",230,116,114,0.504347826086956,222,113,109,0.509009009009009,0.0160321593522513,0.348991694068006,0.634976146579743
7,"Rheinland-Pfalz",7141029,"Diez, Stadt",10813,5462,5351,0.505132710626098,10692,5411,5281,0.506079311634867,0.0160321593522513,0.348991694068006,0.634976146579743
7,"Rheinland-Pfalz",7141030,"Dörnberg",478,243,235,0.50836820083682,561,296,265,0.527629233511586,0.0160321593522513,0.348991694068006,0.634976146579743
7,"Rheinland-Pfalz",7141031,"Dörscheid",409,200,209,0.488997555012225,400,193,207,0.4825,0.0160321593522513,0.348991694068006,0.634976146579743
7,"Rheinland-Pfalz",7141032,"Dörsdorf",431,206,225,0.477958236658933,448,215,233,0.479910714285714,0.0160321593522513,0.348991694068006,0.634976146579743
7,"Rheinland-Pfalz",7141033,"Dornholzhausen",224,112,112,0.5,222,111,111,0.5,0.0160321593522513,0.348991694068006,0.634976146579743
7,"Rheinland-Pfalz",7141034,"Ebertshausen",126,57,69,0.452380952380952,119,55,64,0.46218487394958,0.0160321593522513,0.348991694068006,0.634976146579743
7,"Rheinland-Pfalz",7141035,"Ehr",76,36,40,0.473684210526316,81,40,41,0.493827160493827,0.0160321593522513,0.348991694068006,0.634976146579743
7,"Rheinland-Pfalz",7141036,"Eisighofen",261,140,121,0.53639846743295,271,145,126,0.535055350553506,0.0160321593522513,0.348991694068006,0.634976146579743
7,"Rheinland-Pfalz",7141037,"Endlichhofen",152,83,69,0.546052631578947,152,88,64,0.578947368421053,0.0160321593522513,0.348991694068006,0.634976146579743
7,"Rheinland-Pfalz",7141038,"Eppenrod",724,369,355,0.509668508287293,726,367,359,0.505509641873278,0.0160321593522513,0.348991694068006,0.634976146579743
7,"Rheinland-Pfalz",7141039,"Ergeshausen",143,74,69,0.517482517482518,147,78,69,0.530612244897959,0.0160321593522513,0.348991694068006,0.634976146579743
7,"Rheinland-Pfalz",7141040,"Eschbach",165,78,87,0.472727272727273,164,78,86,0.475609756097561,0.0160321593522513,0.348991694068006,0.634976146579743
7,"Rheinland-Pfalz",7141041,"Fachbach",1258,611,647,0.485691573926868,1279,632,647,0.494136043784206,0.0160321593522513,0.348991694068006,0.634976146579743
7,"Rheinland-Pfalz",7141042,"Filsen",642,327,315,0.509345794392523,623,317,306,0.508828250401284,0.0160321593522513,0.348991694068006,0.634976146579743
7,"Rheinland-Pfalz",7141043,"Flacht",1067,534,533,0.500468603561387,1098,555,543,0.505464480874317,0.0160321593522513,0.348991694068006,0.634976146579743
7,"Rheinland-Pfalz",7141044,"Frücht",609,284,325,0.466338259441708,600,275,325,0.458333333333333,0.0160321593522513,0.348991694068006,0.634976146579743
7,"Rheinland-Pfalz",7141045,"Geilnau",371,177,194,0.477088948787062,370,175,195,0.472972972972973,0.0160321593522513,0.348991694068006,0.634976146579743
7,"Rheinland-Pfalz",7141046,"Geisig",365,185,180,0.506849315068493,371,184,187,0.495956873315364,0.0160321593522513,0.348991694068006,0.634976146579743
7,"Rheinland-Pfalz",7141047,"Gemmerich",556,276,280,0.496402877697842,557,276,281,0.495511669658887,0.0160321593522513,0.348991694068006,0.634976146579743
7,"Rheinland-Pfalz",7141049,"Gückingen",1043,519,524,0.497603068072867,1051,527,524,0.501427212178877,0.0160321593522513,0.348991694068006,0.634976146579743
7,"Rheinland-Pfalz",7141050,"Gutenacker",371,181,190,0.487870619946092,372,186,186,0.5,0.0160321593522513,0.348991694068006,0.634976146579743
7,"Rheinland-Pfalz",7141051,"Hahnstätten",2959,1478,1481,0.499493071983778,2820,1423,1397,0.504609929078014,0.0160321593522513,0.348991694068006,0.634976146579743
7,"Rheinland-Pfalz",7141052,"Hambach",465,230,235,0.494623655913978,472,239,233,0.50635593220339,0.0160321593522513,0.348991694068006,0.634976146579743
7,"Rheinland-Pfalz",7141053,"Heistenbach",1084,519,565,0.478782287822878,1088,519,569,0.477022058823529,0.0160321593522513,0.348991694068006,0.634976146579743
7,"Rheinland-Pfalz",7141054,"Herold",435,206,229,0.473563218390805,453,210,243,0.463576158940397,0.0160321593522513,0.348991694068006,0.634976146579743
7,"Rheinland-Pfalz",7141055,"Himmighofen",311,160,151,0.514469453376206,307,159,148,0.517915309446254,0.0160321593522513,0.348991694068006,0.634976146579743
7,"Rheinland-Pfalz",7141057,"Hirschberg",378,191,187,0.505291005291005,341,165,176,0.483870967741935,0.0160321593522513,0.348991694068006,0.634976146579743
7,"Rheinland-Pfalz",7141058,"Hömberg",360,181,179,0.502777777777778,356,179,177,0.502808988764045,0.0160321593522513,0.348991694068006,0.634976146579743
7,"Rheinland-Pfalz",7141059,"Holzappel",1091,543,548,0.497708524289643,1091,547,544,0.501374885426214,0.0160321593522513,0.348991694068006,0.634976146579743
7,"Rheinland-Pfalz",7141060,"Holzhausen an der Haide",1199,618,581,0.515429524603837,1201,617,584,0.513738551207327,0.0160321593522513,0.348991694068006,0.634976146579743
7,"Rheinland-Pfalz",7141061,"Holzheim",886,447,439,0.50451467268623,856,430,426,0.502336448598131,0.0160321593522513,0.348991694068006,0.634976146579743
7,"Rheinland-Pfalz",7141062,"Horhausen",279,137,142,0.491039426523298,269,124,145,0.460966542750929,0.0160321593522513,0.348991694068006,0.634976146579743
7,"Rheinland-Pfalz",7141063,"Hunzel",259,129,130,0.498069498069498,261,130,131,0.498084291187739,0.0160321593522513,0.348991694068006,0.634976146579743
7,"Rheinland-Pfalz",7141064,"Isselbach",402,202,200,0.502487562189055,416,210,206,0.504807692307692,0.0160321593522513,0.348991694068006,0.634976146579743
7,"Rheinland-Pfalz",7141065,"Kaltenholzhausen",584,290,294,0.496575342465753,589,298,291,0.505942275042445,0.0160321593522513,0.348991694068006,0.634976146579743
7,"Rheinland-Pfalz",7141066,"Kamp-Bornhofen",1584,753,831,0.475378787878788,1579,741,838,0.469284357188094,0.0160321593522513,0.348991694068006,0.634976146579743
7,"Rheinland-Pfalz",7141067,"Kasdorf",224,108,116,0.482142857142857,223,112,111,0.502242152466368,0.0160321593522513,0.348991694068006,0.634976146579743
7,"Rheinland-Pfalz",7141068,"Katzenelnbogen, Stadt",2207,1039,1168,0.470774807430902,2160,1007,1153,0.466203703703704,0.0160321593522513,0.348991694068006,0.634976146579743
7,"Rheinland-Pfalz",7141069,"Kaub, Stadt",877,417,460,0.475484606613455,840,404,436,0.480952380952381,0.0160321593522513,0.348991694068006,0.634976146579743
7,"Rheinland-Pfalz",7141070,"Kehlbach",176,88,88,0.5,175,87,88,0.497142857142857,0.0160321593522513,0.348991694068006,0.634976146579743
7,"Rheinland-Pfalz",7141071,"Kemmenau",452,213,239,0.471238938053097,444,211,233,0.475225225225225,0.0160321593522513,0.348991694068006,0.634976146579743
7,"Rheinland-Pfalz",7141072,"Kestert",632,316,316,0.5,625,308,317,0.4928,0.0160321593522513,0.348991694068006,0.634976146579743
7,"Rheinland-Pfalz",7141073,"Klingelbach",689,333,356,0.483309143686502,711,346,365,0.486638537271449,0.0160321593522513,0.348991694068006,0.634976146579743
7,"Rheinland-Pfalz",7141074,"Kördorf",548,281,267,0.512773722627737,548,279,269,0.509124087591241,0.0160321593522513,0.348991694068006,0.634976146579743
7,"Rheinland-Pfalz",7141075,"Lahnstein, Stadt",17624,8351,9273,0.473842487517022,17795,8578,9217,0.482045518404046,0.0160321593522513,0.348991694068006,0.634976146579743
7,"Rheinland-Pfalz",7141076,"Langenscheid",535,268,267,0.500934579439252,550,274,276,0.498181818181818,0.0160321593522513,0.348991694068006,0.634976146579743
7,"Rheinland-Pfalz",7141077,"Laurenburg",324,165,159,0.509259259259259,303,148,155,0.488448844884488,0.0160321593522513,0.348991694068006,0.634976146579743
7,"Rheinland-Pfalz",7141078,"Lautert",279,144,135,0.516129032258065,288,142,146,0.493055555555556,0.0160321593522513,0.348991694068006,0.634976146579743
7,"Rheinland-Pfalz",7141079,"Lierschied",486,240,246,0.493827160493827,462,232,230,0.502164502164502,0.0160321593522513,0.348991694068006,0.634976146579743
7,"Rheinland-Pfalz",7141080,"Lipporn",281,138,143,0.491103202846975,281,137,144,0.487544483985765,0.0160321593522513,0.348991694068006,0.634976146579743
7,"Rheinland-Pfalz",7141081,"Lohrheim",562,277,285,0.49288256227758,578,290,288,0.501730103806228,0.0160321593522513,0.348991694068006,0.634976146579743
7,"Rheinland-Pfalz",7141082,"Lollschied",202,108,94,0.534653465346535,194,100,94,0.515463917525773,0.0160321593522513,0.348991694068006,0.634976146579743
7,"Rheinland-Pfalz",7141083,"Lykershausen",219,108,111,0.493150684931507,213,105,108,0.492957746478873,0.0160321593522513,0.348991694068006,0.634976146579743
7,"Rheinland-Pfalz",7141084,"Marienfels",309,152,157,0.491909385113269,307,153,154,0.498371335504886,0.0160321593522513,0.348991694068006,0.634976146579743
7,"Rheinland-Pfalz",7141085,"Miehlen",1973,991,982,0.5022807906741,2006,1017,989,0.506979062811565,0.0160321593522513,0.348991694068006,0.634976146579743
7,"Rheinland-Pfalz",7141086,"Miellen",384,196,188,0.510416666666667,401,208,193,0.518703241895262,0.0160321593522513,0.348991694068006,0.634976146579743
7,"Rheinland-Pfalz",7141087,"Misselberg",87,40,47,0.459770114942529,79,35,44,0.443037974683544,0.0160321593522513,0.348991694068006,0.634976146579743
7,"Rheinland-Pfalz",7141088,"Mittelfischbach",125,63,62,0.504,120,60,60,0.5,0.0160321593522513,0.348991694068006,0.634976146579743
7,"Rheinland-Pfalz",7141089,"Mudershausen",407,204,203,0.501228501228501,435,225,210,0.517241379310345,0.0160321593522513,0.348991694068006,0.634976146579743
7,"Rheinland-Pfalz",7141091,"Nassau, Stadt",4615,2273,2342,0.492524377031419,4654,2279,2375,0.489686291362269,0.0160321593522513,0.348991694068006,0.634976146579743
7,"Rheinland-Pfalz",7141092,"Nastätten, Stadt",4167,1992,2175,0.478041756659467,4206,2040,2166,0.485021398002853,0.0160321593522513,0.348991694068006,0.634976146579743
7,"Rheinland-Pfalz",7141093,"Netzbach",369,190,179,0.514905149051491,375,192,183,0.512,0.0160321593522513,0.348991694068006,0.634976146579743
7,"Rheinland-Pfalz",7141094,"Niederbachheim",265,125,140,0.471698113207547,254,125,129,0.492125984251969,0.0160321593522513,0.348991694068006,0.634976146579743
7,"Rheinland-Pfalz",7141095,"Niederneisen",1448,714,734,0.493093922651934,1442,725,717,0.502773925104022,0.0160321593522513,0.348991694068006,0.634976146579743
7,"Rheinland-Pfalz",7141096,"Niedertiefenbach",228,116,112,0.508771929824561,226,112,114,0.495575221238938,0.0160321593522513,0.348991694068006,0.634976146579743
7,"Rheinland-Pfalz",7141097,"Niederwallmenach",421,211,210,0.501187648456057,406,207,199,0.509852216748768,0.0160321593522513,0.348991694068006,0.634976146579743
7,"Rheinland-Pfalz",7141098,"Nievern",987,483,504,0.48936170212766,987,487,500,0.493414387031408,0.0160321593522513,0.348991694068006,0.634976146579743
7,"Rheinland-Pfalz",7141099,"Nochern",525,271,254,0.516190476190476,525,269,256,0.512380952380952,0.0160321593522513,0.348991694068006,0.634976146579743
7,"Rheinland-Pfalz",7141100,"Oberbachheim",198,106,92,0.535353535353535,195,106,89,0.543589743589744,0.0160321593522513,0.348991694068006,0.634976146579743
7,"Rheinland-Pfalz",7141101,"Oberfischbach",169,87,82,0.514792899408284,173,91,82,0.526011560693642,0.0160321593522513,0.348991694068006,0.634976146579743
7,"Rheinland-Pfalz",7141102,"Oberneisen",737,380,357,0.515603799185889,732,383,349,0.523224043715847,0.0160321593522513,0.348991694068006,0.634976146579743
7,"Rheinland-Pfalz",7141103,"Obernhof",358,168,190,0.46927374301676,346,179,167,0.517341040462428,0.0160321593522513,0.348991694068006,0.634976146579743
7,"Rheinland-Pfalz",7141104,"Obertiefenbach",394,200,194,0.50761421319797,381,193,188,0.506561679790026,0.0160321593522513,0.348991694068006,0.634976146579743
7,"Rheinland-Pfalz",7141105,"Oberwallmenach",199,102,97,0.512562814070352,204,101,103,0.495098039215686,0.0160321593522513,0.348991694068006,0.634976146579743
7,"Rheinland-Pfalz",7141106,"Oberwies",147,71,76,0.482993197278912,147,73,74,0.496598639455782,0.0160321593522513,0.348991694068006,0.634976146579743
7,"Rheinland-Pfalz",7141107,"Oelsberg",536,261,275,0.486940298507463,544,265,279,0.487132352941176,0.0160321593522513,0.348991694068006,0.634976146579743
7,"Rheinland-Pfalz",7141108,"Osterspai",1251,621,630,0.496402877697842,1256,623,633,0.496019108280255,0.0160321593522513,0.348991694068006,0.634976146579743
7,"Rheinland-Pfalz",7141109,"Patersberg",400,196,204,0.49,391,190,201,0.485933503836317,0.0160321593522513,0.348991694068006,0.634976146579743
7,"Rheinland-Pfalz",7141110,"Hainau",167,80,87,0.479041916167665,172,84,88,0.488372093023256,0.0160321593522513,0.348991694068006,0.634976146579743
7,"Rheinland-Pfalz",7141111,"Pohl",346,177,169,0.511560693641618,346,177,169,0.511560693641618,0.0160321593522513,0.348991694068006,0.634976146579743
7,"Rheinland-Pfalz",7141112,"Prath",331,171,160,0.516616314199396,325,177,148,0.544615384615385,0.0160321593522513,0.348991694068006,0.634976146579743
7,"Rheinland-Pfalz",7141113,"Reckenroth",213,106,107,0.497652582159624,223,112,111,0.502242152466368,0.0160321593522513,0.348991694068006,0.634976146579743
7,"Rheinland-Pfalz",7141114,"Reichenberg",185,92,93,0.497297297297297,178,85,93,0.47752808988764,0.0160321593522513,0.348991694068006,0.634976146579743
7,"Rheinland-Pfalz",7141115,"Reitzenhain",317,165,152,0.520504731861199,325,169,156,0.52,0.0160321593522513,0.348991694068006,0.634976146579743
7,"Rheinland-Pfalz",7141116,"Rettershain",346,166,180,0.479768786127168,344,175,169,0.508720930232558,0.0160321593522513,0.348991694068006,0.634976146579743
7,"Rheinland-Pfalz",7141117,"Rettert",445,219,226,0.492134831460674,459,219,240,0.477124183006536,0.0160321593522513,0.348991694068006,0.634976146579743
7,"Rheinland-Pfalz",7141118,"Roth",189,91,98,0.481481481481481,177,75,102,0.423728813559322,0.0160321593522513,0.348991694068006,0.634976146579743
7,"Rheinland-Pfalz",7141120,"Ruppertshofen",356,177,179,0.497191011235955,361,189,172,0.523545706371191,0.0160321593522513,0.348991694068006,0.634976146579743
7,"Rheinland-Pfalz",7141121,"Sankt Goarshausen, Loreleystadt, Stadt",1306,631,675,0.483154670750383,1306,641,665,0.490811638591118,0.0160321593522513,0.348991694068006,0.634976146579743
7,"Rheinland-Pfalz",7141122,"Sauerthal",172,88,84,0.511627906976744,193,94,99,0.487046632124352,0.0160321593522513,0.348991694068006,0.634976146579743
7,"Rheinland-Pfalz",7141124,"Scheidt",312,141,171,0.451923076923077,299,130,169,0.434782608695652,0.0160321593522513,0.348991694068006,0.634976146579743
7,"Rheinland-Pfalz",7141125,"Schiesheim",256,124,132,0.484375,260,127,133,0.488461538461538,0.0160321593522513,0.348991694068006,0.634976146579743
7,"Rheinland-Pfalz",7141126,"Schönborn",713,366,347,0.513323983169706,732,375,357,0.512295081967213,0.0160321593522513,0.348991694068006,0.634976146579743
7,"Rheinland-Pfalz",7141127,"Schweighausen",232,114,118,0.491379310344828,228,113,115,0.495614035087719,0.0160321593522513,0.348991694068006,0.634976146579743
7,"Rheinland-Pfalz",7141128,"Seelbach",427,210,217,0.491803278688525,437,212,225,0.48512585812357,0.0160321593522513,0.348991694068006,0.634976146579743
7,"Rheinland-Pfalz",7141129,"Singhofen",1812,895,917,0.4939293598234,1803,885,918,0.490848585690516,0.0160321593522513,0.348991694068006,0.634976146579743
7,"Rheinland-Pfalz",7141130,"Steinsberg",241,123,118,0.510373443983402,245,126,119,0.514285714285714,0.0160321593522513,0.348991694068006,0.634976146579743
7,"Rheinland-Pfalz",7141131,"Strüth",316,154,162,0.487341772151899,319,153,166,0.479623824451411,0.0160321593522513,0.348991694068006,0.634976146579743
7,"Rheinland-Pfalz",7141132,"Sulzbach",210,111,99,0.528571428571429,206,105,101,0.509708737864078,0.0160321593522513,0.348991694068006,0.634976146579743
7,"Rheinland-Pfalz",7141133,"Wasenbach",351,180,171,0.512820512820513,351,181,170,0.515669515669516,0.0160321593522513,0.348991694068006,0.634976146579743
7,"Rheinland-Pfalz",7141134,"Weidenbach",118,63,55,0.533898305084746,108,61,47,0.564814814814815,0.0160321593522513,0.348991694068006,0.634976146579743
7,"Rheinland-Pfalz",7141135,"Weinähr",439,225,214,0.5125284738041,428,224,204,0.523364485981308,0.0160321593522513,0.348991694068006,0.634976146579743
7,"Rheinland-Pfalz",7141136,"Weisel",1087,532,555,0.489420423183073,1069,538,531,0.503274087932647,0.0160321593522513,0.348991694068006,0.634976146579743
7,"Rheinland-Pfalz",7141137,"Welterod",460,247,213,0.53695652173913,475,259,216,0.545263157894737,0.0160321593522513,0.348991694068006,0.634976146579743
7,"Rheinland-Pfalz",7141138,"Weyer",494,246,248,0.497975708502024,481,236,245,0.490644490644491,0.0160321593522513,0.348991694068006,0.634976146579743
7,"Rheinland-Pfalz",7141139,"Winden",703,347,356,0.493598862019915,693,338,355,0.487734487734488,0.0160321593522513,0.348991694068006,0.634976146579743
7,"Rheinland-Pfalz",7141140,"Winterwerb",173,86,87,0.497109826589595,173,86,87,0.497109826589595,0.0160321593522513,0.348991694068006,0.634976146579743
7,"Rheinland-Pfalz",7141141,"Zimmerschied",93,46,47,0.494623655913978,86,42,44,0.488372093023256,0.0160321593522513,0.348991694068006,0.634976146579743
7,"Rheinland-Pfalz",7141201,"Arzbach",1699,802,897,0.472042377869335,1712,809,903,0.472546728971963,0.0160321593522513,0.348991694068006,0.634976146579743
7,"Rheinland-Pfalz",7141501,"Braubach, Stadt",3060,1499,1561,0.489869281045752,3019,1490,1529,0.493540907585293,0.0160321593522513,0.348991694068006,0.634976146579743
7,"Rheinland-Pfalz",7141502,"Diethardt",238,119,119,0.5,257,131,126,0.509727626459144,0.0160321593522513,0.348991694068006,0.634976146579743
7,"Rheinland-Pfalz",7141503,"Balduinstein",569,281,288,0.493848857644991,562,270,292,0.480427046263345,0.0160321593522513,0.348991694068006,0.634976146579743
7,"Rheinland-Pfalz",7143001,"Alsbach",619,314,305,0.507269789983845,596,304,292,0.51006711409396,0.0160321593522513,0.348991694068006,0.634976146579743
7,"Rheinland-Pfalz",7143003,"Bannberscheid",633,311,322,0.4913112164297,616,296,320,0.480519480519481,0.0160321593522513,0.348991694068006,0.634976146579743
7,"Rheinland-Pfalz",7143005,"Boden",579,266,313,0.459412780656304,568,264,304,0.464788732394366,0.0160321593522513,0.348991694068006,0.634976146579743
7,"Rheinland-Pfalz",7143006,"Breitenau",652,322,330,0.493865030674847,638,317,321,0.496865203761755,0.0160321593522513,0.348991694068006,0.634976146579743
7,"Rheinland-Pfalz",7143007,"Caan",699,347,352,0.496423462088698,714,357,357,0.5,0.0160321593522513,0.348991694068006,0.634976146579743
7,"Rheinland-Pfalz",7143008,"Daubach",464,233,231,0.502155172413793,461,237,224,0.51409978308026,0.0160321593522513,0.348991694068006,0.634976146579743
7,"Rheinland-Pfalz",7143009,"Deesen",678,340,338,0.501474926253687,667,340,327,0.509745127436282,0.0160321593522513,0.348991694068006,0.634976146579743
7,"Rheinland-Pfalz",7143010,"Dernbach (Westerwald)",2375,1077,1298,0.453473684210526,2304,1015,1289,0.440538194444444,0.0160321593522513,0.348991694068006,0.634976146579743
7,"Rheinland-Pfalz",7143011,"Dreikirchen",1034,512,522,0.495164410058027,1015,498,517,0.49064039408867,0.0160321593522513,0.348991694068006,0.634976146579743
7,"Rheinland-Pfalz",7143012,"Ebernhahn",1228,626,602,0.509771986970684,1225,614,611,0.501224489795918,0.0160321593522513,0.348991694068006,0.634976146579743
7,"Rheinland-Pfalz",7143013,"Eitelborn",2410,1179,1231,0.489211618257261,2437,1191,1246,0.4887156339762,0.0160321593522513,0.348991694068006,0.634976146579743
7,"Rheinland-Pfalz",7143015,"Ellenhausen",305,155,150,0.508196721311475,276,137,139,0.496376811594203,0.0160321593522513,0.348991694068006,0.634976146579743
7,"Rheinland-Pfalz",7143018,"Freilingen",697,360,337,0.516499282639885,703,362,341,0.514935988620199,0.0160321593522513,0.348991694068006,0.634976146579743
7,"Rheinland-Pfalz",7143019,"Freirachdorf",652,319,333,0.489263803680982,646,320,326,0.495356037151703,0.0160321593522513,0.348991694068006,0.634976146579743
7,"Rheinland-Pfalz",7143020,"Gackenbach",527,279,248,0.529411764705882,545,291,254,0.53394495412844,0.0160321593522513,0.348991694068006,0.634976146579743
7,"Rheinland-Pfalz",7143021,"Girod",1196,602,594,0.503344481605351,1216,613,603,0.504111842105263,0.0160321593522513,0.348991694068006,0.634976146579743
7,"Rheinland-Pfalz",7143022,"Goddert",417,212,205,0.508393285371703,419,215,204,0.513126491646778,0.0160321593522513,0.348991694068006,0.634976146579743
7,"Rheinland-Pfalz",7143023,"Görgeshausen",828,430,398,0.519323671497585,817,418,399,0.511627906976744,0.0160321593522513,0.348991694068006,0.634976146579743
7,"Rheinland-Pfalz",7143024,"Großholbach",986,502,484,0.509127789046653,976,496,480,0.508196721311475,0.0160321593522513,0.348991694068006,0.634976146579743
7,"Rheinland-Pfalz",7143025,"Hartenfels",827,414,413,0.500604594921403,832,420,412,0.504807692307692,0.0160321593522513,0.348991694068006,0.634976146579743
7,"Rheinland-Pfalz",7143026,"Heilberscheid",671,344,327,0.512667660208644,656,341,315,0.519817073170732,0.0160321593522513,0.348991694068006,0.634976146579743
7,"Rheinland-Pfalz",7143027,"Heiligenroth",1392,679,713,0.487787356321839,1414,697,717,0.492927864214993,0.0160321593522513,0.348991694068006,0.634976146579743
7,"Rheinland-Pfalz",7143028,"Helferskirchen",1139,585,554,0.513608428446005,1127,564,563,0.500443655723159,0.0160321593522513,0.348991694068006,0.634976146579743
7,"Rheinland-Pfalz",7143029,"Herschbach",2810,1412,1398,0.502491103202847,2828,1423,1405,0.503182461103253,0.0160321593522513,0.348991694068006,0.634976146579743
7,"Rheinland-Pfalz",7143030,"Hilgert",1531,755,776,0.493141737426519,1536,763,773,0.496744791666667,0.0160321593522513,0.348991694068006,0.634976146579743
7,"Rheinland-Pfalz",7143031,"Hillscheid",2465,1225,1240,0.496957403651116,2440,1210,1230,0.495901639344262,0.0160321593522513,0.348991694068006,0.634976146579743
7,"Rheinland-Pfalz",7143032,"Höhr-Grenzhausen, Stadt",9177,4432,4745,0.482946496676474,9131,4408,4723,0.482751067791041,0.0160321593522513,0.348991694068006,0.634976146579743
7,"Rheinland-Pfalz",7143033,"Holler",1040,516,524,0.496153846153846,1031,497,534,0.482056256062076,0.0160321593522513,0.348991694068006,0.634976146579743
7,"Rheinland-Pfalz",7143034,"Horbach",686,352,334,0.513119533527697,701,353,348,0.503566333808845,0.0160321593522513,0.348991694068006,0.634976146579743
7,"Rheinland-Pfalz",7143036,"Hübingen",517,266,251,0.514506769825919,525,268,257,0.510476190476191,0.0160321593522513,0.348991694068006,0.634976146579743
7,"Rheinland-Pfalz",7143037,"Hundsangen",2055,1006,1049,0.489537712895377,2054,1012,1042,0.49269717624148,0.0160321593522513,0.348991694068006,0.634976146579743
7,"Rheinland-Pfalz",7143038,"Hundsdorf",464,238,226,0.512931034482759,468,248,220,0.52991452991453,0.0160321593522513,0.348991694068006,0.634976146579743
7,"Rheinland-Pfalz",7143039,"Kadenbach",1380,692,688,0.501449275362319,1366,690,676,0.505124450951684,0.0160321593522513,0.348991694068006,0.634976146579743
7,"Rheinland-Pfalz",7143040,"Kammerforst",251,128,123,0.50996015936255,243,119,124,0.489711934156379,0.0160321593522513,0.348991694068006,0.634976146579743
7,"Rheinland-Pfalz",7143041,"Krümmel",334,183,151,0.547904191616767,335,178,157,0.53134328358209,0.0160321593522513,0.348991694068006,0.634976146579743
7,"Rheinland-Pfalz",7143042,"Leuterod",868,454,414,0.523041474654378,857,459,398,0.53558926487748,0.0160321593522513,0.348991694068006,0.634976146579743
7,"Rheinland-Pfalz",7143044,"Marienrachdorf",984,469,515,0.476626016260163,1011,480,531,0.474777448071217,0.0160321593522513,0.348991694068006,0.634976146579743
7,"Rheinland-Pfalz",7143045,"Maroth",229,124,105,0.541484716157205,246,133,113,0.540650406504065,0.0160321593522513,0.348991694068006,0.634976146579743
7,"Rheinland-Pfalz",7143046,"Maxsain",1077,555,522,0.515320334261838,1113,567,546,0.509433962264151,0.0160321593522513,0.348991694068006,0.634976146579743
7,"Rheinland-Pfalz",7143047,"Mogendorf",1199,612,587,0.510425354462052,1161,592,569,0.509905254091301,0.0160321593522513,0.348991694068006,0.634976146579743
7,"Rheinland-Pfalz",7143048,"Montabaur, Stadt",12427,5925,6502,0.47678442101875,12361,5931,6430,0.47981554890381,0.0160321593522513,0.348991694068006,0.634976146579743
7,"Rheinland-Pfalz",7143049,"Moschheim",753,379,374,0.50332005312085,753,380,373,0.50464807436919,0.0160321593522513,0.348991694068006,0.634976146579743
7,"Rheinland-Pfalz",7143050,"Nauort",2269,1090,1179,0.480387836051124,2289,1103,1186,0.481869812145041,0.0160321593522513,0.348991694068006,0.634976146579743
7,"Rheinland-Pfalz",7143051,"Nentershausen",1987,986,1001,0.496225465525918,1975,984,991,0.498227848101266,0.0160321593522513,0.348991694068006,0.634976146579743
7,"Rheinland-Pfalz",7143052,"Neuhäusel",2027,995,1032,0.490873211642822,1974,963,1011,0.487841945288754,0.0160321593522513,0.348991694068006,0.634976146579743
7,"Rheinland-Pfalz",7143053,"Niederelbert",1636,794,842,0.485330073349633,1612,788,824,0.488833746898263,0.0160321593522513,0.348991694068006,0.634976146579743
7,"Rheinland-Pfalz",7143054,"Niedererbach",1009,502,507,0.497522299306244,1008,490,518,0.486111111111111,0.0160321593522513,0.348991694068006,0.634976146579743
7,"Rheinland-Pfalz",7143055,"Nomborn",726,343,383,0.472451790633609,725,343,382,0.473103448275862,0.0160321593522513,0.348991694068006,0.634976146579743
7,"Rheinland-Pfalz",7143056,"Nordhofen",554,286,268,0.516245487364621,550,288,262,0.523636363636364,0.0160321593522513,0.348991694068006,0.634976146579743
7,"Rheinland-Pfalz",7143057,"Oberelbert",1101,562,539,0.510445049954587,1081,543,538,0.502312673450509,0.0160321593522513,0.348991694068006,0.634976146579743
7,"Rheinland-Pfalz",7143058,"Obererbach",531,258,273,0.485875706214689,534,265,269,0.49625468164794,0.0160321593522513,0.348991694068006,0.634976146579743
7,"Rheinland-Pfalz",7143059,"Oberhaid",408,204,204,0.5,396,195,201,0.492424242424242,0.0160321593522513,0.348991694068006,0.634976146579743
7,"Rheinland-Pfalz",7143060,"Ötzingen",1378,700,678,0.507982583454282,1330,669,661,0.503007518796992,0.0160321593522513,0.348991694068006,0.634976146579743
7,"Rheinland-Pfalz",7143061,"Quirnbach",513,241,272,0.469785575048733,531,269,262,0.506591337099812,0.0160321593522513,0.348991694068006,0.634976146579743
7,"Rheinland-Pfalz",7143062,"Ransbach-Baumbach, Stadt",7404,3596,3808,0.48568341437061,7465,3651,3814,0.489082384460817,0.0160321593522513,0.348991694068006,0.634976146579743
7,"Rheinland-Pfalz",7143064,"Rückeroth",517,254,263,0.491295938104449,531,256,275,0.48210922787194,0.0160321593522513,0.348991694068006,0.634976146579743
7,"Rheinland-Pfalz",7143065,"Ruppach-Goldhausen",1207,598,609,0.495443247721624,1177,579,598,0.491928632115548,0.0160321593522513,0.348991694068006,0.634976146579743
7,"Rheinland-Pfalz",7143066,"Schenkelberg",644,306,338,0.475155279503106,669,332,337,0.496263079222721,0.0160321593522513,0.348991694068006,0.634976146579743
7,"Rheinland-Pfalz",7143067,"Selters (Westerwald), Stadt",2775,1364,1411,0.491531531531532,2707,1343,1364,0.496121167343923,0.0160321593522513,0.348991694068006,0.634976146579743
7,"Rheinland-Pfalz",7143068,"Sessenbach",478,240,238,0.502092050209205,494,251,243,0.508097165991903,0.0160321593522513,0.348991694068006,0.634976146579743
7,"Rheinland-Pfalz",7143069,"Sessenhausen",949,468,481,0.493150684931507,934,468,466,0.501070663811563,0.0160321593522513,0.348991694068006,0.634976146579743
7,"Rheinland-Pfalz",7143070,"Siershahn",2763,1366,1397,0.494390155627941,2742,1346,1396,0.490882567469001,0.0160321593522513,0.348991694068006,0.634976146579743
7,"Rheinland-Pfalz",7143071,"Simmern",1498,779,719,0.520026702269693,1420,758,662,0.533802816901408,0.0160321593522513,0.348991694068006,0.634976146579743
7,"Rheinland-Pfalz",7143072,"Stahlhofen",727,358,369,0.492434662998624,723,352,371,0.48686030428769,0.0160321593522513,0.348991694068006,0.634976146579743
7,"Rheinland-Pfalz",7143073,"Staudt",1109,534,575,0.481514878268711,1084,513,571,0.473247232472325,0.0160321593522513,0.348991694068006,0.634976146579743
7,"Rheinland-Pfalz",7143074,"Steinefrenz",769,376,393,0.488946684005202,747,357,390,0.477911646586345,0.0160321593522513,0.348991694068006,0.634976146579743
7,"Rheinland-Pfalz",7143075,"Steinen",251,138,113,0.549800796812749,240,132,108,0.55,0.0160321593522513,0.348991694068006,0.634976146579743
7,"Rheinland-Pfalz",7143077,"Untershausen",487,247,240,0.507186858316222,502,257,245,0.51195219123506,0.0160321593522513,0.348991694068006,0.634976146579743
7,"Rheinland-Pfalz",7143078,"Vielbach",538,272,266,0.505576208178439,531,270,261,0.508474576271186,0.0160321593522513,0.348991694068006,0.634976146579743
7,"Rheinland-Pfalz",7143079,"Welschneudorf",965,479,486,0.496373056994819,960,491,469,0.511458333333333,0.0160321593522513,0.348991694068006,0.634976146579743
7,"Rheinland-Pfalz",7143080,"Weroth",621,311,310,0.500805152979066,597,301,296,0.504187604690117,0.0160321593522513,0.348991694068006,0.634976146579743
7,"Rheinland-Pfalz",7143081,"Wirges, Stadt",5252,2505,2747,0.476961157654227,5061,2398,2663,0.473819403279984,0.0160321593522513,0.348991694068006,0.634976146579743
7,"Rheinland-Pfalz",7143082,"Wirscheid",332,172,160,0.518072289156627,327,176,151,0.53822629969419,0.0160321593522513,0.348991694068006,0.634976146579743
7,"Rheinland-Pfalz",7143084,"Wittgert",637,320,317,0.502354788069074,663,337,326,0.508295625942685,0.0160321593522513,0.348991694068006,0.634976146579743
7,"Rheinland-Pfalz",7143085,"Wölferlingen",513,260,253,0.50682261208577,522,269,253,0.515325670498084,0.0160321593522513,0.348991694068006,0.634976146579743
7,"Rheinland-Pfalz",7143200,"Ailertchen",611,308,303,0.504091653027823,605,308,297,0.509090909090909,0.0160321593522513,0.348991694068006,0.634976146579743
7,"Rheinland-Pfalz",7143202,"Alpenrod",1532,767,765,0.50065274151436,1549,768,781,0.495803744351194,0.0160321593522513,0.348991694068006,0.634976146579743
7,"Rheinland-Pfalz",7143203,"Arnshöfen",152,76,76,0.5,152,72,80,0.473684210526316,0.0160321593522513,0.348991694068006,0.634976146579743
7,"Rheinland-Pfalz",7143204,"Astert",239,113,126,0.472803347280335,248,119,129,0.479838709677419,0.0160321593522513,0.348991694068006,0.634976146579743
7,"Rheinland-Pfalz",7143205,"Atzelgift",643,330,313,0.513219284603421,646,331,315,0.512383900928793,0.0160321593522513,0.348991694068006,0.634976146579743
7,"Rheinland-Pfalz",7143206,"Bad Marienberg (Westerwald), Stadt",5819,2850,2969,0.489774875408146,5594,2740,2854,0.489810511262066,0.0160321593522513,0.348991694068006,0.634976146579743
7,"Rheinland-Pfalz",7143207,"Bellingen",603,309,294,0.512437810945274,582,294,288,0.505154639175258,0.0160321593522513,0.348991694068006,0.634976146579743
7,"Rheinland-Pfalz",7143208,"Berod bei Wallmerod",551,277,274,0.502722323049002,550,275,275,0.5,0.0160321593522513,0.348991694068006,0.634976146579743
7,"Rheinland-Pfalz",7143209,"Berzhahn",490,244,246,0.497959183673469,495,252,243,0.509090909090909,0.0160321593522513,0.348991694068006,0.634976146579743
7,"Rheinland-Pfalz",7143210,"Bilkheim",483,246,237,0.509316770186335,493,257,236,0.521298174442191,0.0160321593522513,0.348991694068006,0.634976146579743
7,"Rheinland-Pfalz",7143211,"Bölsberg",253,128,125,0.505928853754941,259,130,129,0.501930501930502,0.0160321593522513,0.348991694068006,0.634976146579743
7,"Rheinland-Pfalz",7143212,"Borod",540,259,281,0.47962962962963,559,270,289,0.483005366726297,0.0160321593522513,0.348991694068006,0.634976146579743
7,"Rheinland-Pfalz",7143213,"Brandscheid",485,249,236,0.51340206185567,483,258,225,0.53416149068323,0.0160321593522513,0.348991694068006,0.634976146579743
7,"Rheinland-Pfalz",7143214,"Bretthausen",169,89,80,0.526627218934911,173,88,85,0.508670520231214,0.0160321593522513,0.348991694068006,0.634976146579743
7,"Rheinland-Pfalz",7143215,"Dreifelden",240,123,117,0.5125,269,140,129,0.520446096654275,0.0160321593522513,0.348991694068006,0.634976146579743
7,"Rheinland-Pfalz",7143216,"Dreisbach",606,303,303,0.5,601,307,294,0.510815307820299,0.0160321593522513,0.348991694068006,0.634976146579743
7,"Rheinland-Pfalz",7143218,"Elsoff (Westerwald)",913,458,455,0.501642935377875,916,463,453,0.505458515283843,0.0160321593522513,0.348991694068006,0.634976146579743
7,"Rheinland-Pfalz",7143219,"Enspel",308,152,156,0.493506493506494,286,145,141,0.506993006993007,0.0160321593522513,0.348991694068006,0.634976146579743
7,"Rheinland-Pfalz",7143220,"Ettinghausen",323,162,161,0.501547987616099,314,156,158,0.496815286624204,0.0160321593522513,0.348991694068006,0.634976146579743
7,"Rheinland-Pfalz",7143221,"Ewighausen",236,114,122,0.483050847457627,242,121,121,0.5,0.0160321593522513,0.348991694068006,0.634976146579743
7,"Rheinland-Pfalz",7143222,"Fehl-Ritzhausen",810,420,390,0.518518518518518,809,426,383,0.526576019777503,0.0160321593522513,0.348991694068006,0.634976146579743
7,"Rheinland-Pfalz",7143223,"Gehlert",610,294,316,0.481967213114754,596,282,314,0.473154362416107,0.0160321593522513,0.348991694068006,0.634976146579743
7,"Rheinland-Pfalz",7143224,"Gemünden",1039,500,539,0.481231953801732,1011,476,535,0.47082096933729,0.0160321593522513,0.348991694068006,0.634976146579743
7,"Rheinland-Pfalz",7143225,"Giesenhausen",335,166,169,0.495522388059702,338,172,166,0.50887573964497,0.0160321593522513,0.348991694068006,0.634976146579743
7,"Rheinland-Pfalz",7143226,"Girkenroth",579,305,274,0.526770293609672,583,313,270,0.536878216123499,0.0160321593522513,0.348991694068006,0.634976146579743
7,"Rheinland-Pfalz",7143227,"Großseifen",590,289,301,0.489830508474576,608,305,303,0.501644736842105,0.0160321593522513,0.348991694068006,0.634976146579743
7,"Rheinland-Pfalz",7143228,"Guckheim",919,457,462,0.49727965179543,920,467,453,0.507608695652174,0.0160321593522513,0.348991694068006,0.634976146579743
7,"Rheinland-Pfalz",7143229,"Hachenburg, Stadt",5855,2709,3146,0.46268146883006,5676,2681,2995,0.472339675828048,0.0160321593522513,0.348991694068006,0.634976146579743
7,"Rheinland-Pfalz",7143230,"Härtlingen",405,201,204,0.496296296296296,417,214,203,0.513189448441247,0.0160321593522513,0.348991694068006,0.634976146579743
7,"Rheinland-Pfalz",7143231,"Hahn bei Marienberg",456,234,222,0.513157894736842,435,220,215,0.505747126436782,0.0160321593522513,0.348991694068006,0.634976146579743
7,"Rheinland-Pfalz",7143232,"Hahn am See",398,199,199,0.5,397,199,198,0.501259445843829,0.0160321593522513,0.348991694068006,0.634976146579743
7,"Rheinland-Pfalz",7143233,"Halbs",367,173,194,0.471389645776567,338,162,176,0.479289940828402,0.0160321593522513,0.348991694068006,0.634976146579743
7,"Rheinland-Pfalz",7143234,"Hardt",428,210,218,0.490654205607477,437,215,222,0.491990846681922,0.0160321593522513,0.348991694068006,0.634976146579743
7,"Rheinland-Pfalz",7143235,"Hattert",1738,891,847,0.512658227848101,1696,860,836,0.507075471698113,0.0160321593522513,0.348991694068006,0.634976146579743
7,"Rheinland-Pfalz",7143236,"Heimborn",280,140,140,0.5,288,143,145,0.496527777777778,0.0160321593522513,0.348991694068006,0.634976146579743
7,"Rheinland-Pfalz",7143237,"Hellenhahn-Schellenberg",1254,625,629,0.498405103668262,1274,634,640,0.497645211930926,0.0160321593522513,0.348991694068006,0.634976146579743
7,"Rheinland-Pfalz",7143238,"Hergenroth",440,218,222,0.495454545454545,429,207,222,0.482517482517482,0.0160321593522513,0.348991694068006,0.634976146579743
7,"Rheinland-Pfalz",7143239,"Herschbach (Oberwesterwald)",956,468,488,0.489539748953975,979,502,477,0.512768130745659,0.0160321593522513,0.348991694068006,0.634976146579743
7,"Rheinland-Pfalz",7143240,"Heuzert",123,67,56,0.544715447154472,125,69,56,0.552,0.0160321593522513,0.348991694068006,0.634976146579743
7,"Rheinland-Pfalz",7143241,"Höchstenbach",677,347,330,0.512555391432792,670,340,330,0.507462686567164,0.0160321593522513,0.348991694068006,0.634976146579743
7,"Rheinland-Pfalz",7143242,"Höhn",3095,1543,1552,0.498546042003231,3076,1573,1503,0.511378413524057,0.0160321593522513,0.348991694068006,0.634976146579743
7,"Rheinland-Pfalz",7143243,"Hof",1306,646,660,0.494640122511485,1205,569,636,0.472199170124481,0.0160321593522513,0.348991694068006,0.634976146579743
7,"Rheinland-Pfalz",7143244,"Homberg",180,98,82,0.544444444444444,165,88,77,0.533333333333333,0.0160321593522513,0.348991694068006,0.634976146579743
7,"Rheinland-Pfalz",7143245,"Hüblingen",306,152,154,0.496732026143791,300,146,154,0.486666666666667,0.0160321593522513,0.348991694068006,0.634976146579743
7,"Rheinland-Pfalz",7143246,"Irmtraut",797,377,420,0.473023839397742,757,363,394,0.479524438573316,0.0160321593522513,0.348991694068006,0.634976146579743
7,"Rheinland-Pfalz",7143247,"Kaden",613,309,304,0.504078303425775,603,303,300,0.502487562189055,0.0160321593522513,0.348991694068006,0.634976146579743
7,"Rheinland-Pfalz",7143248,"Kirburg",560,278,282,0.496428571428571,561,269,292,0.479500891265597,0.0160321593522513,0.348991694068006,0.634976146579743
7,"Rheinland-Pfalz",7143249,"Kölbingen",1038,503,535,0.484585741811175,1038,499,539,0.480732177263969,0.0160321593522513,0.348991694068006,0.634976146579743
7,"Rheinland-Pfalz",7143250,"Kroppach",646,315,331,0.487616099071207,644,315,329,0.489130434782609,0.0160321593522513,0.348991694068006,0.634976146579743
7,"Rheinland-Pfalz",7143251,"Kuhnhöfen",155,80,75,0.516129032258065,154,80,74,0.519480519480519,0.0160321593522513,0.348991694068006,0.634976146579743
7,"Rheinland-Pfalz",7143252,"Kundert",276,144,132,0.521739130434783,272,144,128,0.529411764705882,0.0160321593522513,0.348991694068006,0.634976146579743
7,"Rheinland-Pfalz",7143253,"Langenbach bei Kirburg",1084,521,563,0.480627306273063,1048,488,560,0.465648854961832,0.0160321593522513,0.348991694068006,0.634976146579743
7,"Rheinland-Pfalz",7143254,"Langenhahn",1326,669,657,0.504524886877828,1351,701,650,0.518874907475944,0.0160321593522513,0.348991694068006,0.634976146579743
7,"Rheinland-Pfalz",7143255,"Lautzenbrücken",390,201,189,0.515384615384615,392,207,185,0.528061224489796,0.0160321593522513,0.348991694068006,0.634976146579743
7,"Rheinland-Pfalz",7143256,"Liebenscheid",879,446,433,0.507394766780432,921,464,457,0.503800217155266,0.0160321593522513,0.348991694068006,0.634976146579743
7,"Rheinland-Pfalz",7143257,"Limbach",445,229,216,0.514606741573034,433,222,211,0.51270207852194,0.0160321593522513,0.348991694068006,0.634976146579743
7,"Rheinland-Pfalz",7143258,"Linden",145,77,68,0.531034482758621,149,84,65,0.563758389261745,0.0160321593522513,0.348991694068006,0.634976146579743
7,"Rheinland-Pfalz",7143259,"Lochum",311,156,155,0.501607717041801,308,155,153,0.503246753246753,0.0160321593522513,0.348991694068006,0.634976146579743
7,"Rheinland-Pfalz",7143260,"Luckenbach",609,303,306,0.497536945812808,611,303,308,0.495908346972177,0.0160321593522513,0.348991694068006,0.634976146579743
7,"Rheinland-Pfalz",7143261,"Marzhausen",253,129,124,0.509881422924901,245,126,119,0.514285714285714,0.0160321593522513,0.348991694068006,0.634976146579743
7,"Rheinland-Pfalz",7143262,"Merkelbach",427,226,201,0.529274004683841,422,221,201,0.523696682464455,0.0160321593522513,0.348991694068006,0.634976146579743
7,"Rheinland-Pfalz",7143263,"Meudt",1874,921,953,0.491462113127001,1844,915,929,0.496203904555315,0.0160321593522513,0.348991694068006,0.634976146579743
7,"Rheinland-Pfalz",7143264,"Mörlen",564,290,274,0.514184397163121,558,287,271,0.514336917562724,0.0160321593522513,0.348991694068006,0.634976146579743
7,"Rheinland-Pfalz",7143265,"Mörsbach",455,225,230,0.494505494505495,455,220,235,0.483516483516484,0.0160321593522513,0.348991694068006,0.634976146579743
7,"Rheinland-Pfalz",7143266,"Molsberg",428,201,227,0.469626168224299,450,214,236,0.475555555555556,0.0160321593522513,0.348991694068006,0.634976146579743
7,"Rheinland-Pfalz",7143267,"Mudenbach",755,375,380,0.496688741721854,783,394,389,0.503192848020434,0.0160321593522513,0.348991694068006,0.634976146579743
7,"Rheinland-Pfalz",7143268,"Mündersbach",752,371,381,0.493351063829787,739,365,374,0.493910690121786,0.0160321593522513,0.348991694068006,0.634976146579743
7,"Rheinland-Pfalz",7143269,"Müschenbach",999,497,502,0.497497497497497,996,495,501,0.496987951807229,0.0160321593522513,0.348991694068006,0.634976146579743
7,"Rheinland-Pfalz",7143270,"Neunkhausen",1101,565,536,0.513169845594914,1102,575,527,0.521778584392015,0.0160321593522513,0.348991694068006,0.634976146579743
7,"Rheinland-Pfalz",7143271,"Neunkirchen",555,281,274,0.506306306306306,565,278,287,0.492035398230089,0.0160321593522513,0.348991694068006,0.634976146579743
7,"Rheinland-Pfalz",7143272,"Neustadt/ Westerwald",590,285,305,0.483050847457627,545,268,277,0.491743119266055,0.0160321593522513,0.348991694068006,0.634976146579743
7,"Rheinland-Pfalz",7143273,"Niederahr",828,413,415,0.498792270531401,833,414,419,0.496998799519808,0.0160321593522513,0.348991694068006,0.634976146579743
7,"Rheinland-Pfalz",7143274,"Niederroßbach",778,393,385,0.505141388174807,797,407,390,0.510664993726474,0.0160321593522513,0.348991694068006,0.634976146579743
7,"Rheinland-Pfalz",7143275,"Niedersayn",181,92,89,0.50828729281768,198,106,92,0.535353535353535,0.0160321593522513,0.348991694068006,0.634976146579743
7,"Rheinland-Pfalz",7143276,"Nister",964,477,487,0.494813278008299,955,472,483,0.494240837696335,0.0160321593522513,0.348991694068006,0.634976146579743
7,"Rheinland-Pfalz",7143277,"Nisterau",896,454,442,0.506696428571429,905,461,444,0.50939226519337,0.0160321593522513,0.348991694068006,0.634976146579743
7,"Rheinland-Pfalz",7143278,"Nister-Möhrendorf",319,157,162,0.492163009404389,320,156,164,0.4875,0.0160321593522513,0.348991694068006,0.634976146579743
7,"Rheinland-Pfalz",7143279,"Nistertal",1273,673,600,0.528672427336999,1279,667,612,0.521501172791243,0.0160321593522513,0.348991694068006,0.634976146579743
7,"Rheinland-Pfalz",7143280,"Norken",998,510,488,0.511022044088176,1001,510,491,0.509490509490509,0.0160321593522513,0.348991694068006,0.634976146579743
7,"Rheinland-Pfalz",7143281,"Oberahr",570,301,269,0.528070175438596,568,301,267,0.529929577464789,0.0160321593522513,0.348991694068006,0.634976146579743
7,"Rheinland-Pfalz",7143282,"Oberrod",702,351,351,0.5,716,371,345,0.518156424581006,0.0160321593522513,0.348991694068006,0.634976146579743
7,"Rheinland-Pfalz",7143283,"Oberroßbach",338,183,155,0.541420118343195,343,196,147,0.571428571428571,0.0160321593522513,0.348991694068006,0.634976146579743
7,"Rheinland-Pfalz",7143284,"Pottum",985,488,497,0.495431472081218,1000,500,500,0.5,0.0160321593522513,0.348991694068006,0.634976146579743
7,"Rheinland-Pfalz",7143285,"Rehe",961,481,480,0.500520291363163,957,483,474,0.504702194357367,0.0160321593522513,0.348991694068006,0.634976146579743
7,"Rheinland-Pfalz",7143286,"Rennerod, Stadt",4064,2035,2029,0.500738188976378,3765,1884,1881,0.500398406374502,0.0160321593522513,0.348991694068006,0.634976146579743
7,"Rheinland-Pfalz",7143287,"Roßbach",827,423,404,0.511487303506651,825,420,405,0.509090909090909,0.0160321593522513,0.348991694068006,0.634976146579743
7,"Rheinland-Pfalz",7143288,"Rotenhain",560,296,264,0.528571428571429,553,304,249,0.549728752260398,0.0160321593522513,0.348991694068006,0.634976146579743
7,"Rheinland-Pfalz",7143289,"Rothenbach",887,465,422,0.52423900789177,881,457,424,0.518728717366629,0.0160321593522513,0.348991694068006,0.634976146579743
7,"Rheinland-Pfalz",7143290,"Salz",866,419,447,0.483833718244804,898,440,458,0.489977728285078,0.0160321593522513,0.348991694068006,0.634976146579743
7,"Rheinland-Pfalz",7143291,"Salzburg",252,123,129,0.488095238095238,228,117,111,0.513157894736842,0.0160321593522513,0.348991694068006,0.634976146579743
7,"Rheinland-Pfalz",7143292,"Seck",1246,633,613,0.508025682182986,1280,660,620,0.515625,0.0160321593522513,0.348991694068006,0.634976146579743
7,"Rheinland-Pfalz",7143293,"Stahlhofen am Wiesensee",318,158,160,0.49685534591195,344,178,166,0.517441860465116,0.0160321593522513,0.348991694068006,0.634976146579743
7,"Rheinland-Pfalz",7143294,"Steinebach an der Wied",779,396,383,0.508344030808729,793,416,377,0.524590163934426,0.0160321593522513,0.348991694068006,0.634976146579743
7,"Rheinland-Pfalz",7143295,"Stein-Neukirch",419,207,212,0.494033412887828,432,221,211,0.511574074074074,0.0160321593522513,0.348991694068006,0.634976146579743
7,"Rheinland-Pfalz",7143296,"Stein-Wingert",224,106,118,0.473214285714286,195,88,107,0.451282051282051,0.0160321593522513,0.348991694068006,0.634976146579743
7,"Rheinland-Pfalz",7143297,"Stockhausen-Illfurth",487,239,248,0.490759753593429,471,247,224,0.524416135881104,0.0160321593522513,0.348991694068006,0.634976146579743
7,"Rheinland-Pfalz",7143298,"Stockum-Püschen",658,321,337,0.487841945288754,648,317,331,0.489197530864198,0.0160321593522513,0.348991694068006,0.634976146579743
7,"Rheinland-Pfalz",7143299,"Streithausen",543,276,267,0.50828729281768,531,280,251,0.527306967984934,0.0160321593522513,0.348991694068006,0.634976146579743
7,"Rheinland-Pfalz",7143300,"Unnau",1885,952,933,0.505039787798409,1816,913,903,0.502753303964758,0.0160321593522513,0.348991694068006,0.634976146579743
7,"Rheinland-Pfalz",7143301,"Wahlrod",856,414,442,0.483644859813084,866,432,434,0.498845265588915,0.0160321593522513,0.348991694068006,0.634976146579743
7,"Rheinland-Pfalz",7143302,"Waigandshain",192,95,97,0.494791666666667,189,95,94,0.502645502645503,0.0160321593522513,0.348991694068006,0.634976146579743
7,"Rheinland-Pfalz",7143303,"Waldmühlen",336,167,169,0.49702380952381,350,170,180,0.485714285714286,0.0160321593522513,0.348991694068006,0.634976146579743
7,"Rheinland-Pfalz",7143304,"Wallmerod",1422,680,742,0.478199718706048,1302,610,692,0.468509984639017,0.0160321593522513,0.348991694068006,0.634976146579743
7,"Rheinland-Pfalz",7143305,"Weidenhahn",554,270,284,0.487364620938628,530,261,269,0.492452830188679,0.0160321593522513,0.348991694068006,0.634976146579743
7,"Rheinland-Pfalz",7143306,"Welkenbach",142,70,72,0.492957746478873,140,69,71,0.492857142857143,0.0160321593522513,0.348991694068006,0.634976146579743
7,"Rheinland-Pfalz",7143307,"Weltersburg",288,143,145,0.496527777777778,276,144,132,0.521739130434783,0.0160321593522513,0.348991694068006,0.634976146579743
7,"Rheinland-Pfalz",7143308,"Westerburg, Stadt",5678,2745,2933,0.48344487495597,5466,2683,2783,0.490852542993048,0.0160321593522513,0.348991694068006,0.634976146579743
7,"Rheinland-Pfalz",7143309,"Westernohe",954,480,474,0.50314465408805,964,482,482,0.5,0.0160321593522513,0.348991694068006,0.634976146579743
7,"Rheinland-Pfalz",7143310,"Wied",481,245,236,0.509355509355509,500,254,246,0.508,0.0160321593522513,0.348991694068006,0.634976146579743
7,"Rheinland-Pfalz",7143311,"Willingen",302,151,151,0.5,248,122,126,0.491935483870968,0.0160321593522513,0.348991694068006,0.634976146579743
7,"Rheinland-Pfalz",7143312,"Willmenrod",656,322,334,0.490853658536585,686,345,341,0.502915451895044,0.0160321593522513,0.348991694068006,0.634976146579743
7,"Rheinland-Pfalz",7143313,"Winkelbach",233,112,121,0.48068669527897,233,116,117,0.497854077253219,0.0160321593522513,0.348991694068006,0.634976146579743
7,"Rheinland-Pfalz",7143314,"Winnen",463,224,239,0.483801295896328,434,203,231,0.467741935483871,0.0160321593522513,0.348991694068006,0.634976146579743
7,"Rheinland-Pfalz",7143315,"Zehnhausen bei Rennerod",391,191,200,0.48849104859335,403,198,205,0.491315136476427,0.0160321593522513,0.348991694068006,0.634976146579743
7,"Rheinland-Pfalz",7143316,"Zehnhausen bei Wallmerod",189,95,94,0.502645502645503,192,94,98,0.489583333333333,0.0160321593522513,0.348991694068006,0.634976146579743
7,"Rheinland-Pfalz",7143501,"Elbingen",304,159,145,0.523026315789474,304,167,137,0.549342105263158,0.0160321593522513,0.348991694068006,0.634976146579743
7,"Rheinland-Pfalz",7143502,"Mähren",243,122,121,0.502057613168724,253,127,126,0.50197628458498,0.0160321593522513,0.348991694068006,0.634976146579743
7,"Rheinland-Pfalz",7211000,"Trier, Stadt",106284,50787,55497,0.47784238455459,105675,50255,55420,0.475561864206293,0.0160321593522513,0.348991694068006,0.634976146579743
7,"Rheinland-Pfalz",7231001,"Altrich",1584,776,808,0.48989898989899,1541,755,786,0.489941596365996,0.0160321593522513,0.348991694068006,0.634976146579743
7,"Rheinland-Pfalz",7231003,"Arenrath",346,179,167,0.517341040462428,325,162,163,0.498461538461538,0.0160321593522513,0.348991694068006,0.634976146579743
7,"Rheinland-Pfalz",7231004,"Bausendorf",1251,607,644,0.485211830535572,1261,620,641,0.49167327517843,0.0160321593522513,0.348991694068006,0.634976146579743
7,"Rheinland-Pfalz",7231005,"Bengel",808,410,398,0.507425742574257,832,426,406,0.512019230769231,0.0160321593522513,0.348991694068006,0.634976146579743
7,"Rheinland-Pfalz",7231006,"Berglicht",460,219,241,0.476086956521739,458,227,231,0.495633187772926,0.0160321593522513,0.348991694068006,0.634976146579743
7,"Rheinland-Pfalz",7231007,"Bergweiler",872,432,440,0.495412844036697,853,426,427,0.499413833528722,0.0160321593522513,0.348991694068006,0.634976146579743
7,"Rheinland-Pfalz",7231008,"Bernkastel-Kues, Stadt",6841,3248,3593,0.474784388247332,6516,3105,3411,0.476519337016575,0.0160321593522513,0.348991694068006,0.634976146579743
7,"Rheinland-Pfalz",7231009,"Bettenfeld",679,326,353,0.480117820324006,663,322,341,0.485671191553544,0.0160321593522513,0.348991694068006,0.634976146579743
7,"Rheinland-Pfalz",7231010,"Binsfeld",1056,513,543,0.485795454545455,1057,529,528,0.500473036896878,0.0160321593522513,0.348991694068006,0.634976146579743
7,"Rheinland-Pfalz",7231012,"Brauneberg",1218,616,602,0.505747126436782,1208,614,594,0.508278145695364,0.0160321593522513,0.348991694068006,0.634976146579743
7,"Rheinland-Pfalz",7231013,"Bruch",453,204,249,0.450331125827815,460,210,250,0.456521739130435,0.0160321593522513,0.348991694068006,0.634976146579743
7,"Rheinland-Pfalz",7231014,"Burg (Mosel)",406,194,212,0.477832512315271,396,190,206,0.47979797979798,0.0160321593522513,0.348991694068006,0.634976146579743
7,"Rheinland-Pfalz",7231016,"Burgen",585,293,292,0.500854700854701,567,280,287,0.493827160493827,0.0160321593522513,0.348991694068006,0.634976146579743
7,"Rheinland-Pfalz",7231017,"Burtscheid",109,50,59,0.458715596330275,108,49,59,0.453703703703704,0.0160321593522513,0.348991694068006,0.634976146579743
7,"Rheinland-Pfalz",7231018,"Deuselbach",274,132,142,0.481751824817518,251,114,137,0.454183266932271,0.0160321593522513,0.348991694068006,0.634976146579743
7,"Rheinland-Pfalz",7231019,"Dhronecken",124,63,61,0.508064516129032,124,59,65,0.475806451612903,0.0160321593522513,0.348991694068006,0.634976146579743
7,"Rheinland-Pfalz",7231020,"Diefenbach",68,35,33,0.514705882352941,63,33,30,0.523809523809524,0.0160321593522513,0.348991694068006,0.634976146579743
7,"Rheinland-Pfalz",7231021,"Dierfeld",10,5,5,0.5,7,4,3,0.571428571428571,0.0160321593522513,0.348991694068006,0.634976146579743
7,"Rheinland-Pfalz",7231022,"Dierscheid",165,81,84,0.490909090909091,156,77,79,0.493589743589744,0.0160321593522513,0.348991694068006,0.634976146579743
7,"Rheinland-Pfalz",7231023,"Dodenburg",105,53,52,0.504761904761905,105,57,48,0.542857142857143,0.0160321593522513,0.348991694068006,0.634976146579743
7,"Rheinland-Pfalz",7231024,"Dreis",1393,706,687,0.506819813352477,1366,699,667,0.511713030746706,0.0160321593522513,0.348991694068006,0.634976146579743
7,"Rheinland-Pfalz",7231025,"Eckfeld",365,184,181,0.504109589041096,351,177,174,0.504273504273504,0.0160321593522513,0.348991694068006,0.634976146579743
7,"Rheinland-Pfalz",7231026,"Eisenschmitt",329,165,164,0.501519756838906,279,141,138,0.505376344086022,0.0160321593522513,0.348991694068006,0.634976146579743
7,"Rheinland-Pfalz",7231029,"Enkirch",1574,781,793,0.496188055908513,1599,792,807,0.4953095684803,0.0160321593522513,0.348991694068006,0.634976146579743
7,"Rheinland-Pfalz",7231030,"Erden",374,187,187,0.5,377,186,191,0.493368700265252,0.0160321593522513,0.348991694068006,0.634976146579743
7,"Rheinland-Pfalz",7231031,"Esch",405,193,212,0.476543209876543,389,190,199,0.488431876606684,0.0160321593522513,0.348991694068006,0.634976146579743
7,"Rheinland-Pfalz",7231032,"Etgert",60,35,25,0.583333333333333,52,28,24,0.538461538461538,0.0160321593522513,0.348991694068006,0.634976146579743
7,"Rheinland-Pfalz",7231033,"Flußbach",464,241,223,0.519396551724138,442,226,216,0.51131221719457,0.0160321593522513,0.348991694068006,0.634976146579743
7,"Rheinland-Pfalz",7231035,"Gielert",173,89,84,0.514450867052023,180,87,93,0.483333333333333,0.0160321593522513,0.348991694068006,0.634976146579743
7,"Rheinland-Pfalz",7231036,"Gipperath",258,137,121,0.531007751937985,250,132,118,0.528,0.0160321593522513,0.348991694068006,0.634976146579743
7,"Rheinland-Pfalz",7231037,"Gladbach",342,166,176,0.485380116959064,325,157,168,0.483076923076923,0.0160321593522513,0.348991694068006,0.634976146579743
7,"Rheinland-Pfalz",7231040,"Gornhausen",217,107,110,0.493087557603687,213,107,106,0.502347417840376,0.0160321593522513,0.348991694068006,0.634976146579743
7,"Rheinland-Pfalz",7231041,"Graach an der Mosel",668,355,313,0.531437125748503,664,350,314,0.52710843373494,0.0160321593522513,0.348991694068006,0.634976146579743
7,"Rheinland-Pfalz",7231042,"Gräfendhron",114,62,52,0.543859649122807,120,68,52,0.566666666666667,0.0160321593522513,0.348991694068006,0.634976146579743
7,"Rheinland-Pfalz",7231044,"Greimerath",250,126,124,0.504,241,117,124,0.485477178423237,0.0160321593522513,0.348991694068006,0.634976146579743
7,"Rheinland-Pfalz",7231046,"Großlittgen",946,474,472,0.501057082452431,924,470,454,0.508658008658009,0.0160321593522513,0.348991694068006,0.634976146579743
7,"Rheinland-Pfalz",7231049,"Hasborn",567,297,270,0.523809523809524,542,285,257,0.525830258302583,0.0160321593522513,0.348991694068006,0.634976146579743
7,"Rheinland-Pfalz",7231050,"Heckenmünster",128,55,73,0.4296875,118,48,70,0.406779661016949,0.0160321593522513,0.348991694068006,0.634976146579743
7,"Rheinland-Pfalz",7231051,"Heidweiler",186,87,99,0.467741935483871,202,93,109,0.46039603960396,0.0160321593522513,0.348991694068006,0.634976146579743
7,"Rheinland-Pfalz",7231053,"Hetzerath",2191,1069,1122,0.487905066179827,2182,1081,1101,0.495417048579285,0.0160321593522513,0.348991694068006,0.634976146579743
7,"Rheinland-Pfalz",7231054,"Hilscheid",265,127,138,0.479245283018868,249,121,128,0.485943775100402,0.0160321593522513,0.348991694068006,0.634976146579743
7,"Rheinland-Pfalz",7231056,"Hochscheid",258,129,129,0.5,255,127,128,0.498039215686275,0.0160321593522513,0.348991694068006,0.634976146579743
7,"Rheinland-Pfalz",7231057,"Hontheim",845,408,437,0.482840236686391,824,406,418,0.492718446601942,0.0160321593522513,0.348991694068006,0.634976146579743
7,"Rheinland-Pfalz",7231058,"Horath",439,221,218,0.503416856492027,429,221,208,0.515151515151515,0.0160321593522513,0.348991694068006,0.634976146579743
7,"Rheinland-Pfalz",7231062,"Hupperath",583,299,284,0.512864493996569,598,309,289,0.516722408026756,0.0160321593522513,0.348991694068006,0.634976146579743
7,"Rheinland-Pfalz",7231064,"Immert",159,75,84,0.471698113207547,162,74,88,0.45679012345679,0.0160321593522513,0.348991694068006,0.634976146579743
7,"Rheinland-Pfalz",7231065,"Karl",203,93,110,0.458128078817734,195,84,111,0.430769230769231,0.0160321593522513,0.348991694068006,0.634976146579743
7,"Rheinland-Pfalz",7231066,"Kesten",357,180,177,0.504201680672269,344,175,169,0.508720930232558,0.0160321593522513,0.348991694068006,0.634976146579743
7,"Rheinland-Pfalz",7231067,"Kinderbeuern",1086,560,526,0.515653775322284,1086,560,526,0.515653775322284,0.0160321593522513,0.348991694068006,0.634976146579743
7,"Rheinland-Pfalz",7231068,"Kinheim",818,397,421,0.485330073349633,805,390,415,0.484472049689441,0.0160321593522513,0.348991694068006,0.634976146579743
7,"Rheinland-Pfalz",7231069,"Klausen",1314,656,658,0.49923896499239,1317,662,655,0.502657555049355,0.0160321593522513,0.348991694068006,0.634976146579743
7,"Rheinland-Pfalz",7231070,"Kleinich",692,349,343,0.504335260115607,676,346,330,0.511834319526627,0.0160321593522513,0.348991694068006,0.634976146579743
7,"Rheinland-Pfalz",7231071,"Kommen",304,148,156,0.486842105263158,309,151,158,0.488673139158576,0.0160321593522513,0.348991694068006,0.634976146579743
7,"Rheinland-Pfalz",7231072,"Kröv",2288,1106,1182,0.483391608391608,2215,1064,1151,0.480361173814898,0.0160321593522513,0.348991694068006,0.634976146579743
7,"Rheinland-Pfalz",7231074,"Laufeld",514,261,253,0.507782101167315,496,251,245,0.506048387096774,0.0160321593522513,0.348991694068006,0.634976146579743
7,"Rheinland-Pfalz",7231075,"Lieser",1234,609,625,0.493517017828201,1191,582,609,0.488664987405542,0.0160321593522513,0.348991694068006,0.634976146579743
7,"Rheinland-Pfalz",7231076,"Lösnich",419,207,212,0.494033412887828,423,208,215,0.491725768321513,0.0160321593522513,0.348991694068006,0.634976146579743
7,"Rheinland-Pfalz",7231077,"Longkamp",1160,579,581,0.499137931034483,1164,588,576,0.505154639175258,0.0160321593522513,0.348991694068006,0.634976146579743
7,"Rheinland-Pfalz",7231078,"Lückenburg",98,47,51,0.479591836734694,92,45,47,0.489130434782609,0.0160321593522513,0.348991694068006,0.634976146579743
7,"Rheinland-Pfalz",7231079,"Malborn",1321,651,670,0.492808478425435,1335,666,669,0.498876404494382,0.0160321593522513,0.348991694068006,0.634976146579743
7,"Rheinland-Pfalz",7231080,"Manderscheid, Stadt",1332,625,707,0.469219219219219,1301,627,674,0.481936971560338,0.0160321593522513,0.348991694068006,0.634976146579743
7,"Rheinland-Pfalz",7231081,"Maring-Noviand",1494,737,757,0.49330655957162,1494,747,747,0.5,0.0160321593522513,0.348991694068006,0.634976146579743
7,"Rheinland-Pfalz",7231082,"Meerfeld",354,184,170,0.519774011299435,350,186,164,0.531428571428571,0.0160321593522513,0.348991694068006,0.634976146579743
7,"Rheinland-Pfalz",7231083,"Merschbach",64,35,29,0.546875,51,26,25,0.509803921568627,0.0160321593522513,0.348991694068006,0.634976146579743
7,"Rheinland-Pfalz",7231085,"Minderlittgen",657,329,328,0.50076103500761,650,329,321,0.506153846153846,0.0160321593522513,0.348991694068006,0.634976146579743
7,"Rheinland-Pfalz",7231086,"Minheim",484,241,243,0.497933884297521,481,237,244,0.492723492723493,0.0160321593522513,0.348991694068006,0.634976146579743
7,"Rheinland-Pfalz",7231087,"Monzelfeld",1219,607,612,0.497949138638228,1212,604,608,0.498349834983498,0.0160321593522513,0.348991694068006,0.634976146579743
7,"Rheinland-Pfalz",7231090,"Mülheim (Mosel)",1031,511,520,0.495635305528613,1009,495,514,0.490584737363726,0.0160321593522513,0.348991694068006,0.634976146579743
7,"Rheinland-Pfalz",7231091,"Musweiler",57,31,26,0.543859649122807,55,29,26,0.527272727272727,0.0160321593522513,0.348991694068006,0.634976146579743
7,"Rheinland-Pfalz",7231092,"Neumagen-Dhron",2214,1092,1122,0.493224932249323,2172,1069,1103,0.492173112338858,0.0160321593522513,0.348991694068006,0.634976146579743
7,"Rheinland-Pfalz",7231093,"Neunkirchen",154,78,76,0.506493506493506,136,71,65,0.522058823529412,0.0160321593522513,0.348991694068006,0.634976146579743
7,"Rheinland-Pfalz",7231095,"Niederöfflingen",445,228,217,0.512359550561798,440,228,212,0.518181818181818,0.0160321593522513,0.348991694068006,0.634976146579743
7,"Rheinland-Pfalz",7231096,"Niederscheidweiler",242,124,118,0.512396694214876,252,132,120,0.523809523809524,0.0160321593522513,0.348991694068006,0.634976146579743
7,"Rheinland-Pfalz",7231100,"Oberöfflingen",274,135,139,0.492700729927007,274,138,136,0.503649635036496,0.0160321593522513,0.348991694068006,0.634976146579743
7,"Rheinland-Pfalz",7231101,"Oberscheidweiler",184,88,96,0.478260869565217,186,86,100,0.462365591397849,0.0160321593522513,0.348991694068006,0.634976146579743
7,"Rheinland-Pfalz",7231103,"Osann-Monzel",1656,847,809,0.511473429951691,1630,832,798,0.510429447852761,0.0160321593522513,0.348991694068006,0.634976146579743
7,"Rheinland-Pfalz",7231104,"Pantenburg",238,117,121,0.491596638655462,236,113,123,0.478813559322034,0.0160321593522513,0.348991694068006,0.634976146579743
7,"Rheinland-Pfalz",7231105,"Piesport",1957,983,974,0.502299437915176,1898,963,935,0.507376185458377,0.0160321593522513,0.348991694068006,0.634976146579743
7,"Rheinland-Pfalz",7231107,"Platten",884,443,441,0.501131221719457,890,447,443,0.502247191011236,0.0160321593522513,0.348991694068006,0.634976146579743
7,"Rheinland-Pfalz",7231108,"Plein",635,316,319,0.497637795275591,655,320,335,0.488549618320611,0.0160321593522513,0.348991694068006,0.634976146579743
7,"Rheinland-Pfalz",7231110,"Reil",1064,526,538,0.494360902255639,1041,508,533,0.487992315081652,0.0160321593522513,0.348991694068006,0.634976146579743
7,"Rheinland-Pfalz",7231111,"Rivenich",728,364,364,0.5,732,361,371,0.493169398907104,0.0160321593522513,0.348991694068006,0.634976146579743
7,"Rheinland-Pfalz",7231112,"Rorodt",50,24,26,0.48,57,26,31,0.456140350877193,0.0160321593522513,0.348991694068006,0.634976146579743
7,"Rheinland-Pfalz",7231113,"Salmtal",2370,1125,1245,0.474683544303797,2365,1129,1236,0.47737843551797,0.0160321593522513,0.348991694068006,0.634976146579743
7,"Rheinland-Pfalz",7231114,"Schladt",117,61,56,0.521367521367521,115,61,54,0.530434782608696,0.0160321593522513,0.348991694068006,0.634976146579743
7,"Rheinland-Pfalz",7231115,"Schönberg",226,119,107,0.526548672566372,217,115,102,0.529953917050691,0.0160321593522513,0.348991694068006,0.634976146579743
7,"Rheinland-Pfalz",7231116,"Schwarzenborn",57,31,26,0.543859649122807,53,28,25,0.528301886792453,0.0160321593522513,0.348991694068006,0.634976146579743
7,"Rheinland-Pfalz",7231117,"Sehlem",896,461,435,0.514508928571429,886,452,434,0.510158013544018,0.0160321593522513,0.348991694068006,0.634976146579743
7,"Rheinland-Pfalz",7231120,"Starkenburg",234,127,107,0.542735042735043,243,125,118,0.51440329218107,0.0160321593522513,0.348991694068006,0.634976146579743
7,"Rheinland-Pfalz",7231122,"Talling",222,108,114,0.486486486486487,216,110,106,0.509259259259259,0.0160321593522513,0.348991694068006,0.634976146579743
7,"Rheinland-Pfalz",7231123,"Thalfang",1820,878,942,0.482417582417582,1777,882,895,0.49634214969049,0.0160321593522513,0.348991694068006,0.634976146579743
7,"Rheinland-Pfalz",7231124,"Traben-Trarbach, Stadt",5815,2851,2964,0.490283748925193,5881,2890,2991,0.491413024995749,0.0160321593522513,0.348991694068006,0.634976146579743
7,"Rheinland-Pfalz",7231125,"Ürzig",906,456,450,0.503311258278146,860,432,428,0.502325581395349,0.0160321593522513,0.348991694068006,0.634976146579743
7,"Rheinland-Pfalz",7231126,"Veldenz",939,481,458,0.512247071352503,900,456,444,0.506666666666667,0.0160321593522513,0.348991694068006,0.634976146579743
7,"Rheinland-Pfalz",7231127,"Wallscheid",352,181,171,0.514204545454545,337,177,160,0.525222551928783,0.0160321593522513,0.348991694068006,0.634976146579743
7,"Rheinland-Pfalz",7231132,"Willwerscheid",68,36,32,0.529411764705882,67,36,31,0.537313432835821,0.0160321593522513,0.348991694068006,0.634976146579743
7,"Rheinland-Pfalz",7231133,"Wintrich",973,481,492,0.494347379239466,953,468,485,0.491080797481637,0.0160321593522513,0.348991694068006,0.634976146579743
7,"Rheinland-Pfalz",7231134,"Wittlich, Stadt",18274,9104,9170,0.498194155630951,17931,8776,9155,0.489431710445597,0.0160321593522513,0.348991694068006,0.634976146579743
7,"Rheinland-Pfalz",7231136,"Zeltingen-Rachtig",2233,1094,1139,0.489923869234214,2181,1059,1122,0.485557083906465,0.0160321593522513,0.348991694068006,0.634976146579743
7,"Rheinland-Pfalz",7231202,"Breit",267,147,120,0.550561797752809,272,151,121,0.555147058823529,0.0160321593522513,0.348991694068006,0.634976146579743
7,"Rheinland-Pfalz",7231203,"Büdlich",200,108,92,0.54,182,97,85,0.532967032967033,0.0160321593522513,0.348991694068006,0.634976146579743
7,"Rheinland-Pfalz",7231204,"Heidenburg",743,353,390,0.475100942126514,749,364,385,0.485981308411215,0.0160321593522513,0.348991694068006,0.634976146579743
7,"Rheinland-Pfalz",7231206,"Lötzbeuren",471,229,242,0.48619957537155,473,233,240,0.492600422832981,0.0160321593522513,0.348991694068006,0.634976146579743
7,"Rheinland-Pfalz",7231207,"Trittenheim",1058,521,537,0.492438563327032,1037,505,532,0.486981677917068,0.0160321593522513,0.348991694068006,0.634976146579743
7,"Rheinland-Pfalz",7231501,"Irmenach",716,347,369,0.48463687150838,709,342,367,0.482369534555712,0.0160321593522513,0.348991694068006,0.634976146579743
7,"Rheinland-Pfalz",7231502,"Morbach",10516,5233,5283,0.497622670216813,10752,5400,5352,0.502232142857143,0.0160321593522513,0.348991694068006,0.634976146579743
7,"Rheinland-Pfalz",7231503,"Landscheid",1958,967,991,0.493871297242084,1979,985,994,0.497726124305205,0.0160321593522513,0.348991694068006,0.634976146579743
7,"Rheinland-Pfalz",7231504,"Niersbach",685,338,347,0.493430656934307,686,335,351,0.488338192419825,0.0160321593522513,0.348991694068006,0.634976146579743
7,"Rheinland-Pfalz",7232001,"Affler",29,16,13,0.551724137931034,24,17,7,0.708333333333333,0.0160321593522513,0.348991694068006,0.634976146579743
7,"Rheinland-Pfalz",7232002,"Alsdorf",438,204,234,0.465753424657534,385,169,216,0.438961038961039,0.0160321593522513,0.348991694068006,0.634976146579743
7,"Rheinland-Pfalz",7232003,"Altscheid",90,45,45,0.5,88,43,45,0.488636363636364,0.0160321593522513,0.348991694068006,0.634976146579743
7,"Rheinland-Pfalz",7232004,"Ammeldingen an der Our",23,14,9,0.608695652173913,10,8,2,0.8,0.0160321593522513,0.348991694068006,0.634976146579743
7,"Rheinland-Pfalz",7232005,"Ammeldingen bei Neuerburg",260,145,115,0.557692307692308,283,161,122,0.568904593639576,0.0160321593522513,0.348991694068006,0.634976146579743
7,"Rheinland-Pfalz",7232006,"Auw an der Kyll",130,56,74,0.430769230769231,139,69,70,0.496402877697842,0.0160321593522513,0.348991694068006,0.634976146579743
7,"Rheinland-Pfalz",7232007,"Badem",1083,537,546,0.49584487534626,1049,516,533,0.491897044804576,0.0160321593522513,0.348991694068006,0.634976146579743
7,"Rheinland-Pfalz",7232008,"Bauler",71,38,33,0.535211267605634,67,36,31,0.537313432835821,0.0160321593522513,0.348991694068006,0.634976146579743
7,"Rheinland-Pfalz",7232009,"Baustert",481,242,239,0.503118503118503,485,248,237,0.511340206185567,0.0160321593522513,0.348991694068006,0.634976146579743
7,"Rheinland-Pfalz",7232010,"Beilingen",375,178,197,0.474666666666667,364,176,188,0.483516483516484,0.0160321593522513,0.348991694068006,0.634976146579743
7,"Rheinland-Pfalz",7232011,"Berkoth",90,48,42,0.533333333333333,82,48,34,0.585365853658537,0.0160321593522513,0.348991694068006,0.634976146579743
7,"Rheinland-Pfalz",7232012,"Berscheid",64,32,32,0.5,61,30,31,0.491803278688525,0.0160321593522513,0.348991694068006,0.634976146579743
7,"Rheinland-Pfalz",7232013,"Bettingen",1032,539,493,0.522286821705426,997,529,468,0.530591775325978,0.0160321593522513,0.348991694068006,0.634976146579743
7,"Rheinland-Pfalz",7232014,"Bickendorf",491,249,242,0.507128309572301,482,247,235,0.512448132780083,0.0160321593522513,0.348991694068006,0.634976146579743
7,"Rheinland-Pfalz",7232015,"Biersdorf am See",538,259,279,0.481412639405204,557,271,286,0.486535008976661,0.0160321593522513,0.348991694068006,0.634976146579743
7,"Rheinland-Pfalz",7232016,"Biesdorf",222,119,103,0.536036036036036,228,129,99,0.565789473684211,0.0160321593522513,0.348991694068006,0.634976146579743
7,"Rheinland-Pfalz",7232017,"Birtlingen",76,36,40,0.473684210526316,74,37,37,0.5,0.0160321593522513,0.348991694068006,0.634976146579743
7,"Rheinland-Pfalz",7232018,"Bitburg, Stadt",13332,6313,7019,0.473522352235224,12773,6109,6664,0.478274485242308,0.0160321593522513,0.348991694068006,0.634976146579743
7,"Rheinland-Pfalz",7232019,"Bollendorf",1622,842,780,0.519112207151665,1606,831,775,0.517434620174346,0.0160321593522513,0.348991694068006,0.634976146579743
7,"Rheinland-Pfalz",7232020,"Brecht",253,122,131,0.482213438735178,251,122,129,0.48605577689243,0.0160321593522513,0.348991694068006,0.634976146579743
7,"Rheinland-Pfalz",7232021,"Brimingen",80,42,38,0.525,75,36,39,0.48,0.0160321593522513,0.348991694068006,0.634976146579743
7,"Rheinland-Pfalz",7232022,"Burg",23,11,12,0.478260869565217,18,4,14,0.222222222222222,0.0160321593522513,0.348991694068006,0.634976146579743
7,"Rheinland-Pfalz",7232024,"Dahlem",269,135,134,0.50185873605948,242,118,124,0.487603305785124,0.0160321593522513,0.348991694068006,0.634976146579743
7,"Rheinland-Pfalz",7232025,"Dauwelshausen",78,44,34,0.564102564102564,75,44,31,0.586666666666667,0.0160321593522513,0.348991694068006,0.634976146579743
7,"Rheinland-Pfalz",7232026,"Dockendorf",197,95,102,0.482233502538071,193,96,97,0.49740932642487,0.0160321593522513,0.348991694068006,0.634976146579743
7,"Rheinland-Pfalz",7232027,"Dudeldorf",1063,539,524,0.507055503292568,1056,542,514,0.513257575757576,0.0160321593522513,0.348991694068006,0.634976146579743
7,"Rheinland-Pfalz",7232028,"Echternacherbrück",742,365,377,0.491913746630728,738,361,377,0.489159891598916,0.0160321593522513,0.348991694068006,0.634976146579743
7,"Rheinland-Pfalz",7232029,"Echtershausen",104,51,53,0.490384615384615,101,49,52,0.485148514851485,0.0160321593522513,0.348991694068006,0.634976146579743
7,"Rheinland-Pfalz",7232030,"Ehlenz",420,215,205,0.511904761904762,416,210,206,0.504807692307692,0.0160321593522513,0.348991694068006,0.634976146579743
7,"Rheinland-Pfalz",7232031,"Emmelbaum",79,40,39,0.506329113924051,79,40,39,0.506329113924051,0.0160321593522513,0.348991694068006,0.634976146579743
7,"Rheinland-Pfalz",7232032,"Enzen",43,20,23,0.465116279069767,36,16,20,0.444444444444444,0.0160321593522513,0.348991694068006,0.634976146579743
7,"Rheinland-Pfalz",7232033,"Ernzen",417,209,208,0.501199040767386,412,213,199,0.516990291262136,0.0160321593522513,0.348991694068006,0.634976146579743
7,"Rheinland-Pfalz",7232034,"Eßlingen",86,44,42,0.511627906976744,53,24,29,0.452830188679245,0.0160321593522513,0.348991694068006,0.634976146579743
7,"Rheinland-Pfalz",7232035,"Etteldorf",26,16,10,0.615384615384615,21,12,9,0.571428571428571,0.0160321593522513,0.348991694068006,0.634976146579743
7,"Rheinland-Pfalz",7232036,"Feilsdorf",33,16,17,0.484848484848485,28,14,14,0.5,0.0160321593522513,0.348991694068006,0.634976146579743
7,"Rheinland-Pfalz",7232037,"Ferschweiler",961,483,478,0.502601456815817,911,451,460,0.495060373216246,0.0160321593522513,0.348991694068006,0.634976146579743
7,"Rheinland-Pfalz",7232038,"Fischbach-Oberraden",75,37,38,0.493333333333333,76,38,38,0.5,0.0160321593522513,0.348991694068006,0.634976146579743
7,"Rheinland-Pfalz",7232039,"Fließem",711,354,357,0.49789029535865,692,340,352,0.491329479768786,0.0160321593522513,0.348991694068006,0.634976146579743
7,"Rheinland-Pfalz",7232040,"Geichlingen",397,201,196,0.506297229219144,387,199,188,0.51421188630491,0.0160321593522513,0.348991694068006,0.634976146579743
7,"Rheinland-Pfalz",7232041,"Gemünd",34,16,18,0.470588235294118,13,5,8,0.384615384615385,0.0160321593522513,0.348991694068006,0.634976146579743
7,"Rheinland-Pfalz",7232042,"Gentingen",72,35,37,0.486111111111111,68,35,33,0.514705882352941,0.0160321593522513,0.348991694068006,0.634976146579743
7,"Rheinland-Pfalz",7232043,"Gindorf",333,165,168,0.495495495495495,322,156,166,0.484472049689441,0.0160321593522513,0.348991694068006,0.634976146579743
7,"Rheinland-Pfalz",7232044,"Gondorf",246,125,121,0.508130081300813,233,117,116,0.502145922746781,0.0160321593522513,0.348991694068006,0.634976146579743
7,"Rheinland-Pfalz",7232045,"Halsdorf",102,52,50,0.509803921568627,88,44,44,0.5,0.0160321593522513,0.348991694068006,0.634976146579743
7,"Rheinland-Pfalz",7232046,"Hamm",20,10,10,0.5,26,13,13,0.5,0.0160321593522513,0.348991694068006,0.634976146579743
7,"Rheinland-Pfalz",7232047,"Heilbach",126,71,55,0.563492063492063,126,73,53,0.579365079365079,0.0160321593522513,0.348991694068006,0.634976146579743
7,"Rheinland-Pfalz",7232048,"Heilenbach",105,52,53,0.495238095238095,104,50,54,0.480769230769231,0.0160321593522513,0.348991694068006,0.634976146579743
7,"Rheinland-Pfalz",7232049,"Herbstmühle",25,12,13,0.48,29,15,14,0.517241379310345,0.0160321593522513,0.348991694068006,0.634976146579743
7,"Rheinland-Pfalz",7232050,"Herforst",1225,588,637,0.48,1176,569,607,0.483843537414966,0.0160321593522513,0.348991694068006,0.634976146579743
7,"Rheinland-Pfalz",7232052,"Hisel",14,5,9,0.357142857142857,14,4,10,0.285714285714286,0.0160321593522513,0.348991694068006,0.634976146579743
7,"Rheinland-Pfalz",7232053,"Holsthum",620,319,301,0.514516129032258,608,315,293,0.518092105263158,0.0160321593522513,0.348991694068006,0.634976146579743
7,"Rheinland-Pfalz",7232054,"Hommerdingen",57,25,32,0.43859649122807,54,23,31,0.425925925925926,0.0160321593522513,0.348991694068006,0.634976146579743
7,"Rheinland-Pfalz",7232055,"Hosten",188,91,97,0.484042553191489,186,89,97,0.478494623655914,0.0160321593522513,0.348991694068006,0.634976146579743
7,"Rheinland-Pfalz",7232056,"Hütten",50,29,21,0.58,45,26,19,0.577777777777778,0.0160321593522513,0.348991694068006,0.634976146579743
7,"Rheinland-Pfalz",7232057,"Hütterscheid",189,100,89,0.529100529100529,193,100,93,0.518134715025907,0.0160321593522513,0.348991694068006,0.634976146579743
7,"Rheinland-Pfalz",7232058,"Hüttingen an der Kyll",337,169,168,0.501483679525223,326,163,163,0.5,0.0160321593522513,0.348991694068006,0.634976146579743
7,"Rheinland-Pfalz",7232059,"Hüttingen bei Lahr",144,71,73,0.493055555555556,135,68,67,0.503703703703704,0.0160321593522513,0.348991694068006,0.634976146579743
7,"Rheinland-Pfalz",7232060,"Idenheim",438,206,232,0.470319634703196,442,204,238,0.461538461538462,0.0160321593522513,0.348991694068006,0.634976146579743
7,"Rheinland-Pfalz",7232061,"Idesheim",411,202,209,0.491484184914842,404,201,203,0.497524752475248,0.0160321593522513,0.348991694068006,0.634976146579743
7,"Rheinland-Pfalz",7232062,"Ingendorf",232,120,112,0.517241379310345,238,122,116,0.512605042016807,0.0160321593522513,0.348991694068006,0.634976146579743
7,"Rheinland-Pfalz",7232063,"Irrel",1432,700,732,0.488826815642458,1384,680,704,0.491329479768786,0.0160321593522513,0.348991694068006,0.634976146579743
7,"Rheinland-Pfalz",7232064,"Karlshausen",374,185,189,0.494652406417112,365,176,189,0.482191780821918,0.0160321593522513,0.348991694068006,0.634976146579743
7,"Rheinland-Pfalz",7232065,"Kaschenbach",57,30,27,0.526315789473684,56,31,25,0.553571428571429,0.0160321593522513,0.348991694068006,0.634976146579743
7,"Rheinland-Pfalz",7232066,"Keppeshausen",15,7,8,0.466666666666667,18,6,12,0.333333333333333,0.0160321593522513,0.348991694068006,0.634976146579743
7,"Rheinland-Pfalz",7232067,"Körperich",1104,542,562,0.490942028985507,1099,536,563,0.4877161055505,0.0160321593522513,0.348991694068006,0.634976146579743
7,"Rheinland-Pfalz",7232068,"Koxhausen",115,58,57,0.504347826086956,110,55,55,0.5,0.0160321593522513,0.348991694068006,0.634976146579743
7,"Rheinland-Pfalz",7232069,"Kruchten",383,187,196,0.488250652741514,377,182,195,0.482758620689655,0.0160321593522513,0.348991694068006,0.634976146579743
7,"Rheinland-Pfalz",7232070,"Kyllburg, Stadt",903,444,459,0.491694352159468,907,459,448,0.50606394707828,0.0160321593522513,0.348991694068006,0.634976146579743
7,"Rheinland-Pfalz",7232071,"Kyllburgweiler",105,51,54,0.485714285714286,96,49,47,0.510416666666667,0.0160321593522513,0.348991694068006,0.634976146579743
7,"Rheinland-Pfalz",7232072,"Lahr",204,100,104,0.490196078431373,181,94,87,0.519337016574586,0.0160321593522513,0.348991694068006,0.634976146579743
7,"Rheinland-Pfalz",7232073,"Leimbach",54,31,23,0.574074074074074,53,31,22,0.584905660377358,0.0160321593522513,0.348991694068006,0.634976146579743
7,"Rheinland-Pfalz",7232074,"Ließem",79,36,43,0.455696202531646,75,37,38,0.493333333333333,0.0160321593522513,0.348991694068006,0.634976146579743
7,"Rheinland-Pfalz",7232075,"Malberg",629,311,318,0.494435612082671,585,294,291,0.502564102564103,0.0160321593522513,0.348991694068006,0.634976146579743
7,"Rheinland-Pfalz",7232076,"Malbergweich",335,171,164,0.51044776119403,350,178,172,0.508571428571429,0.0160321593522513,0.348991694068006,0.634976146579743
7,"Rheinland-Pfalz",7232077,"Meckel",396,197,199,0.497474747474747,399,201,198,0.503759398496241,0.0160321593522513,0.348991694068006,0.634976146579743
7,"Rheinland-Pfalz",7232078,"Menningen",178,87,91,0.48876404494382,180,78,102,0.433333333333333,0.0160321593522513,0.348991694068006,0.634976146579743
7,"Rheinland-Pfalz",7232079,"Messerich",543,272,271,0.500920810313076,541,274,267,0.506469500924214,0.0160321593522513,0.348991694068006,0.634976146579743
7,"Rheinland-Pfalz",7232080,"Mettendorf",1122,560,562,0.499108734402852,1120,566,554,0.505357142857143,0.0160321593522513,0.348991694068006,0.634976146579743
7,"Rheinland-Pfalz",7232081,"Metterich",502,255,247,0.50796812749004,501,260,241,0.518962075848303,0.0160321593522513,0.348991694068006,0.634976146579743
7,"Rheinland-Pfalz",7232082,"Minden",203,107,96,0.527093596059113,132,71,61,0.537878787878788,0.0160321593522513,0.348991694068006,0.634976146579743
7,"Rheinland-Pfalz",7232083,"Mülbach",120,63,57,0.525,110,56,54,0.509090909090909,0.0160321593522513,0.348991694068006,0.634976146579743
7,"Rheinland-Pfalz",7232084,"Muxerath",54,26,28,0.481481481481481,54,27,27,0.5,0.0160321593522513,0.348991694068006,0.634976146579743
7,"Rheinland-Pfalz",7232085,"Nasingen",45,25,20,0.555555555555556,47,27,20,0.574468085106383,0.0160321593522513,0.348991694068006,0.634976146579743
7,"Rheinland-Pfalz",7232086,"Nattenheim",541,261,280,0.482439926062847,539,256,283,0.474953617810761,0.0160321593522513,0.348991694068006,0.634976146579743
7,"Rheinland-Pfalz",7232087,"Neidenbach",888,415,473,0.467342342342342,887,417,470,0.470124013528749,0.0160321593522513,0.348991694068006,0.634976146579743
7,"Rheinland-Pfalz",7232088,"Neuerburg, Stadt",1538,737,801,0.479193758127438,1497,761,736,0.508350033400134,0.0160321593522513,0.348991694068006,0.634976146579743
7,"Rheinland-Pfalz",7232089,"Niedergeckler",51,25,26,0.490196078431373,43,22,21,0.511627906976744,0.0160321593522513,0.348991694068006,0.634976146579743
7,"Rheinland-Pfalz",7232090,"Niederraden",52,30,22,0.576923076923077,43,25,18,0.581395348837209,0.0160321593522513,0.348991694068006,0.634976146579743
7,"Rheinland-Pfalz",7232091,"Niederstedem",259,143,116,0.552123552123552,241,132,109,0.547717842323652,0.0160321593522513,0.348991694068006,0.634976146579743
7,"Rheinland-Pfalz",7232092,"Niederweiler",86,39,47,0.453488372093023,82,37,45,0.451219512195122,0.0160321593522513,0.348991694068006,0.634976146579743
7,"Rheinland-Pfalz",7232093,"Niederweis",236,113,123,0.478813559322034,233,115,118,0.493562231759657,0.0160321593522513,0.348991694068006,0.634976146579743
7,"Rheinland-Pfalz",7232094,"Niehl",78,41,37,0.525641025641026,76,40,36,0.526315789473684,0.0160321593522513,0.348991694068006,0.634976146579743
7,"Rheinland-Pfalz",7232095,"Nusbaum",485,244,241,0.503092783505155,464,230,234,0.495689655172414,0.0160321593522513,0.348991694068006,0.634976146579743
7,"Rheinland-Pfalz",7232096,"Obergeckler",169,96,73,0.568047337278107,178,104,74,0.584269662921348,0.0160321593522513,0.348991694068006,0.634976146579743
7,"Rheinland-Pfalz",7232097,"Oberstedem",68,30,38,0.441176470588235,71,34,37,0.47887323943662,0.0160321593522513,0.348991694068006,0.634976146579743
7,"Rheinland-Pfalz",7232098,"Oberweiler",135,68,67,0.503703703703704,128,68,60,0.53125,0.0160321593522513,0.348991694068006,0.634976146579743
7,"Rheinland-Pfalz",7232099,"Oberweis",556,276,280,0.496402877697842,528,262,266,0.496212121212121,0.0160321593522513,0.348991694068006,0.634976146579743
7,"Rheinland-Pfalz",7232100,"Olsdorf",98,45,53,0.459183673469388,89,40,49,0.449438202247191,0.0160321593522513,0.348991694068006,0.634976146579743
7,"Rheinland-Pfalz",7232101,"Orsfeld",158,87,71,0.550632911392405,150,83,67,0.553333333333333,0.0160321593522513,0.348991694068006,0.634976146579743
7,"Rheinland-Pfalz",7232102,"Utscheid",459,237,222,0.516339869281046,466,236,230,0.506437768240343,0.0160321593522513,0.348991694068006,0.634976146579743
7,"Rheinland-Pfalz",7232103,"Peffingen",231,112,119,0.484848484848485,230,116,114,0.504347826086956,0.0160321593522513,0.348991694068006,0.634976146579743
7,"Rheinland-Pfalz",7232104,"Philippsheim",104,55,49,0.528846153846154,104,56,48,0.538461538461538,0.0160321593522513,0.348991694068006,0.634976146579743
7,"Rheinland-Pfalz",7232105,"Pickließem",277,140,137,0.505415162454874,272,140,132,0.514705882352941,0.0160321593522513,0.348991694068006,0.634976146579743
7,"Rheinland-Pfalz",7232106,"Plascheid",87,50,37,0.574712643678161,89,51,38,0.573033707865168,0.0160321593522513,0.348991694068006,0.634976146579743
7,"Rheinland-Pfalz",7232107,"Preist",695,335,360,0.482014388489209,670,324,346,0.483582089552239,0.0160321593522513,0.348991694068006,0.634976146579743
7,"Rheinland-Pfalz",7232108,"Prümzurlay",503,259,244,0.514910536779324,545,274,271,0.502752293577982,0.0160321593522513,0.348991694068006,0.634976146579743
7,"Rheinland-Pfalz",7232109,"Rittersdorf",1433,730,703,0.509420795533845,1421,719,702,0.505981703026038,0.0160321593522513,0.348991694068006,0.634976146579743
7,"Rheinland-Pfalz",7232110,"Rodershausen",167,86,81,0.514970059880239,177,92,85,0.519774011299435,0.0160321593522513,0.348991694068006,0.634976146579743
7,"Rheinland-Pfalz",7232111,"Röhl",425,221,204,0.52,407,210,197,0.515970515970516,0.0160321593522513,0.348991694068006,0.634976146579743
7,"Rheinland-Pfalz",7232112,"Roth an der Our",191,97,94,0.507853403141361,186,92,94,0.494623655913978,0.0160321593522513,0.348991694068006,0.634976146579743
7,"Rheinland-Pfalz",7232113,"Sankt Thomas",288,148,140,0.513888888888889,294,152,142,0.517006802721088,0.0160321593522513,0.348991694068006,0.634976146579743
7,"Rheinland-Pfalz",7232114,"Schankweiler",194,97,97,0.5,189,94,95,0.497354497354497,0.0160321593522513,0.348991694068006,0.634976146579743
7,"Rheinland-Pfalz",7232115,"Scharfbillig",65,31,34,0.476923076923077,67,32,35,0.477611940298507,0.0160321593522513,0.348991694068006,0.634976146579743
7,"Rheinland-Pfalz",7232116,"Scheitenkorb",41,18,23,0.439024390243902,35,16,19,0.457142857142857,0.0160321593522513,0.348991694068006,0.634976146579743
7,"Rheinland-Pfalz",7232117,"Scheuern",55,25,30,0.454545454545455,41,22,19,0.536585365853659,0.0160321593522513,0.348991694068006,0.634976146579743
7,"Rheinland-Pfalz",7232118,"Schleid",373,195,178,0.522788203753351,350,185,165,0.528571428571429,0.0160321593522513,0.348991694068006,0.634976146579743
7,"Rheinland-Pfalz",7232119,"Seffern",319,167,152,0.523510971786834,312,160,152,0.512820512820513,0.0160321593522513,0.348991694068006,0.634976146579743
7,"Rheinland-Pfalz",7232120,"Sefferweich",226,120,106,0.530973451327434,222,119,103,0.536036036036036,0.0160321593522513,0.348991694068006,0.634976146579743
7,"Rheinland-Pfalz",7232121,"Sevenig bei Neuerburg",51,30,21,0.588235294117647,54,32,22,0.592592592592593,0.0160321593522513,0.348991694068006,0.634976146579743
7,"Rheinland-Pfalz",7232122,"Sinspelt",424,217,207,0.511792452830189,400,192,208,0.48,0.0160321593522513,0.348991694068006,0.634976146579743
7,"Rheinland-Pfalz",7232123,"Speicher, Stadt",3179,1550,1629,0.487574709027996,3142,1525,1617,0.485359643539147,0.0160321593522513,0.348991694068006,0.634976146579743
7,"Rheinland-Pfalz",7232124,"Stockem",89,40,49,0.449438202247191,83,38,45,0.457831325301205,0.0160321593522513,0.348991694068006,0.634976146579743
7,"Rheinland-Pfalz",7232125,"Sülm",458,229,229,0.5,444,223,221,0.502252252252252,0.0160321593522513,0.348991694068006,0.634976146579743
7,"Rheinland-Pfalz",7232126,"Trimport",285,144,141,0.505263157894737,291,152,139,0.52233676975945,0.0160321593522513,0.348991694068006,0.634976146579743
7,"Rheinland-Pfalz",7232127,"Übereisenbach",63,29,34,0.46031746031746,60,25,35,0.416666666666667,0.0160321593522513,0.348991694068006,0.634976146579743
7,"Rheinland-Pfalz",7232128,"Uppershausen",78,42,36,0.538461538461538,74,42,32,0.567567567567568,0.0160321593522513,0.348991694068006,0.634976146579743
7,"Rheinland-Pfalz",7232129,"Usch",68,34,34,0.5,69,36,33,0.521739130434783,0.0160321593522513,0.348991694068006,0.634976146579743
7,"Rheinland-Pfalz",7232130,"Waldhof-Falkenstein",32,14,18,0.4375,33,15,18,0.454545454545455,0.0160321593522513,0.348991694068006,0.634976146579743
7,"Rheinland-Pfalz",7232131,"Wallendorf",377,193,184,0.511936339522546,371,192,179,0.517520215633423,0.0160321593522513,0.348991694068006,0.634976146579743
7,"Rheinland-Pfalz",7232132,"Weidingen",172,93,79,0.540697674418605,167,90,77,0.538922155688623,0.0160321593522513,0.348991694068006,0.634976146579743
7,"Rheinland-Pfalz",7232133,"Wettlingen",52,22,30,0.423076923076923,48,19,29,0.395833333333333,0.0160321593522513,0.348991694068006,0.634976146579743
7,"Rheinland-Pfalz",7232134,"Wiersdorf",254,132,122,0.519685039370079,255,138,117,0.541176470588235,0.0160321593522513,0.348991694068006,0.634976146579743
7,"Rheinland-Pfalz",7232135,"Wilsecker",183,99,84,0.540983606557377,185,105,80,0.567567567567568,0.0160321593522513,0.348991694068006,0.634976146579743
7,"Rheinland-Pfalz",7232137,"Wolsfeld",829,417,412,0.503015681544029,813,411,402,0.505535055350554,0.0160321593522513,0.348991694068006,0.634976146579743
7,"Rheinland-Pfalz",7232138,"Zweifelscheid",53,29,24,0.547169811320755,46,24,22,0.521739130434783,0.0160321593522513,0.348991694068006,0.634976146579743
7,"Rheinland-Pfalz",7232201,"Arzfeld",1363,682,681,0.500366837857667,1342,672,670,0.500745156482861,0.0160321593522513,0.348991694068006,0.634976146579743
7,"Rheinland-Pfalz",7232202,"Auw bei Prüm",652,338,314,0.51840490797546,664,359,305,0.54066265060241,0.0160321593522513,0.348991694068006,0.634976146579743
7,"Rheinland-Pfalz",7232203,"Balesfeld",215,98,117,0.455813953488372,222,108,114,0.486486486486487,0.0160321593522513,0.348991694068006,0.634976146579743
7,"Rheinland-Pfalz",7232206,"Bleialf",1196,594,602,0.496655518394649,1189,592,597,0.497897392767031,0.0160321593522513,0.348991694068006,0.634976146579743
7,"Rheinland-Pfalz",7232207,"Brandscheid",317,171,146,0.539432176656151,322,167,155,0.518633540372671,0.0160321593522513,0.348991694068006,0.634976146579743
7,"Rheinland-Pfalz",7232208,"Buchet",244,130,114,0.532786885245902,235,120,115,0.51063829787234,0.0160321593522513,0.348991694068006,0.634976146579743
7,"Rheinland-Pfalz",7232209,"Büdesheim",581,303,278,0.521514629948365,580,301,279,0.518965517241379,0.0160321593522513,0.348991694068006,0.634976146579743
7,"Rheinland-Pfalz",7232210,"Burbach",663,332,331,0.500754147812971,597,296,301,0.495812395309883,0.0160321593522513,0.348991694068006,0.634976146579743
7,"Rheinland-Pfalz",7232211,"Dackscheid",142,71,71,0.5,154,77,77,0.5,0.0160321593522513,0.348991694068006,0.634976146579743
7,"Rheinland-Pfalz",7232212,"Dahnen",320,160,160,0.5,352,183,169,0.519886363636364,0.0160321593522513,0.348991694068006,0.634976146579743
7,"Rheinland-Pfalz",7232213,"Daleiden",850,432,418,0.508235294117647,887,455,432,0.512965050732807,0.0160321593522513,0.348991694068006,0.634976146579743
7,"Rheinland-Pfalz",7232214,"Dasburg",229,109,120,0.475982532751092,226,110,116,0.486725663716814,0.0160321593522513,0.348991694068006,0.634976146579743
7,"Rheinland-Pfalz",7232216,"Dingdorf",96,51,45,0.53125,92,51,41,0.554347826086957,0.0160321593522513,0.348991694068006,0.634976146579743
7,"Rheinland-Pfalz",7232217,"Eilscheid",47,23,24,0.48936170212766,46,22,24,0.478260869565217,0.0160321593522513,0.348991694068006,0.634976146579743
7,"Rheinland-Pfalz",7232218,"Eisenach",360,191,169,0.530555555555556,357,189,168,0.529411764705882,0.0160321593522513,0.348991694068006,0.634976146579743
7,"Rheinland-Pfalz",7232220,"Eschfeld",182,90,92,0.494505494505495,181,88,93,0.486187845303867,0.0160321593522513,0.348991694068006,0.634976146579743
7,"Rheinland-Pfalz",7232221,"Euscheid",131,73,58,0.557251908396947,148,90,58,0.608108108108108,0.0160321593522513,0.348991694068006,0.634976146579743
7,"Rheinland-Pfalz",7232222,"Feuerscheid",332,175,157,0.52710843373494,342,179,163,0.523391812865497,0.0160321593522513,0.348991694068006,0.634976146579743
7,"Rheinland-Pfalz",7232223,"Fleringen",352,188,164,0.534090909090909,347,189,158,0.544668587896254,0.0160321593522513,0.348991694068006,0.634976146579743
7,"Rheinland-Pfalz",7232224,"Giesdorf",133,64,69,0.481203007518797,139,65,74,0.467625899280576,0.0160321593522513,0.348991694068006,0.634976146579743
7,"Rheinland-Pfalz",7232225,"Gilzem",430,215,215,0.5,414,212,202,0.51207729468599,0.0160321593522513,0.348991694068006,0.634976146579743
7,"Rheinland-Pfalz",7232226,"Weinsheim",1012,516,496,0.509881422924901,1023,520,503,0.50830889540567,0.0160321593522513,0.348991694068006,0.634976146579743
7,"Rheinland-Pfalz",7232227,"Gondenbrett",446,232,214,0.520179372197309,440,227,213,0.515909090909091,0.0160321593522513,0.348991694068006,0.634976146579743
7,"Rheinland-Pfalz",7232228,"Gransdorf",311,159,152,0.511254019292605,308,155,153,0.503246753246753,0.0160321593522513,0.348991694068006,0.634976146579743
7,"Rheinland-Pfalz",7232229,"Großkampenberg",152,82,70,0.539473684210526,156,85,71,0.544871794871795,0.0160321593522513,0.348991694068006,0.634976146579743
7,"Rheinland-Pfalz",7232230,"Großlangenfeld",127,58,69,0.456692913385827,124,57,67,0.459677419354839,0.0160321593522513,0.348991694068006,0.634976146579743
7,"Rheinland-Pfalz",7232231,"Habscheid",627,308,319,0.491228070175439,601,309,292,0.51414309484193,0.0160321593522513,0.348991694068006,0.634976146579743
7,"Rheinland-Pfalz",7232233,"Hargarten",93,48,45,0.516129032258065,93,48,45,0.516129032258065,0.0160321593522513,0.348991694068006,0.634976146579743
7,"Rheinland-Pfalz",7232234,"Harspelt",72,36,36,0.5,70,39,31,0.557142857142857,0.0160321593522513,0.348991694068006,0.634976146579743
7,"Rheinland-Pfalz",7232236,"Heckhuscheid",151,78,73,0.516556291390728,135,72,63,0.533333333333333,0.0160321593522513,0.348991694068006,0.634976146579743
7,"Rheinland-Pfalz",7232238,"Heisdorf",108,53,55,0.490740740740741,101,49,52,0.485148514851485,0.0160321593522513,0.348991694068006,0.634976146579743
7,"Rheinland-Pfalz",7232240,"Herzfeld",41,22,19,0.536585365853659,34,20,14,0.588235294117647,0.0160321593522513,0.348991694068006,0.634976146579743
7,"Rheinland-Pfalz",7232245,"Irrhausen",220,112,108,0.509090909090909,224,115,109,0.513392857142857,0.0160321593522513,0.348991694068006,0.634976146579743
7,"Rheinland-Pfalz",7232246,"Jucken",173,84,89,0.485549132947977,175,85,90,0.485714285714286,0.0160321593522513,0.348991694068006,0.634976146579743
7,"Rheinland-Pfalz",7232247,"Kesfeld",81,48,33,0.592592592592593,79,48,31,0.607594936708861,0.0160321593522513,0.348991694068006,0.634976146579743
7,"Rheinland-Pfalz",7232248,"Kickeshausen",40,17,23,0.425,36,15,21,0.416666666666667,0.0160321593522513,0.348991694068006,0.634976146579743
7,"Rheinland-Pfalz",7232249,"Kinzenburg",48,23,25,0.479166666666667,46,22,24,0.478260869565217,0.0160321593522513,0.348991694068006,0.634976146579743
7,"Rheinland-Pfalz",7232250,"Kleinlangenfeld",152,70,82,0.460526315789474,153,69,84,0.450980392156863,0.0160321593522513,0.348991694068006,0.634976146579743
7,"Rheinland-Pfalz",7232253,"Krautscheid",236,120,116,0.508474576271186,248,124,124,0.5,0.0160321593522513,0.348991694068006,0.634976146579743
7,"Rheinland-Pfalz",7232254,"Lambertsberg",348,178,170,0.511494252873563,348,173,175,0.497126436781609,0.0160321593522513,0.348991694068006,0.634976146579743
7,"Rheinland-Pfalz",7232255,"Lascheid",75,39,36,0.52,69,38,31,0.550724637681159,0.0160321593522513,0.348991694068006,0.634976146579743
7,"Rheinland-Pfalz",7232256,"Lasel",320,170,150,0.53125,311,162,149,0.520900321543408,0.0160321593522513,0.348991694068006,0.634976146579743
7,"Rheinland-Pfalz",7232258,"Lauperath",103,53,50,0.514563106796116,100,51,49,0.51,0.0160321593522513,0.348991694068006,0.634976146579743
7,"Rheinland-Pfalz",7232259,"Leidenborn",171,85,86,0.497076023391813,174,88,86,0.505747126436782,0.0160321593522513,0.348991694068006,0.634976146579743
7,"Rheinland-Pfalz",7232260,"Lichtenborn",323,157,166,0.486068111455108,325,158,167,0.486153846153846,0.0160321593522513,0.348991694068006,0.634976146579743
7,"Rheinland-Pfalz",7232261,"Lierfeld",80,40,40,0.5,84,40,44,0.476190476190476,0.0160321593522513,0.348991694068006,0.634976146579743
7,"Rheinland-Pfalz",7232262,"Lünebach",557,262,295,0.470377019748653,575,275,300,0.478260869565217,0.0160321593522513,0.348991694068006,0.634976146579743
7,"Rheinland-Pfalz",7232263,"Lützkampen",383,190,193,0.496083550913838,363,175,188,0.482093663911846,0.0160321593522513,0.348991694068006,0.634976146579743
7,"Rheinland-Pfalz",7232264,"Manderscheid",67,35,32,0.522388059701492,52,31,21,0.596153846153846,0.0160321593522513,0.348991694068006,0.634976146579743
7,"Rheinland-Pfalz",7232265,"Masthorn",59,27,32,0.457627118644068,63,27,36,0.428571428571429,0.0160321593522513,0.348991694068006,0.634976146579743
7,"Rheinland-Pfalz",7232266,"Matzerath",56,28,28,0.5,57,28,29,0.491228070175439,0.0160321593522513,0.348991694068006,0.634976146579743
7,"Rheinland-Pfalz",7232267,"Mauel",59,34,25,0.576271186440678,60,34,26,0.566666666666667,0.0160321593522513,0.348991694068006,0.634976146579743
7,"Rheinland-Pfalz",7232270,"Merlscheid",35,19,16,0.542857142857143,34,18,16,0.529411764705882,0.0160321593522513,0.348991694068006,0.634976146579743
7,"Rheinland-Pfalz",7232271,"Mützenich",111,58,53,0.522522522522523,113,57,56,0.504424778761062,0.0160321593522513,0.348991694068006,0.634976146579743
7,"Rheinland-Pfalz",7232272,"Neuendorf",94,52,42,0.553191489361702,95,50,45,0.526315789473684,0.0160321593522513,0.348991694068006,0.634976146579743
7,"Rheinland-Pfalz",7232273,"Neuheilenbach",262,134,128,0.511450381679389,240,120,120,0.5,0.0160321593522513,0.348991694068006,0.634976146579743
7,"Rheinland-Pfalz",7232276,"Niederlauch",46,23,23,0.5,47,24,23,0.51063829787234,0.0160321593522513,0.348991694068006,0.634976146579743
7,"Rheinland-Pfalz",7232277,"Niederpierscheid",41,20,21,0.48780487804878,37,17,20,0.459459459459459,0.0160321593522513,0.348991694068006,0.634976146579743
7,"Rheinland-Pfalz",7232279,"Nimshuscheid",294,150,144,0.510204081632653,281,145,136,0.516014234875445,0.0160321593522513,0.348991694068006,0.634976146579743
7,"Rheinland-Pfalz",7232280,"Nimsreuland",98,49,49,0.5,104,52,52,0.5,0.0160321593522513,0.348991694068006,0.634976146579743
7,"Rheinland-Pfalz",7232282,"Oberkail",612,308,304,0.503267973856209,595,294,301,0.494117647058824,0.0160321593522513,0.348991694068006,0.634976146579743
7,"Rheinland-Pfalz",7232283,"Oberlascheid",122,65,57,0.532786885245902,131,69,62,0.526717557251908,0.0160321593522513,0.348991694068006,0.634976146579743
7,"Rheinland-Pfalz",7232284,"Oberlauch",61,34,27,0.557377049180328,59,35,24,0.593220338983051,0.0160321593522513,0.348991694068006,0.634976146579743
7,"Rheinland-Pfalz",7232285,"Oberpierscheid",355,173,182,0.487323943661972,365,177,188,0.484931506849315,0.0160321593522513,0.348991694068006,0.634976146579743
7,"Rheinland-Pfalz",7232287,"Olmscheid",153,76,77,0.496732026143791,163,82,81,0.503067484662577,0.0160321593522513,0.348991694068006,0.634976146579743
7,"Rheinland-Pfalz",7232288,"Olzheim",570,296,274,0.519298245614035,564,300,264,0.531914893617021,0.0160321593522513,0.348991694068006,0.634976146579743
7,"Rheinland-Pfalz",7232289,"Orenhofen",1277,625,652,0.489428347689898,1259,618,641,0.490865766481334,0.0160321593522513,0.348991694068006,0.634976146579743
7,"Rheinland-Pfalz",7232290,"Orlenbach",200,98,102,0.49,202,106,96,0.524752475247525,0.0160321593522513,0.348991694068006,0.634976146579743
7,"Rheinland-Pfalz",7232291,"Pintesfeld",44,22,22,0.5,40,21,19,0.525,0.0160321593522513,0.348991694068006,0.634976146579743
7,"Rheinland-Pfalz",7232292,"Pittenbach",98,54,44,0.551020408163265,94,54,40,0.574468085106383,0.0160321593522513,0.348991694068006,0.634976146579743
7,"Rheinland-Pfalz",7232293,"Plütscheid",309,153,156,0.495145631067961,307,152,155,0.495114006514658,0.0160321593522513,0.348991694068006,0.634976146579743
7,"Rheinland-Pfalz",7232294,"Preischeid",178,89,89,0.5,176,89,87,0.505681818181818,0.0160321593522513,0.348991694068006,0.634976146579743
7,"Rheinland-Pfalz",7232295,"Pronsfeld",955,459,496,0.480628272251309,945,459,486,0.485714285714286,0.0160321593522513,0.348991694068006,0.634976146579743
7,"Rheinland-Pfalz",7232296,"Prüm, Stadt",5391,2647,2744,0.491003524392506,5276,2599,2677,0.492608036391205,0.0160321593522513,0.348991694068006,0.634976146579743
7,"Rheinland-Pfalz",7232297,"Reiff",55,27,28,0.490909090909091,59,31,28,0.525423728813559,0.0160321593522513,0.348991694068006,0.634976146579743
7,"Rheinland-Pfalz",7232298,"Reipeldingen",68,33,35,0.485294117647059,58,29,29,0.5,0.0160321593522513,0.348991694068006,0.634976146579743
7,"Rheinland-Pfalz",7232300,"Rommersheim",651,318,333,0.488479262672811,652,319,333,0.489263803680982,0.0160321593522513,0.348991694068006,0.634976146579743
7,"Rheinland-Pfalz",7232301,"Roscheid",70,34,36,0.485714285714286,61,31,30,0.508196721311475,0.0160321593522513,0.348991694068006,0.634976146579743
7,"Rheinland-Pfalz",7232302,"Roth bei Prüm",450,227,223,0.504444444444444,453,242,211,0.534216335540839,0.0160321593522513,0.348991694068006,0.634976146579743
7,"Rheinland-Pfalz",7232304,"Schönecken",1489,737,752,0.494963062458026,1501,739,762,0.492338441039307,0.0160321593522513,0.348991694068006,0.634976146579743
7,"Rheinland-Pfalz",7232305,"Schwirzheim",444,229,215,0.515765765765766,428,217,211,0.507009345794392,0.0160321593522513,0.348991694068006,0.634976146579743
7,"Rheinland-Pfalz",7232306,"Seinsfeld",157,83,74,0.528662420382166,156,82,74,0.525641025641026,0.0160321593522513,0.348991694068006,0.634976146579743
7,"Rheinland-Pfalz",7232307,"Seiwerath",147,81,66,0.551020408163265,135,69,66,0.511111111111111,0.0160321593522513,0.348991694068006,0.634976146579743
7,"Rheinland-Pfalz",7232308,"Sellerich",309,159,150,0.514563106796116,297,153,144,0.515151515151515,0.0160321593522513,0.348991694068006,0.634976146579743
7,"Rheinland-Pfalz",7232309,"Sengerich",21,11,10,0.523809523809524,23,12,11,0.521739130434783,0.0160321593522513,0.348991694068006,0.634976146579743
7,"Rheinland-Pfalz",7232310,"Sevenig (Our)",52,26,26,0.5,57,29,28,0.508771929824561,0.0160321593522513,0.348991694068006,0.634976146579743
7,"Rheinland-Pfalz",7232311,"Spangdahlem",839,420,419,0.500595947556615,795,399,396,0.50188679245283,0.0160321593522513,0.348991694068006,0.634976146579743
7,"Rheinland-Pfalz",7232313,"Steinborn",204,103,101,0.504901960784314,194,94,100,0.484536082474227,0.0160321593522513,0.348991694068006,0.634976146579743
7,"Rheinland-Pfalz",7232315,"Strickscheid",31,16,15,0.516129032258065,33,17,16,0.515151515151515,0.0160321593522513,0.348991694068006,0.634976146579743
7,"Rheinland-Pfalz",7232318,"Wallersheim",733,363,370,0.495225102319236,730,366,364,0.501369863013699,0.0160321593522513,0.348991694068006,0.634976146579743
7,"Rheinland-Pfalz",7232320,"Watzerath",402,189,213,0.470149253731343,414,197,217,0.475845410628019,0.0160321593522513,0.348991694068006,0.634976146579743
7,"Rheinland-Pfalz",7232321,"Wawern",292,161,131,0.551369863013699,300,167,133,0.556666666666667,0.0160321593522513,0.348991694068006,0.634976146579743
7,"Rheinland-Pfalz",7232322,"Waxweiler",1075,531,544,0.493953488372093,1080,536,544,0.496296296296296,0.0160321593522513,0.348991694068006,0.634976146579743
7,"Rheinland-Pfalz",7232327,"Winringen",66,28,38,0.424242424242424,65,30,35,0.461538461538462,0.0160321593522513,0.348991694068006,0.634976146579743
7,"Rheinland-Pfalz",7232328,"Winterscheid",153,76,77,0.496732026143791,134,68,66,0.507462686567164,0.0160321593522513,0.348991694068006,0.634976146579743
7,"Rheinland-Pfalz",7232329,"Winterspelt",836,416,420,0.497607655502392,804,397,407,0.493781094527363,0.0160321593522513,0.348991694068006,0.634976146579743
7,"Rheinland-Pfalz",7232331,"Zendscheid",132,64,68,0.484848484848485,129,61,68,0.472868217054264,0.0160321593522513,0.348991694068006,0.634976146579743
7,"Rheinland-Pfalz",7232332,"Hersdorf",403,202,201,0.501240694789082,381,190,191,0.498687664041995,0.0160321593522513,0.348991694068006,0.634976146579743
7,"Rheinland-Pfalz",7232333,"Üttfeld",434,215,219,0.495391705069124,461,239,222,0.518438177874187,0.0160321593522513,0.348991694068006,0.634976146579743
7,"Rheinland-Pfalz",7232501,"Wißmannsdorf",804,386,418,0.480099502487562,772,380,392,0.492227979274611,0.0160321593522513,0.348991694068006,0.634976146579743
7,"Rheinland-Pfalz",7233002,"Basberg",84,38,46,0.452380952380952,64,31,33,0.484375,0.0160321593522513,0.348991694068006,0.634976146579743
7,"Rheinland-Pfalz",7233003,"Beinhausen",76,41,35,0.539473684210526,75,43,32,0.573333333333333,0.0160321593522513,0.348991694068006,0.634976146579743
7,"Rheinland-Pfalz",7233004,"Berlingen",221,115,106,0.520361990950226,186,98,88,0.526881720430108,0.0160321593522513,0.348991694068006,0.634976146579743
7,"Rheinland-Pfalz",7233005,"Berndorf",562,275,287,0.48932384341637,522,251,271,0.480842911877395,0.0160321593522513,0.348991694068006,0.634976146579743
7,"Rheinland-Pfalz",7233006,"Betteldorf",292,145,147,0.496575342465753,276,138,138,0.5,0.0160321593522513,0.348991694068006,0.634976146579743
7,"Rheinland-Pfalz",7233007,"Birgel",468,234,234,0.5,463,232,231,0.501079913606911,0.0160321593522513,0.348991694068006,0.634976146579743
7,"Rheinland-Pfalz",7233008,"Bleckhausen",308,146,162,0.474025974025974,291,135,156,0.463917525773196,0.0160321593522513,0.348991694068006,0.634976146579743
7,"Rheinland-Pfalz",7233010,"Boxberg",231,123,108,0.532467532467532,215,116,99,0.53953488372093,0.0160321593522513,0.348991694068006,0.634976146579743
7,"Rheinland-Pfalz",7233011,"Brockscheid",201,99,102,0.492537313432836,195,97,98,0.497435897435897,0.0160321593522513,0.348991694068006,0.634976146579743
7,"Rheinland-Pfalz",7233014,"Darscheid",828,393,435,0.47463768115942,821,386,435,0.470158343483557,0.0160321593522513,0.348991694068006,0.634976146579743
7,"Rheinland-Pfalz",7233016,"Demerath",316,157,159,0.496835443037975,313,152,161,0.485623003194888,0.0160321593522513,0.348991694068006,0.634976146579743
7,"Rheinland-Pfalz",7233017,"Deudesfeld",374,178,196,0.475935828877005,383,180,203,0.469973890339426,0.0160321593522513,0.348991694068006,0.634976146579743
7,"Rheinland-Pfalz",7233018,"Dockweiler",660,337,323,0.510606060606061,658,336,322,0.51063829787234,0.0160321593522513,0.348991694068006,0.634976146579743
7,"Rheinland-Pfalz",7233019,"Dohm-Lammersdorf",183,90,93,0.491803278688525,175,86,89,0.491428571428571,0.0160321593522513,0.348991694068006,0.634976146579743
7,"Rheinland-Pfalz",7233020,"Dreis-Brück",868,434,434,0.5,891,438,453,0.491582491582492,0.0160321593522513,0.348991694068006,0.634976146579743
7,"Rheinland-Pfalz",7233021,"Ellscheid",269,136,133,0.505576208178439,258,126,132,0.488372093023256,0.0160321593522513,0.348991694068006,0.634976146579743
7,"Rheinland-Pfalz",7233022,"Esch",472,219,253,0.463983050847458,474,217,257,0.457805907172996,0.0160321593522513,0.348991694068006,0.634976146579743
7,"Rheinland-Pfalz",7233023,"Feusdorf",504,248,256,0.492063492063492,535,260,275,0.485981308411215,0.0160321593522513,0.348991694068006,0.634976146579743
7,"Rheinland-Pfalz",7233025,"Gefell",108,52,56,0.481481481481481,96,49,47,0.510416666666667,0.0160321593522513,0.348991694068006,0.634976146579743
7,"Rheinland-Pfalz",7233026,"Gerolstein, Stadt",7594,3687,3907,0.485514880168554,7390,3564,3826,0.482273342354533,0.0160321593522513,0.348991694068006,0.634976146579743
7,"Rheinland-Pfalz",7233027,"Gillenfeld",1437,707,730,0.491997216423104,1422,698,724,0.490857946554149,0.0160321593522513,0.348991694068006,0.634976146579743
7,"Rheinland-Pfalz",7233028,"Gönnersdorf",510,269,241,0.527450980392157,531,276,255,0.519774011299435,0.0160321593522513,0.348991694068006,0.634976146579743
7,"Rheinland-Pfalz",7233029,"Hillesheim, Stadt",3109,1487,1622,0.478288838854937,3012,1442,1570,0.47875166002656,0.0160321593522513,0.348991694068006,0.634976146579743
7,"Rheinland-Pfalz",7233030,"Hinterweiler",243,113,130,0.465020576131687,229,106,123,0.462882096069869,0.0160321593522513,0.348991694068006,0.634976146579743
7,"Rheinland-Pfalz",7233031,"Hörscheid",129,60,69,0.465116279069767,131,60,71,0.458015267175573,0.0160321593522513,0.348991694068006,0.634976146579743
7,"Rheinland-Pfalz",7233032,"Hörschhausen",140,74,66,0.528571428571429,141,78,63,0.553191489361702,0.0160321593522513,0.348991694068006,0.634976146579743
7,"Rheinland-Pfalz",7233033,"Hohenfels-Essingen",327,166,161,0.507645259938838,340,170,170,0.5,0.0160321593522513,0.348991694068006,0.634976146579743
7,"Rheinland-Pfalz",7233034,"Immerath",237,117,120,0.493670886075949,243,122,121,0.502057613168724,0.0160321593522513,0.348991694068006,0.634976146579743
7,"Rheinland-Pfalz",7233035,"Jünkerath",1712,830,882,0.48481308411215,1579,784,795,0.496516782773908,0.0160321593522513,0.348991694068006,0.634976146579743
7,"Rheinland-Pfalz",7233036,"Kalenborn-Scheuern",441,214,227,0.485260770975057,447,223,224,0.498881431767338,0.0160321593522513,0.348991694068006,0.634976146579743
7,"Rheinland-Pfalz",7233037,"Katzwinkel",142,78,64,0.549295774647887,105,65,40,0.619047619047619,0.0160321593522513,0.348991694068006,0.634976146579743
7,"Rheinland-Pfalz",7233038,"Kerpen (Eifel)",476,231,245,0.485294117647059,402,185,217,0.460199004975124,0.0160321593522513,0.348991694068006,0.634976146579743
7,"Rheinland-Pfalz",7233039,"Kirchweiler",360,195,165,0.541666666666667,359,186,173,0.518105849582173,0.0160321593522513,0.348991694068006,0.634976146579743
7,"Rheinland-Pfalz",7233040,"Kradenbach",150,74,76,0.493333333333333,151,73,78,0.483443708609272,0.0160321593522513,0.348991694068006,0.634976146579743
7,"Rheinland-Pfalz",7233041,"Lissendorf",1118,539,579,0.48211091234347,1096,518,578,0.472627737226277,0.0160321593522513,0.348991694068006,0.634976146579743
7,"Rheinland-Pfalz",7233042,"Mehren",1418,692,726,0.488011283497884,1440,696,744,0.483333333333333,0.0160321593522513,0.348991694068006,0.634976146579743
7,"Rheinland-Pfalz",7233043,"Meisburg",246,120,126,0.48780487804878,241,112,129,0.464730290456432,0.0160321593522513,0.348991694068006,0.634976146579743
7,"Rheinland-Pfalz",7233046,"Mückeln",217,102,115,0.470046082949309,216,109,107,0.50462962962963,0.0160321593522513,0.348991694068006,0.634976146579743
7,"Rheinland-Pfalz",7233048,"Neichen",137,67,70,0.489051094890511,138,71,67,0.514492753623188,0.0160321593522513,0.348991694068006,0.634976146579743
7,"Rheinland-Pfalz",7233049,"Nerdlen",215,109,106,0.506976744186047,222,111,111,0.5,0.0160321593522513,0.348991694068006,0.634976146579743
7,"Rheinland-Pfalz",7233050,"Neroth",862,428,434,0.496519721577726,862,423,439,0.490719257540603,0.0160321593522513,0.348991694068006,0.634976146579743
7,"Rheinland-Pfalz",7233052,"Niederstadtfeld",467,232,235,0.49678800856531,451,225,226,0.498891352549889,0.0160321593522513,0.348991694068006,0.634976146579743
7,"Rheinland-Pfalz",7233053,"Oberbettingen",729,357,372,0.489711934156379,718,346,372,0.481894150417827,0.0160321593522513,0.348991694068006,0.634976146579743
7,"Rheinland-Pfalz",7233054,"Oberehe-Stroheich",327,173,154,0.529051987767584,331,173,158,0.522658610271903,0.0160321593522513,0.348991694068006,0.634976146579743
7,"Rheinland-Pfalz",7233055,"Oberstadtfeld",571,277,294,0.485113835376532,574,280,294,0.48780487804878,0.0160321593522513,0.348991694068006,0.634976146579743
7,"Rheinland-Pfalz",7233056,"Pelm",976,490,486,0.502049180327869,983,499,484,0.507629704984741,0.0160321593522513,0.348991694068006,0.634976146579743
7,"Rheinland-Pfalz",7233058,"Rockeskyll",252,129,123,0.511904761904762,245,124,121,0.506122448979592,0.0160321593522513,0.348991694068006,0.634976146579743
7,"Rheinland-Pfalz",7233060,"Salm",328,171,157,0.521341463414634,332,178,154,0.536144578313253,0.0160321593522513,0.348991694068006,0.634976146579743
7,"Rheinland-Pfalz",7233061,"Sarmersbach",202,109,93,0.53960396039604,191,103,88,0.539267015706806,0.0160321593522513,0.348991694068006,0.634976146579743
7,"Rheinland-Pfalz",7233062,"Saxler",68,35,33,0.514705882352941,65,32,33,0.492307692307692,0.0160321593522513,0.348991694068006,0.634976146579743
7,"Rheinland-Pfalz",7233063,"Schalkenmehren",597,306,291,0.512562814070352,589,303,286,0.514431239388795,0.0160321593522513,0.348991694068006,0.634976146579743
7,"Rheinland-Pfalz",7233064,"Schönbach",254,130,124,0.511811023622047,262,139,123,0.530534351145038,0.0160321593522513,0.348991694068006,0.634976146579743
7,"Rheinland-Pfalz",7233065,"Schutz",144,75,69,0.520833333333333,138,68,70,0.492753623188406,0.0160321593522513,0.348991694068006,0.634976146579743
7,"Rheinland-Pfalz",7233067,"Steineberg",250,127,123,0.508,257,129,128,0.501945525291829,0.0160321593522513,0.348991694068006,0.634976146579743
7,"Rheinland-Pfalz",7233068,"Steiningen",208,98,110,0.471153846153846,197,95,102,0.482233502538071,0.0160321593522513,0.348991694068006,0.634976146579743
7,"Rheinland-Pfalz",7233070,"Strohn",506,260,246,0.513833992094862,502,268,234,0.533864541832669,0.0160321593522513,0.348991694068006,0.634976146579743
7,"Rheinland-Pfalz",7233071,"Strotzbüsch",439,244,195,0.555808656036446,444,247,197,0.556306306306306,0.0160321593522513,0.348991694068006,0.634976146579743
7,"Rheinland-Pfalz",7233074,"Udler",284,140,144,0.492957746478873,281,135,146,0.480427046263345,0.0160321593522513,0.348991694068006,0.634976146579743
7,"Rheinland-Pfalz",7233075,"Üdersdorf",1117,548,569,0.49059982094897,1109,538,571,0.48512173128945,0.0160321593522513,0.348991694068006,0.634976146579743
7,"Rheinland-Pfalz",7233076,"Üxheim",1420,723,697,0.509154929577465,1356,695,661,0.512536873156342,0.0160321593522513,0.348991694068006,0.634976146579743
7,"Rheinland-Pfalz",7233077,"Utzerath",176,83,93,0.471590909090909,188,95,93,0.50531914893617,0.0160321593522513,0.348991694068006,0.634976146579743
7,"Rheinland-Pfalz",7233079,"Wallenborn",428,219,209,0.511682242990654,422,217,205,0.514218009478673,0.0160321593522513,0.348991694068006,0.634976146579743
7,"Rheinland-Pfalz",7233080,"Walsdorf",908,457,451,0.503303964757709,896,451,445,0.503348214285714,0.0160321593522513,0.348991694068006,0.634976146579743
7,"Rheinland-Pfalz",7233081,"Weidenbach",262,122,140,0.465648854961832,249,120,129,0.481927710843373,0.0160321593522513,0.348991694068006,0.634976146579743
7,"Rheinland-Pfalz",7233083,"Wiesbaum",646,331,315,0.512383900928793,621,316,305,0.508856682769726,0.0160321593522513,0.348991694068006,0.634976146579743
7,"Rheinland-Pfalz",7233084,"Winkel (Eifel)",138,68,70,0.492753623188406,130,67,63,0.515384615384615,0.0160321593522513,0.348991694068006,0.634976146579743
7,"Rheinland-Pfalz",7233201,"Arbach",147,69,78,0.469387755102041,135,68,67,0.503703703703704,0.0160321593522513,0.348991694068006,0.634976146579743
7,"Rheinland-Pfalz",7233202,"Bereborn",100,46,54,0.46,107,49,58,0.457943925233645,0.0160321593522513,0.348991694068006,0.634976146579743
7,"Rheinland-Pfalz",7233203,"Berenbach",174,94,80,0.540229885057471,181,98,83,0.541436464088398,0.0160321593522513,0.348991694068006,0.634976146579743
7,"Rheinland-Pfalz",7233204,"Birresborn",1193,581,612,0.487007544006706,1154,567,587,0.491334488734835,0.0160321593522513,0.348991694068006,0.634976146579743
7,"Rheinland-Pfalz",7233205,"Bodenbach",228,114,114,0.5,216,114,102,0.527777777777778,0.0160321593522513,0.348991694068006,0.634976146579743
7,"Rheinland-Pfalz",7233206,"Bongard",255,132,123,0.517647058823529,241,128,113,0.531120331950207,0.0160321593522513,0.348991694068006,0.634976146579743
7,"Rheinland-Pfalz",7233207,"Borler",71,37,34,0.52112676056338,71,40,31,0.563380281690141,0.0160321593522513,0.348991694068006,0.634976146579743
7,"Rheinland-Pfalz",7233208,"Brücktal",76,40,36,0.526315789473684,92,53,39,0.576086956521739,0.0160321593522513,0.348991694068006,0.634976146579743
7,"Rheinland-Pfalz",7233209,"Densborn",546,279,267,0.510989010989011,560,295,265,0.526785714285714,0.0160321593522513,0.348991694068006,0.634976146579743
7,"Rheinland-Pfalz",7233210,"Drees",157,69,88,0.439490445859873,157,69,88,0.439490445859873,0.0160321593522513,0.348991694068006,0.634976146579743
7,"Rheinland-Pfalz",7233211,"Duppach",295,145,150,0.491525423728814,280,136,144,0.485714285714286,0.0160321593522513,0.348991694068006,0.634976146579743
7,"Rheinland-Pfalz",7233212,"Gelenberg",93,45,48,0.483870967741935,96,46,50,0.479166666666667,0.0160321593522513,0.348991694068006,0.634976146579743
7,"Rheinland-Pfalz",7233213,"Gunderath",111,52,59,0.468468468468468,122,60,62,0.491803278688525,0.0160321593522513,0.348991694068006,0.634976146579743
7,"Rheinland-Pfalz",7233214,"Hallschlag",495,247,248,0.498989898989899,512,256,256,0.5,0.0160321593522513,0.348991694068006,0.634976146579743
7,"Rheinland-Pfalz",7233215,"Höchstberg",341,168,173,0.49266862170088,342,170,172,0.497076023391813,0.0160321593522513,0.348991694068006,0.634976146579743
7,"Rheinland-Pfalz",7233216,"Horperath",133,60,73,0.451127819548872,132,58,74,0.439393939393939,0.0160321593522513,0.348991694068006,0.634976146579743
7,"Rheinland-Pfalz",7233217,"Kaperich",179,88,91,0.491620111731844,170,85,85,0.5,0.0160321593522513,0.348991694068006,0.634976146579743
7,"Rheinland-Pfalz",7233218,"Kelberg",1963,966,997,0.492103922567499,1966,997,969,0.507121057985758,0.0160321593522513,0.348991694068006,0.634976146579743
7,"Rheinland-Pfalz",7233219,"Kerschenbach",195,109,86,0.558974358974359,188,106,82,0.563829787234043,0.0160321593522513,0.348991694068006,0.634976146579743
7,"Rheinland-Pfalz",7233220,"Kirsbach",76,44,32,0.578947368421053,77,46,31,0.597402597402597,0.0160321593522513,0.348991694068006,0.634976146579743
7,"Rheinland-Pfalz",7233221,"Kötterichen",111,55,56,0.495495495495495,115,58,57,0.504347826086956,0.0160321593522513,0.348991694068006,0.634976146579743
7,"Rheinland-Pfalz",7233222,"Kolverath",130,65,65,0.5,126,58,68,0.46031746031746,0.0160321593522513,0.348991694068006,0.634976146579743
7,"Rheinland-Pfalz",7233223,"Kopp",177,88,89,0.497175141242938,164,78,86,0.475609756097561,0.0160321593522513,0.348991694068006,0.634976146579743
7,"Rheinland-Pfalz",7233224,"Lirstal",215,107,108,0.497674418604651,199,99,100,0.49748743718593,0.0160321593522513,0.348991694068006,0.634976146579743
7,"Rheinland-Pfalz",7233225,"Mannebach",249,129,120,0.518072289156627,237,125,112,0.527426160337553,0.0160321593522513,0.348991694068006,0.634976146579743
7,"Rheinland-Pfalz",7233226,"Mosbruch",152,78,74,0.513157894736842,153,73,80,0.477124183006536,0.0160321593522513,0.348991694068006,0.634976146579743
7,"Rheinland-Pfalz",7233227,"Mürlenbach",593,291,302,0.490725126475548,594,298,296,0.501683501683502,0.0160321593522513,0.348991694068006,0.634976146579743
7,"Rheinland-Pfalz",7233228,"Nitz",42,26,16,0.619047619047619,44,29,15,0.659090909090909,0.0160321593522513,0.348991694068006,0.634976146579743
7,"Rheinland-Pfalz",7233229,"Nohn",433,215,218,0.496535796766744,432,211,221,0.488425925925926,0.0160321593522513,0.348991694068006,0.634976146579743
7,"Rheinland-Pfalz",7233230,"Oberelz",122,57,65,0.467213114754098,114,56,58,0.491228070175439,0.0160321593522513,0.348991694068006,0.634976146579743
7,"Rheinland-Pfalz",7233232,"Ormont",383,200,183,0.522193211488251,375,190,185,0.506666666666667,0.0160321593522513,0.348991694068006,0.634976146579743
7,"Rheinland-Pfalz",7233233,"Reimerath",64,34,30,0.53125,68,36,32,0.529411764705882,0.0160321593522513,0.348991694068006,0.634976146579743
7,"Rheinland-Pfalz",7233234,"Retterath",337,164,173,0.486646884272997,344,170,174,0.494186046511628,0.0160321593522513,0.348991694068006,0.634976146579743
7,"Rheinland-Pfalz",7233235,"Reuth",188,91,97,0.484042553191489,196,97,99,0.494897959183673,0.0160321593522513,0.348991694068006,0.634976146579743
7,"Rheinland-Pfalz",7233236,"Sassen",82,40,42,0.48780487804878,81,43,38,0.530864197530864,0.0160321593522513,0.348991694068006,0.634976146579743
7,"Rheinland-Pfalz",7233237,"Scheid",135,71,64,0.525925925925926,118,60,58,0.508474576271186,0.0160321593522513,0.348991694068006,0.634976146579743
7,"Rheinland-Pfalz",7233239,"Schüller",317,154,163,0.485804416403785,336,166,170,0.494047619047619,0.0160321593522513,0.348991694068006,0.634976146579743
7,"Rheinland-Pfalz",7233240,"Stadtkyll",1438,719,719,0.5,1469,742,727,0.505105513955072,0.0160321593522513,0.348991694068006,0.634976146579743
7,"Rheinland-Pfalz",7233241,"Steffeln",642,335,307,0.521806853582555,648,343,305,0.529320987654321,0.0160321593522513,0.348991694068006,0.634976146579743
7,"Rheinland-Pfalz",7233242,"Uersfeld",683,349,334,0.510980966325037,688,366,322,0.531976744186046,0.0160321593522513,0.348991694068006,0.634976146579743
7,"Rheinland-Pfalz",7233243,"Ueß",50,27,23,0.54,57,26,31,0.456140350877193,0.0160321593522513,0.348991694068006,0.634976146579743
7,"Rheinland-Pfalz",7233244,"Welcherath",132,69,63,0.522727272727273,129,68,61,0.527131782945736,0.0160321593522513,0.348991694068006,0.634976146579743
7,"Rheinland-Pfalz",7233501,"Daun, Stadt",8088,3965,4123,0.490232443125618,8043,3963,4080,0.492726594554271,0.0160321593522513,0.348991694068006,0.634976146579743
7,"Rheinland-Pfalz",7235001,"Aach",1113,546,567,0.490566037735849,1115,542,573,0.48609865470852,0.0160321593522513,0.348991694068006,0.634976146579743
7,"Rheinland-Pfalz",7235002,"Ayl",1464,720,744,0.491803278688525,1469,726,743,0.494213750850919,0.0160321593522513,0.348991694068006,0.634976146579743
7,"Rheinland-Pfalz",7235003,"Baldringen",273,137,136,0.501831501831502,261,131,130,0.501915708812261,0.0160321593522513,0.348991694068006,0.634976146579743
7,"Rheinland-Pfalz",7235004,"Bekond",837,425,412,0.507765830346475,852,436,416,0.511737089201878,0.0160321593522513,0.348991694068006,0.634976146579743
7,"Rheinland-Pfalz",7235005,"Bescheid",402,207,195,0.514925373134328,410,214,196,0.521951219512195,0.0160321593522513,0.348991694068006,0.634976146579743
7,"Rheinland-Pfalz",7235008,"Beuren (Hochwald)",933,465,468,0.498392282958199,931,454,477,0.487647690655209,0.0160321593522513,0.348991694068006,0.634976146579743
7,"Rheinland-Pfalz",7235010,"Bonerath",252,121,131,0.48015873015873,252,118,134,0.468253968253968,0.0160321593522513,0.348991694068006,0.634976146579743
7,"Rheinland-Pfalz",7235014,"Damflos",634,309,325,0.487381703470032,622,300,322,0.482315112540193,0.0160321593522513,0.348991694068006,0.634976146579743
7,"Rheinland-Pfalz",7235015,"Detzem",562,268,294,0.476868327402135,551,266,285,0.482758620689655,0.0160321593522513,0.348991694068006,0.634976146579743
7,"Rheinland-Pfalz",7235019,"Ensch",465,232,233,0.498924731182796,470,234,236,0.497872340425532,0.0160321593522513,0.348991694068006,0.634976146579743
7,"Rheinland-Pfalz",7235021,"Farschweiler",751,376,375,0.500665778961385,737,358,379,0.485753052917232,0.0160321593522513,0.348991694068006,0.634976146579743
7,"Rheinland-Pfalz",7235022,"Fell",2439,1203,1236,0.493234932349323,2441,1221,1220,0.500204834084392,0.0160321593522513,0.348991694068006,0.634976146579743
7,"Rheinland-Pfalz",7235025,"Fisch",360,184,176,0.511111111111111,363,186,177,0.512396694214876,0.0160321593522513,0.348991694068006,0.634976146579743
7,"Rheinland-Pfalz",7235026,"Föhren",2671,1331,1340,0.498315237738675,2687,1336,1351,0.497208783029401,0.0160321593522513,0.348991694068006,0.634976146579743
7,"Rheinland-Pfalz",7235027,"Franzenheim",370,201,169,0.543243243243243,374,203,171,0.542780748663102,0.0160321593522513,0.348991694068006,0.634976146579743
7,"Rheinland-Pfalz",7235028,"Freudenburg",1644,799,845,0.486009732360097,1648,804,844,0.487864077669903,0.0160321593522513,0.348991694068006,0.634976146579743
7,"Rheinland-Pfalz",7235030,"Geisfeld",545,276,269,0.506422018348624,522,265,257,0.507662835249042,0.0160321593522513,0.348991694068006,0.634976146579743
7,"Rheinland-Pfalz",7235033,"Greimerath",1019,500,519,0.490677134445535,1067,539,528,0.505154639175258,0.0160321593522513,0.348991694068006,0.634976146579743
7,"Rheinland-Pfalz",7235035,"Grimburg",509,255,254,0.50098231827112,503,250,253,0.497017892644135,0.0160321593522513,0.348991694068006,0.634976146579743
7,"Rheinland-Pfalz",7235036,"Gusenburg",1158,585,573,0.505181347150259,1136,574,562,0.505281690140845,0.0160321593522513,0.348991694068006,0.634976146579743
7,"Rheinland-Pfalz",7235037,"Gusterath",1886,921,965,0.488335100742312,1908,935,973,0.490041928721174,0.0160321593522513,0.348991694068006,0.634976146579743
7,"Rheinland-Pfalz",7235038,"Gutweiler",642,308,334,0.479750778816199,674,334,340,0.495548961424332,0.0160321593522513,0.348991694068006,0.634976146579743
7,"Rheinland-Pfalz",7235040,"Heddert",263,136,127,0.517110266159696,246,128,118,0.520325203252033,0.0160321593522513,0.348991694068006,0.634976146579743
7,"Rheinland-Pfalz",7235043,"Hentern",387,209,178,0.540051679586563,387,208,179,0.537467700258398,0.0160321593522513,0.348991694068006,0.634976146579743
7,"Rheinland-Pfalz",7235044,"Herl",277,137,140,0.494584837545126,277,139,138,0.501805054151625,0.0160321593522513,0.348991694068006,0.634976146579743
7,"Rheinland-Pfalz",7235045,"Hermeskeil, Stadt",5791,2805,2986,0.484372301847695,5621,2717,2904,0.483365949119374,0.0160321593522513,0.348991694068006,0.634976146579743
7,"Rheinland-Pfalz",7235046,"Hinzenburg",136,68,68,0.5,132,70,62,0.53030303030303,0.0160321593522513,0.348991694068006,0.634976146579743
7,"Rheinland-Pfalz",7235047,"Hinzert-Pölert",298,140,158,0.469798657718121,302,138,164,0.456953642384106,0.0160321593522513,0.348991694068006,0.634976146579743
7,"Rheinland-Pfalz",7235048,"Hockweiler",295,147,148,0.498305084745763,298,147,151,0.493288590604027,0.0160321593522513,0.348991694068006,0.634976146579743
7,"Rheinland-Pfalz",7235050,"Holzerath",431,218,213,0.505800464037123,423,216,207,0.51063829787234,0.0160321593522513,0.348991694068006,0.634976146579743
7,"Rheinland-Pfalz",7235051,"Igel",2038,1004,1034,0.492639842983317,2045,1011,1034,0.494376528117359,0.0160321593522513,0.348991694068006,0.634976146579743
7,"Rheinland-Pfalz",7235052,"Irsch",1505,771,734,0.512292358803987,1502,758,744,0.504660452729694,0.0160321593522513,0.348991694068006,0.634976146579743
7,"Rheinland-Pfalz",7235055,"Kanzem",652,311,341,0.476993865030675,639,305,334,0.477308294209703,0.0160321593522513,0.348991694068006,0.634976146579743
7,"Rheinland-Pfalz",7235056,"Kasel",1238,605,633,0.488691437802908,1235,609,626,0.493117408906883,0.0160321593522513,0.348991694068006,0.634976146579743
7,"Rheinland-Pfalz",7235057,"Kastel-Staadt",397,198,199,0.498740554156171,383,193,190,0.503916449086162,0.0160321593522513,0.348991694068006,0.634976146579743
7,"Rheinland-Pfalz",7235058,"Kell am See",1938,964,974,0.497420020639835,1879,919,960,0.489089941458222,0.0160321593522513,0.348991694068006,0.634976146579743
7,"Rheinland-Pfalz",7235060,"Kenn",2552,1234,1318,0.483542319749216,2549,1231,1318,0.482934484111416,0.0160321593522513,0.348991694068006,0.634976146579743
7,"Rheinland-Pfalz",7235062,"Kirf",850,425,425,0.5,834,421,413,0.504796163069544,0.0160321593522513,0.348991694068006,0.634976146579743
7,"Rheinland-Pfalz",7235063,"Klüsserath",1098,541,557,0.492714025500911,1112,553,559,0.497302158273381,0.0160321593522513,0.348991694068006,0.634976146579743
7,"Rheinland-Pfalz",7235067,"Köwerich",338,163,175,0.482248520710059,334,166,168,0.497005988023952,0.0160321593522513,0.348991694068006,0.634976146579743
7,"Rheinland-Pfalz",7235068,"Konz, Stadt",17574,8565,9009,0.48736770228747,17855,8779,9076,0.491683001960235,0.0160321593522513,0.348991694068006,0.634976146579743
7,"Rheinland-Pfalz",7235069,"Kordel",2110,1040,1070,0.492890995260663,2095,1018,1077,0.485918854415274,0.0160321593522513,0.348991694068006,0.634976146579743
7,"Rheinland-Pfalz",7235070,"Korlingen",764,386,378,0.505235602094241,781,398,383,0.509603072983355,0.0160321593522513,0.348991694068006,0.634976146579743
7,"Rheinland-Pfalz",7235072,"Lampaden",575,275,300,0.478260869565217,562,273,289,0.48576512455516,0.0160321593522513,0.348991694068006,0.634976146579743
7,"Rheinland-Pfalz",7235073,"Langsur",1627,808,819,0.496619545175169,1634,814,820,0.498164014687883,0.0160321593522513,0.348991694068006,0.634976146579743
7,"Rheinland-Pfalz",7235074,"Leiwen",1517,733,784,0.483190507580751,1496,730,766,0.487967914438503,0.0160321593522513,0.348991694068006,0.634976146579743
7,"Rheinland-Pfalz",7235077,"Longen",91,47,44,0.516483516483517,84,42,42,0.5,0.0160321593522513,0.348991694068006,0.634976146579743
7,"Rheinland-Pfalz",7235078,"Longuich",1283,635,648,0.494933749025721,1295,640,655,0.494208494208494,0.0160321593522513,0.348991694068006,0.634976146579743
7,"Rheinland-Pfalz",7235080,"Lorscheid",597,287,310,0.480737018425461,579,285,294,0.492227979274611,0.0160321593522513,0.348991694068006,0.634976146579743
7,"Rheinland-Pfalz",7235081,"Mandern",877,461,416,0.525655644241733,863,454,409,0.526071842410197,0.0160321593522513,0.348991694068006,0.634976146579743
7,"Rheinland-Pfalz",7235082,"Mannebach",353,166,187,0.470254957507082,348,169,179,0.485632183908046,0.0160321593522513,0.348991694068006,0.634976146579743
7,"Rheinland-Pfalz",7235083,"Mehring",2265,1085,1180,0.479028697571744,2245,1092,1153,0.48641425389755,0.0160321593522513,0.348991694068006,0.634976146579743
7,"Rheinland-Pfalz",7235085,"Mertesdorf",1632,792,840,0.485294117647059,1633,797,836,0.488058787507655,0.0160321593522513,0.348991694068006,0.634976146579743
7,"Rheinland-Pfalz",7235090,"Morscheid",951,450,501,0.473186119873817,970,475,495,0.489690721649485,0.0160321593522513,0.348991694068006,0.634976146579743
7,"Rheinland-Pfalz",7235091,"Naurath (Eifel)",368,188,180,0.510869565217391,381,205,176,0.538057742782152,0.0160321593522513,0.348991694068006,0.634976146579743
7,"Rheinland-Pfalz",7235092,"Naurath (Wald)",232,120,112,0.517241379310345,231,119,112,0.515151515151515,0.0160321593522513,0.348991694068006,0.634976146579743
7,"Rheinland-Pfalz",7235093,"Neuhütten",788,377,411,0.478426395939086,779,377,402,0.48395378690629,0.0160321593522513,0.348991694068006,0.634976146579743
7,"Rheinland-Pfalz",7235094,"Newel",2863,1421,1442,0.496332518337408,2857,1422,1435,0.497724886244312,0.0160321593522513,0.348991694068006,0.634976146579743
7,"Rheinland-Pfalz",7235095,"Nittel",2248,1108,1140,0.49288256227758,2194,1076,1118,0.490428441203282,0.0160321593522513,0.348991694068006,0.634976146579743
7,"Rheinland-Pfalz",7235096,"Oberbillig",990,483,507,0.487878787878788,969,479,490,0.494324045407637,0.0160321593522513,0.348991694068006,0.634976146579743
7,"Rheinland-Pfalz",7235098,"Ockfen",636,307,329,0.482704402515723,620,294,326,0.474193548387097,0.0160321593522513,0.348991694068006,0.634976146579743
7,"Rheinland-Pfalz",7235100,"Ollmuth",166,87,79,0.524096385542169,170,88,82,0.517647058823529,0.0160321593522513,0.348991694068006,0.634976146579743
7,"Rheinland-Pfalz",7235101,"Onsdorf",147,67,80,0.45578231292517,137,64,73,0.467153284671533,0.0160321593522513,0.348991694068006,0.634976146579743
7,"Rheinland-Pfalz",7235103,"Osburg",2400,1179,1221,0.49125,2395,1170,1225,0.488517745302714,0.0160321593522513,0.348991694068006,0.634976146579743
7,"Rheinland-Pfalz",7235104,"Palzem",1441,730,711,0.506592643997224,1437,740,697,0.514961725817676,0.0160321593522513,0.348991694068006,0.634976146579743
7,"Rheinland-Pfalz",7235105,"Paschel",242,126,116,0.520661157024793,246,133,113,0.540650406504065,0.0160321593522513,0.348991694068006,0.634976146579743
7,"Rheinland-Pfalz",7235106,"Pellingen",1002,491,511,0.49001996007984,1001,488,513,0.487512487512487,0.0160321593522513,0.348991694068006,0.634976146579743
7,"Rheinland-Pfalz",7235107,"Pluwig",1425,708,717,0.496842105263158,1450,721,729,0.497241379310345,0.0160321593522513,0.348991694068006,0.634976146579743
7,"Rheinland-Pfalz",7235108,"Pölich",472,214,258,0.453389830508475,429,200,229,0.466200466200466,0.0160321593522513,0.348991694068006,0.634976146579743
7,"Rheinland-Pfalz",7235111,"Ralingen",2055,1027,1028,0.499756690997567,2031,1018,1013,0.501230920728705,0.0160321593522513,0.348991694068006,0.634976146579743
7,"Rheinland-Pfalz",7235112,"Rascheid",472,237,235,0.502118644067797,495,250,245,0.505050505050505,0.0160321593522513,0.348991694068006,0.634976146579743
7,"Rheinland-Pfalz",7235114,"Reinsfeld",2324,1101,1223,0.473752151462995,2287,1082,1205,0.473108876257105,0.0160321593522513,0.348991694068006,0.634976146579743
7,"Rheinland-Pfalz",7235115,"Riol",1220,603,617,0.494262295081967,1218,601,617,0.493431855500821,0.0160321593522513,0.348991694068006,0.634976146579743
7,"Rheinland-Pfalz",7235116,"Riveris",413,200,213,0.484261501210654,412,207,205,0.502427184466019,0.0160321593522513,0.348991694068006,0.634976146579743
7,"Rheinland-Pfalz",7235118,"Saarburg, Stadt",6673,3262,3411,0.488835606174135,6554,3260,3294,0.49740616417455,0.0160321593522513,0.348991694068006,0.634976146579743
7,"Rheinland-Pfalz",7235119,"Schillingen",1222,607,615,0.496726677577741,1221,608,613,0.497952497952498,0.0160321593522513,0.348991694068006,0.634976146579743
7,"Rheinland-Pfalz",7235120,"Schleich",191,92,99,0.481675392670157,190,89,101,0.468421052631579,0.0160321593522513,0.348991694068006,0.634976146579743
7,"Rheinland-Pfalz",7235122,"Schoden",729,361,368,0.49519890260631,725,360,365,0.496551724137931,0.0160321593522513,0.348991694068006,0.634976146579743
7,"Rheinland-Pfalz",7235123,"Schömerich",125,60,65,0.48,125,55,70,0.44,0.0160321593522513,0.348991694068006,0.634976146579743
7,"Rheinland-Pfalz",7235124,"Schöndorf",742,353,389,0.475741239892183,751,362,389,0.48202396804261,0.0160321593522513,0.348991694068006,0.634976146579743
7,"Rheinland-Pfalz",7235125,"Schweich, Stadt",6927,3290,3637,0.474953082142342,6891,3290,3601,0.477434334639385,0.0160321593522513,0.348991694068006,0.634976146579743
7,"Rheinland-Pfalz",7235126,"Serrig",1604,781,823,0.486907730673317,1573,774,799,0.49205340114431,0.0160321593522513,0.348991694068006,0.634976146579743
7,"Rheinland-Pfalz",7235129,"Sommerau",73,34,39,0.465753424657534,73,30,43,0.410958904109589,0.0160321593522513,0.348991694068006,0.634976146579743
7,"Rheinland-Pfalz",7235131,"Taben-Rodt",794,378,416,0.476070528967254,879,402,477,0.457337883959044,0.0160321593522513,0.348991694068006,0.634976146579743
7,"Rheinland-Pfalz",7235132,"Tawern",2601,1311,1290,0.5040369088812,2596,1300,1296,0.500770416024653,0.0160321593522513,0.348991694068006,0.634976146579743
7,"Rheinland-Pfalz",7235133,"Temmels",700,346,354,0.494285714285714,718,346,372,0.481894150417827,0.0160321593522513,0.348991694068006,0.634976146579743
7,"Rheinland-Pfalz",7235134,"Thörnich",178,91,87,0.51123595505618,180,96,84,0.533333333333333,0.0160321593522513,0.348991694068006,0.634976146579743
7,"Rheinland-Pfalz",7235135,"Thomm",1079,536,543,0.4967562557924,1071,535,536,0.49953314659197,0.0160321593522513,0.348991694068006,0.634976146579743
7,"Rheinland-Pfalz",7235136,"Trassem",1176,573,603,0.487244897959184,1171,580,591,0.49530315969257,0.0160321593522513,0.348991694068006,0.634976146579743
7,"Rheinland-Pfalz",7235137,"Trierweiler",3680,1760,1920,0.478260869565217,3655,1759,1896,0.481258549931601,0.0160321593522513,0.348991694068006,0.634976146579743
7,"Rheinland-Pfalz",7235140,"Vierherrenborn",196,98,98,0.5,196,100,96,0.510204081632653,0.0160321593522513,0.348991694068006,0.634976146579743
7,"Rheinland-Pfalz",7235141,"Waldrach",2029,992,1037,0.488910793494332,1989,974,1015,0.489693313222725,0.0160321593522513,0.348991694068006,0.634976146579743
7,"Rheinland-Pfalz",7235142,"Waldweiler",838,416,422,0.496420047732697,828,414,414,0.5,0.0160321593522513,0.348991694068006,0.634976146579743
7,"Rheinland-Pfalz",7235143,"Wasserliesch",2273,1127,1146,0.495820501539815,2197,1092,1105,0.497041420118343,0.0160321593522513,0.348991694068006,0.634976146579743
7,"Rheinland-Pfalz",7235144,"Wawern",599,304,295,0.507512520868113,599,307,292,0.512520868113522,0.0160321593522513,0.348991694068006,0.634976146579743
7,"Rheinland-Pfalz",7235146,"Wellen",793,410,383,0.517023959646911,772,396,376,0.512953367875648,0.0160321593522513,0.348991694068006,0.634976146579743
7,"Rheinland-Pfalz",7235148,"Wiltingen",1443,717,726,0.496881496881497,1431,718,713,0.501747030048917,0.0160321593522513,0.348991694068006,0.634976146579743
7,"Rheinland-Pfalz",7235149,"Wincheringen",1819,901,918,0.495327102803738,1772,864,908,0.487584650112867,0.0160321593522513,0.348991694068006,0.634976146579743
7,"Rheinland-Pfalz",7235151,"Zemmer",2931,1441,1490,0.491641078130331,2823,1393,1430,0.493446687920652,0.0160321593522513,0.348991694068006,0.634976146579743
7,"Rheinland-Pfalz",7235152,"Zerf",1593,799,794,0.501569365976146,1567,782,785,0.499042756860243,0.0160321593522513,0.348991694068006,0.634976146579743
7,"Rheinland-Pfalz",7235153,"Züsch",647,312,335,0.482225656877898,638,308,330,0.482758620689655,0.0160321593522513,0.348991694068006,0.634976146579743
7,"Rheinland-Pfalz",7235154,"Merzkirchen",708,371,337,0.524011299435028,709,376,333,0.530324400564175,0.0160321593522513,0.348991694068006,0.634976146579743
7,"Rheinland-Pfalz",7235501,"Welschbillig",2598,1337,1261,0.514626635873749,2639,1393,1246,0.527851458885942,0.0160321593522513,0.348991694068006,0.634976146579743
7,"Rheinland-Pfalz",7311000,"Frankenthal (Pfalz), Stadt",46617,22551,24066,0.483750563099299,47002,23074,23928,0.490915280200843,0.0160321593522513,0.348991694068006,0.634976146579743
7,"Rheinland-Pfalz",7312000,"Kaiserslautern, Stadt",96963,48132,48831,0.496395532316451,99790,50641,49149,0.507475698967832,0.0160321593522513,0.348991694068006,0.634976146579743
7,"Rheinland-Pfalz",7313000,"Landau in der Pfalz, Stadt",43476,20495,22981,0.471409513294691,43957,20802,23155,0.473235207134245,0.0160321593522513,0.348991694068006,0.634976146579743
7,"Rheinland-Pfalz",7314000,"Ludwigshafen am Rhein, Stadt",158637,78046,80591,0.491978542206421,165560,82734,82826,0.49972215510993,0.0160321593522513,0.348991694068006,0.634976146579743
7,"Rheinland-Pfalz",7315000,"Mainz, Stadt",201002,96637,104365,0.480776310683476,200957,96929,104028,0.482337017371876,0.0160321593522513,0.348991694068006,0.634976146579743
7,"Rheinland-Pfalz",7316000,"Neustadt an der Weinstraße, Stadt",52322,25197,27125,0.481575627842972,52941,25428,27513,0.480308267694226,0.0160321593522513,0.348991694068006,0.634976146579743
7,"Rheinland-Pfalz",7317000,"Pirmasens, Stadt",40655,19449,21206,0.478391341778379,40006,19516,20490,0.487826825976104,0.0160321593522513,0.348991694068006,0.634976146579743
7,"Rheinland-Pfalz",7318000,"Speyer, Stadt",49712,23783,25929,0.478415674283875,50036,24085,25951,0.481353425533616,0.0160321593522513,0.348991694068006,0.634976146579743
7,"Rheinland-Pfalz",7319000,"Worms, Stadt",79526,38359,41167,0.482345396474109,81967,40155,41812,0.489892273719912,0.0160321593522513,0.348991694068006,0.634976146579743
7,"Rheinland-Pfalz",7320000,"Zweibrücken, Stadt",34161,16808,17353,0.49202306724042,33807,16623,17184,0.491702901765906,0.0160321593522513,0.348991694068006,0.634976146579743
7,"Rheinland-Pfalz",7331001,"Albig",1643,809,834,0.492391965916007,1633,807,826,0.494182486221678,0.0160321593522513,0.348991694068006,0.634976146579743
7,"Rheinland-Pfalz",7331002,"Alsheim",2647,1274,1373,0.48129958443521,2626,1268,1358,0.482863670982483,0.0160321593522513,0.348991694068006,0.634976146579743
7,"Rheinland-Pfalz",7331003,"Alzey, Stadt",17488,8531,8957,0.48782021957914,17646,8640,9006,0.489629377762666,0.0160321593522513,0.348991694068006,0.634976146579743
7,"Rheinland-Pfalz",7331004,"Armsheim",2540,1264,1276,0.497637795275591,2583,1300,1283,0.503290747193186,0.0160321593522513,0.348991694068006,0.634976146579743
7,"Rheinland-Pfalz",7331005,"Bechenheim",425,209,216,0.491764705882353,427,203,224,0.475409836065574,0.0160321593522513,0.348991694068006,0.634976146579743
7,"Rheinland-Pfalz",7331006,"Bechtheim",1786,895,891,0.501119820828667,1764,875,889,0.496031746031746,0.0160321593522513,0.348991694068006,0.634976146579743
7,"Rheinland-Pfalz",7331007,"Bechtolsheim",1607,803,804,0.49968886123211,1590,798,792,0.50188679245283,0.0160321593522513,0.348991694068006,0.634976146579743
7,"Rheinland-Pfalz",7331008,"Bermersheim vor der Höhe",375,176,199,0.469333333333333,387,181,206,0.467700258397933,0.0160321593522513,0.348991694068006,0.634976146579743
7,"Rheinland-Pfalz",7331009,"Bermersheim",329,167,162,0.507598784194529,322,162,160,0.503105590062112,0.0160321593522513,0.348991694068006,0.634976146579743
7,"Rheinland-Pfalz",7331010,"Biebelnheim",674,341,333,0.50593471810089,657,325,332,0.494672754946728,0.0160321593522513,0.348991694068006,0.634976146579743
7,"Rheinland-Pfalz",7331011,"Hochborn",422,209,213,0.495260663507109,423,214,209,0.505910165484634,0.0160321593522513,0.348991694068006,0.634976146579743
7,"Rheinland-Pfalz",7331012,"Bornheim",863,502,361,0.581691772885284,711,424,287,0.59634317862166,0.0160321593522513,0.348991694068006,0.634976146579743
7,"Rheinland-Pfalz",7331014,"Dintesheim",160,78,82,0.4875,156,77,79,0.493589743589744,0.0160321593522513,0.348991694068006,0.634976146579743
7,"Rheinland-Pfalz",7331015,"Dittelsheim-Heßloch",2103,1051,1052,0.499762244412744,2103,1054,1049,0.501188777936281,0.0160321593522513,0.348991694068006,0.634976146579743
7,"Rheinland-Pfalz",7331017,"Eckelsheim",461,228,233,0.494577006507592,495,259,236,0.523232323232323,0.0160321593522513,0.348991694068006,0.634976146579743
7,"Rheinland-Pfalz",7331018,"Eich",3373,1681,1692,0.498369404091313,3279,1635,1644,0.498627630375114,0.0160321593522513,0.348991694068006,0.634976146579743
7,"Rheinland-Pfalz",7331019,"Ensheim",454,228,226,0.502202643171806,456,229,227,0.50219298245614,0.0160321593522513,0.348991694068006,0.634976146579743
7,"Rheinland-Pfalz",7331020,"Eppelsheim",1261,623,638,0.494052339413164,1246,623,623,0.5,0.0160321593522513,0.348991694068006,0.634976146579743
7,"Rheinland-Pfalz",7331021,"Erbes-Büdesheim",1340,683,657,0.509701492537313,1342,675,667,0.502980625931446,0.0160321593522513,0.348991694068006,0.634976146579743
7,"Rheinland-Pfalz",7331022,"Esselborn",386,189,197,0.489637305699482,369,177,192,0.479674796747967,0.0160321593522513,0.348991694068006,0.634976146579743
7,"Rheinland-Pfalz",7331023,"Flörsheim-Dalsheim",3017,1443,1574,0.478289691746768,3079,1509,1570,0.490094186424164,0.0160321593522513,0.348991694068006,0.634976146579743
7,"Rheinland-Pfalz",7331024,"Flomborn",1027,503,524,0.489776046738072,1031,510,521,0.49466537342386,0.0160321593522513,0.348991694068006,0.634976146579743
7,"Rheinland-Pfalz",7331025,"Flonheim",2643,1323,1320,0.500567536889898,2636,1318,1318,0.5,0.0160321593522513,0.348991694068006,0.634976146579743
7,"Rheinland-Pfalz",7331026,"Framersheim",1640,823,817,0.501829268292683,1621,813,808,0.501542257865515,0.0160321593522513,0.348991694068006,0.634976146579743
7,"Rheinland-Pfalz",7331027,"Freimersheim",689,360,329,0.522496371552975,681,351,330,0.515418502202643,0.0160321593522513,0.348991694068006,0.634976146579743
7,"Rheinland-Pfalz",7331028,"Frettenheim",320,165,155,0.515625,306,153,153,0.5,0.0160321593522513,0.348991694068006,0.634976146579743
7,"Rheinland-Pfalz",7331029,"Gabsheim",755,371,384,0.491390728476821,770,378,392,0.490909090909091,0.0160321593522513,0.348991694068006,0.634976146579743
7,"Rheinland-Pfalz",7331030,"Gau-Bickelheim",2005,989,1016,0.493266832917706,2039,1011,1028,0.495831289847965,0.0160321593522513,0.348991694068006,0.634976146579743
7,"Rheinland-Pfalz",7331031,"Gau-Heppenheim",533,260,273,0.48780487804878,528,260,268,0.492424242424242,0.0160321593522513,0.348991694068006,0.634976146579743
7,"Rheinland-Pfalz",7331032,"Gau-Odernheim",3824,1905,1919,0.498169456066946,3807,1894,1913,0.497504596795377,0.0160321593522513,0.348991694068006,0.634976146579743
7,"Rheinland-Pfalz",7331033,"Gau-Weinheim",611,310,301,0.507364975450082,579,301,278,0.51986183074266,0.0160321593522513,0.348991694068006,0.634976146579743
7,"Rheinland-Pfalz",7331034,"Gimbsheim",2986,1510,1476,0.50569323509712,2950,1503,1447,0.509491525423729,0.0160321593522513,0.348991694068006,0.634976146579743
7,"Rheinland-Pfalz",7331035,"Gumbsheim",598,305,293,0.510033444816054,597,305,292,0.510887772194305,0.0160321593522513,0.348991694068006,0.634976146579743
7,"Rheinland-Pfalz",7331036,"Gundersheim",1618,829,789,0.512360939431397,1592,813,779,0.510678391959799,0.0160321593522513,0.348991694068006,0.634976146579743
7,"Rheinland-Pfalz",7331037,"Gundheim",914,447,467,0.489059080962801,910,427,483,0.469230769230769,0.0160321593522513,0.348991694068006,0.634976146579743
7,"Rheinland-Pfalz",7331038,"Hamm am Rhein",2132,1094,1038,0.51313320825516,2175,1120,1055,0.514942528735632,0.0160321593522513,0.348991694068006,0.634976146579743
7,"Rheinland-Pfalz",7331039,"Hangen-Weisheim",466,230,236,0.493562231759657,485,238,247,0.490721649484536,0.0160321593522513,0.348991694068006,0.634976146579743
7,"Rheinland-Pfalz",7331041,"Hohen-Sülzen",634,323,311,0.509463722397476,626,325,301,0.519169329073482,0.0160321593522513,0.348991694068006,0.634976146579743
7,"Rheinland-Pfalz",7331042,"Kettenheim",303,160,143,0.528052805280528,294,157,137,0.534013605442177,0.0160321593522513,0.348991694068006,0.634976146579743
7,"Rheinland-Pfalz",7331043,"Lonsheim",585,299,286,0.511111111111111,566,283,283,0.5,0.0160321593522513,0.348991694068006,0.634976146579743
7,"Rheinland-Pfalz",7331044,"Mauchenheim",988,468,520,0.473684210526316,997,476,521,0.477432296890672,0.0160321593522513,0.348991694068006,0.634976146579743
7,"Rheinland-Pfalz",7331045,"Mettenheim",1508,748,760,0.496021220159151,1506,745,761,0.49468791500664,0.0160321593522513,0.348991694068006,0.634976146579743
7,"Rheinland-Pfalz",7331046,"Mölsheim",587,294,293,0.500851788756388,578,283,295,0.48961937716263,0.0160321593522513,0.348991694068006,0.634976146579743
7,"Rheinland-Pfalz",7331047,"Mörstadt",902,460,442,0.509977827050998,904,464,440,0.513274336283186,0.0160321593522513,0.348991694068006,0.634976146579743
7,"Rheinland-Pfalz",7331048,"Monsheim",2509,1210,1299,0.482263850139498,2463,1184,1279,0.480714575720666,0.0160321593522513,0.348991694068006,0.634976146579743
7,"Rheinland-Pfalz",7331049,"Monzernheim",609,309,300,0.507389162561576,617,320,297,0.518638573743922,0.0160321593522513,0.348991694068006,0.634976146579743
7,"Rheinland-Pfalz",7331050,"Nack",641,323,318,0.50390015600624,636,315,321,0.495283018867925,0.0160321593522513,0.348991694068006,0.634976146579743
7,"Rheinland-Pfalz",7331051,"Nieder-Wiesen",613,295,318,0.481239804241436,616,298,318,0.483766233766234,0.0160321593522513,0.348991694068006,0.634976146579743
7,"Rheinland-Pfalz",7331052,"Ober-Flörsheim",1238,615,623,0.496768982229402,1279,642,637,0.501954652071931,0.0160321593522513,0.348991694068006,0.634976146579743
7,"Rheinland-Pfalz",7331053,"Offenheim",612,305,307,0.498366013071895,595,300,295,0.504201680672269,0.0160321593522513,0.348991694068006,0.634976146579743
7,"Rheinland-Pfalz",7331054,"Offstein",1757,869,888,0.494593056346044,1730,860,870,0.497109826589595,0.0160321593522513,0.348991694068006,0.634976146579743
7,"Rheinland-Pfalz",7331055,"Osthofen, Stadt",8692,4198,4494,0.48297284859641,8385,4095,4290,0.488372093023256,0.0160321593522513,0.348991694068006,0.634976146579743
7,"Rheinland-Pfalz",7331056,"Partenheim",1560,771,789,0.494230769230769,1577,781,796,0.495244134432467,0.0160321593522513,0.348991694068006,0.634976146579743
7,"Rheinland-Pfalz",7331058,"Saulheim",7211,3571,3640,0.495215642767993,7229,3596,3633,0.497440863189929,0.0160321593522513,0.348991694068006,0.634976146579743
7,"Rheinland-Pfalz",7331059,"Schornsheim",1547,760,787,0.491273432449903,1548,758,790,0.489664082687339,0.0160321593522513,0.348991694068006,0.634976146579743
7,"Rheinland-Pfalz",7331060,"Siefersheim",1259,621,638,0.493248610007943,1260,625,635,0.496031746031746,0.0160321593522513,0.348991694068006,0.634976146579743
7,"Rheinland-Pfalz",7331061,"Spiesheim",961,479,482,0.49843912591051,988,493,495,0.498987854251012,0.0160321593522513,0.348991694068006,0.634976146579743
7,"Rheinland-Pfalz",7331062,"Stein-Bockenheim",682,312,370,0.457478005865103,682,314,368,0.460410557184751,0.0160321593522513,0.348991694068006,0.634976146579743
7,"Rheinland-Pfalz",7331063,"Sulzheim",1074,537,537,0.5,1082,551,531,0.509242144177449,0.0160321593522513,0.348991694068006,0.634976146579743
7,"Rheinland-Pfalz",7331064,"Udenheim",1335,657,678,0.492134831460674,1355,665,690,0.490774907749078,0.0160321593522513,0.348991694068006,0.634976146579743
7,"Rheinland-Pfalz",7331065,"Vendersheim",580,291,289,0.501724137931034,570,288,282,0.505263157894737,0.0160321593522513,0.348991694068006,0.634976146579743
7,"Rheinland-Pfalz",7331066,"Wachenheim",695,345,350,0.496402877697842,615,303,312,0.492682926829268,0.0160321593522513,0.348991694068006,0.634976146579743
7,"Rheinland-Pfalz",7331067,"Wahlheim",596,298,298,0.5,595,300,295,0.504201680672269,0.0160321593522513,0.348991694068006,0.634976146579743
7,"Rheinland-Pfalz",7331068,"Wallertheim",1811,925,886,0.510767531750414,1797,916,881,0.509738452977184,0.0160321593522513,0.348991694068006,0.634976146579743
7,"Rheinland-Pfalz",7331070,"Wendelsheim",1353,670,683,0.49519586104952,1414,719,695,0.508486562942008,0.0160321593522513,0.348991694068006,0.634976146579743
7,"Rheinland-Pfalz",7331071,"Westhofen",3161,1578,1583,0.49920911104081,3161,1585,1576,0.501423600126542,0.0160321593522513,0.348991694068006,0.634976146579743
7,"Rheinland-Pfalz",7331072,"Wöllstein",4539,2373,2166,0.522802379378718,4400,2218,2182,0.504090909090909,0.0160321593522513,0.348991694068006,0.634976146579743
7,"Rheinland-Pfalz",7331073,"Wörrstadt, Stadt",7569,3696,3873,0.488307570352755,7649,3746,3903,0.489737220551706,0.0160321593522513,0.348991694068006,0.634976146579743
7,"Rheinland-Pfalz",7331075,"Wonsheim",883,443,440,0.501698754246886,864,419,445,0.484953703703704,0.0160321593522513,0.348991694068006,0.634976146579743
7,"Rheinland-Pfalz",7332001,"Altleiningen",1805,900,905,0.498614958448753,1825,909,916,0.498082191780822,0.0160321593522513,0.348991694068006,0.634976146579743
7,"Rheinland-Pfalz",7332002,"Bad Dürkheim, Stadt",18127,8509,9618,0.46941027196999,18734,8903,9831,0.475232198142415,0.0160321593522513,0.348991694068006,0.634976146579743
7,"Rheinland-Pfalz",7332003,"Battenberg (Pfalz)",393,197,196,0.501272264631043,390,200,190,0.512820512820513,0.0160321593522513,0.348991694068006,0.634976146579743
7,"Rheinland-Pfalz",7332004,"Bissersheim",448,209,239,0.466517857142857,448,206,242,0.459821428571429,0.0160321593522513,0.348991694068006,0.634976146579743
7,"Rheinland-Pfalz",7332005,"Bobenheim am Berg",839,404,435,0.481525625744934,839,412,427,0.491060786650775,0.0160321593522513,0.348991694068006,0.634976146579743
7,"Rheinland-Pfalz",7332006,"Bockenheim an der Weinstraße",2149,1060,1089,0.493252675663099,2163,1070,1093,0.494683310217291,0.0160321593522513,0.348991694068006,0.634976146579743
7,"Rheinland-Pfalz",7332007,"Carlsberg",3439,1725,1714,0.50159930212271,3468,1749,1719,0.504325259515571,0.0160321593522513,0.348991694068006,0.634976146579743
7,"Rheinland-Pfalz",7332008,"Dackenheim",433,220,213,0.508083140877598,447,229,218,0.512304250559284,0.0160321593522513,0.348991694068006,0.634976146579743
7,"Rheinland-Pfalz",7332009,"Deidesheim, Stadt",3732,1767,1965,0.473472668810289,3680,1742,1938,0.473369565217391,0.0160321593522513,0.348991694068006,0.634976146579743
7,"Rheinland-Pfalz",7332010,"Dirmstein",2973,1438,1535,0.483686511940801,2983,1457,1526,0.488434461951056,0.0160321593522513,0.348991694068006,0.634976146579743
7,"Rheinland-Pfalz",7332012,"Ebertsheim",1259,636,623,0.505162827640985,1276,645,631,0.505485893416928,0.0160321593522513,0.348991694068006,0.634976146579743
7,"Rheinland-Pfalz",7332013,"Ellerstadt",2310,1156,1154,0.5004329004329,2295,1177,1118,0.512854030501089,0.0160321593522513,0.348991694068006,0.634976146579743
7,"Rheinland-Pfalz",7332014,"Elmstein",2468,1235,1233,0.500405186385737,2521,1280,1241,0.507735025783419,0.0160321593522513,0.348991694068006,0.634976146579743
7,"Rheinland-Pfalz",7332015,"Erpolzheim",1332,651,681,0.488738738738739,1329,659,670,0.495861550037622,0.0160321593522513,0.348991694068006,0.634976146579743
7,"Rheinland-Pfalz",7332016,"Esthal",1401,719,682,0.513204853675946,1433,751,682,0.524075366364271,0.0160321593522513,0.348991694068006,0.634976146579743
7,"Rheinland-Pfalz",7332017,"Forst an der Weinstraße",816,391,425,0.479166666666667,826,406,420,0.491525423728814,0.0160321593522513,0.348991694068006,0.634976146579743
7,"Rheinland-Pfalz",7332018,"Frankeneck",807,417,390,0.516728624535316,799,413,386,0.516896120150188,0.0160321593522513,0.348991694068006,0.634976146579743
7,"Rheinland-Pfalz",7332019,"Freinsheim, Stadt",5016,2404,2612,0.4792663476874,5000,2405,2595,0.481,0.0160321593522513,0.348991694068006,0.634976146579743
7,"Rheinland-Pfalz",7332020,"Friedelsheim",1460,717,743,0.491095890410959,1457,714,743,0.490048043925875,0.0160321593522513,0.348991694068006,0.634976146579743
7,"Rheinland-Pfalz",7332021,"Gerolsheim",1698,848,850,0.499411071849234,1668,833,835,0.499400479616307,0.0160321593522513,0.348991694068006,0.634976146579743
7,"Rheinland-Pfalz",7332022,"Gönnheim",1471,699,772,0.475186947654657,1484,715,769,0.481805929919137,0.0160321593522513,0.348991694068006,0.634976146579743
7,"Rheinland-Pfalz",7332023,"Großkarlbach",1107,529,578,0.477868112014454,1108,538,570,0.485559566787004,0.0160321593522513,0.348991694068006,0.634976146579743
7,"Rheinland-Pfalz",7332024,"Grünstadt, Stadt",12830,6186,6644,0.482151208106002,13068,6302,6766,0.482246709519437,0.0160321593522513,0.348991694068006,0.634976146579743
7,"Rheinland-Pfalz",7332025,"Haßloch",19847,9740,10107,0.490754270166776,20442,10148,10294,0.496428920849232,0.0160321593522513,0.348991694068006,0.634976146579743
7,"Rheinland-Pfalz",7332026,"Herxheim am Berg",749,387,362,0.516688918558077,731,387,344,0.529411764705882,0.0160321593522513,0.348991694068006,0.634976146579743
7,"Rheinland-Pfalz",7332027,"Hettenleidelheim",3022,1459,1563,0.482792852415619,3017,1451,1566,0.480941332449453,0.0160321593522513,0.348991694068006,0.634976146579743
7,"Rheinland-Pfalz",7332028,"Kallstadt",1182,576,606,0.487309644670051,1206,600,606,0.497512437810945,0.0160321593522513,0.348991694068006,0.634976146579743
7,"Rheinland-Pfalz",7332029,"Kindenheim",978,503,475,0.514314928425358,978,500,478,0.511247443762781,0.0160321593522513,0.348991694068006,0.634976146579743
7,"Rheinland-Pfalz",7332030,"Kirchheim an der Weinstraße",1816,927,889,0.510462555066079,1795,912,883,0.508077994428969,0.0160321593522513,0.348991694068006,0.634976146579743
7,"Rheinland-Pfalz",7332031,"Kleinkarlbach",893,459,434,0.513997760358343,908,454,454,0.5,0.0160321593522513,0.348991694068006,0.634976146579743
7,"Rheinland-Pfalz",7332032,"Lambrecht (Pfalz), Stadt",4009,1926,2083,0.480419057121477,3862,1896,1966,0.490937338166753,0.0160321593522513,0.348991694068006,0.634976146579743
7,"Rheinland-Pfalz",7332033,"Laumersheim",896,446,450,0.497767857142857,876,441,435,0.503424657534247,0.0160321593522513,0.348991694068006,0.634976146579743
7,"Rheinland-Pfalz",7332034,"Lindenberg",1070,517,553,0.483177570093458,1099,528,571,0.480436760691538,0.0160321593522513,0.348991694068006,0.634976146579743
7,"Rheinland-Pfalz",7332035,"Meckenheim",3332,1644,1688,0.493397358943577,3282,1632,1650,0.497257769652651,0.0160321593522513,0.348991694068006,0.634976146579743
7,"Rheinland-Pfalz",7332036,"Mertesheim",380,199,181,0.523684210526316,384,201,183,0.5234375,0.0160321593522513,0.348991694068006,0.634976146579743
7,"Rheinland-Pfalz",7332037,"Neidenfels",869,421,448,0.484464902186421,870,417,453,0.479310344827586,0.0160321593522513,0.348991694068006,0.634976146579743
7,"Rheinland-Pfalz",7332038,"Neuleiningen",809,382,427,0.472187886279357,825,399,426,0.483636363636364,0.0160321593522513,0.348991694068006,0.634976146579743
7,"Rheinland-Pfalz",7332039,"Niederkirchen bei Deidesheim",2345,1170,1175,0.498933901918977,2338,1160,1178,0.496150556030796,0.0160321593522513,0.348991694068006,0.634976146579743
7,"Rheinland-Pfalz",7332040,"Obersülzen",632,330,302,0.522151898734177,628,324,304,0.515923566878981,0.0160321593522513,0.348991694068006,0.634976146579743
7,"Rheinland-Pfalz",7332041,"Obrigheim (Pfalz)",2674,1314,1360,0.491398653702319,2729,1355,1374,0.496518871381458,0.0160321593522513,0.348991694068006,0.634976146579743
7,"Rheinland-Pfalz",7332042,"Quirnheim",769,410,359,0.533159947984395,786,428,358,0.544529262086514,0.0160321593522513,0.348991694068006,0.634976146579743
7,"Rheinland-Pfalz",7332043,"Ruppertsberg",1473,710,763,0.482009504412763,1483,715,768,0.482130815913688,0.0160321593522513,0.348991694068006,0.634976146579743
7,"Rheinland-Pfalz",7332044,"Tiefenthal",805,411,394,0.51055900621118,805,416,389,0.516770186335404,0.0160321593522513,0.348991694068006,0.634976146579743
7,"Rheinland-Pfalz",7332046,"Wachenheim an der Weinstraße, Stadt",4706,2293,2413,0.487250318742031,4673,2282,2391,0.488337256580355,0.0160321593522513,0.348991694068006,0.634976146579743
7,"Rheinland-Pfalz",7332047,"Wattenheim",1599,801,798,0.50093808630394,1613,810,803,0.502169869807812,0.0160321593522513,0.348991694068006,0.634976146579743
7,"Rheinland-Pfalz",7332048,"Weidenthal",1837,885,952,0.481763745236799,1861,902,959,0.484685652874798,0.0160321593522513,0.348991694068006,0.634976146579743
7,"Rheinland-Pfalz",7332049,"Weisenheim am Berg",1680,810,870,0.482142857142857,1619,780,839,0.48177887584929,0.0160321593522513,0.348991694068006,0.634976146579743
7,"Rheinland-Pfalz",7332050,"Weisenheim am Sand",4235,2020,2215,0.476977567886659,4349,2099,2250,0.482639687284433,0.0160321593522513,0.348991694068006,0.634976146579743
7,"Rheinland-Pfalz",7333001,"Albisheim (Pfrimm)",1720,846,874,0.491860465116279,1769,872,897,0.492933860938383,0.0160321593522513,0.348991694068006,0.634976146579743
7,"Rheinland-Pfalz",7333003,"Alsenz",1684,819,865,0.486342042755344,1750,863,887,0.493142857142857,0.0160321593522513,0.348991694068006,0.634976146579743
7,"Rheinland-Pfalz",7333004,"Bayerfeld-Steckweiler",444,233,211,0.524774774774775,450,230,220,0.511111111111111,0.0160321593522513,0.348991694068006,0.634976146579743
7,"Rheinland-Pfalz",7333005,"Bennhausen",153,76,77,0.496732026143791,156,78,78,0.5,0.0160321593522513,0.348991694068006,0.634976146579743
7,"Rheinland-Pfalz",7333006,"Biedesheim",630,323,307,0.512698412698413,628,324,304,0.515923566878981,0.0160321593522513,0.348991694068006,0.634976146579743
7,"Rheinland-Pfalz",7333007,"Bischheim",719,383,336,0.532684283727399,700,367,333,0.524285714285714,0.0160321593522513,0.348991694068006,0.634976146579743
7,"Rheinland-Pfalz",7333008,"Bisterschied",244,127,117,0.520491803278688,245,128,117,0.522448979591837,0.0160321593522513,0.348991694068006,0.634976146579743
7,"Rheinland-Pfalz",7333009,"Börrstadt",939,450,489,0.479233226837061,906,437,469,0.48233995584989,0.0160321593522513,0.348991694068006,0.634976146579743
7,"Rheinland-Pfalz",7333010,"Bolanden",2441,1239,1202,0.507578861122491,2361,1185,1176,0.501905972045743,0.0160321593522513,0.348991694068006,0.634976146579743
7,"Rheinland-Pfalz",7333011,"Breunigweiler",455,235,220,0.516483516483517,457,238,219,0.520787746170678,0.0160321593522513,0.348991694068006,0.634976146579743
7,"Rheinland-Pfalz",7333012,"Bubenheim",429,223,206,0.51981351981352,428,227,201,0.530373831775701,0.0160321593522513,0.348991694068006,0.634976146579743
7,"Rheinland-Pfalz",7333013,"Dannenfels",865,422,443,0.487861271676301,856,419,437,0.489485981308411,0.0160321593522513,0.348991694068006,0.634976146579743
7,"Rheinland-Pfalz",7333014,"Dielkirchen",529,254,275,0.480151228733459,521,253,268,0.485604606525912,0.0160321593522513,0.348991694068006,0.634976146579743
7,"Rheinland-Pfalz",7333016,"Dörrmoschel",148,76,72,0.513513513513513,139,71,68,0.510791366906475,0.0160321593522513,0.348991694068006,0.634976146579743
7,"Rheinland-Pfalz",7333017,"Dreisen",983,491,492,0.499491353001017,1008,509,499,0.504960317460317,0.0160321593522513,0.348991694068006,0.634976146579743
7,"Rheinland-Pfalz",7333018,"Einselthum",833,420,413,0.504201680672269,825,418,407,0.506666666666667,0.0160321593522513,0.348991694068006,0.634976146579743
7,"Rheinland-Pfalz",7333019,"Eisenberg (Pfalz), Stadt",9158,4503,4655,0.491701244813278,9337,4647,4690,0.497697333190532,0.0160321593522513,0.348991694068006,0.634976146579743
7,"Rheinland-Pfalz",7333020,"Falkenstein",237,133,104,0.561181434599156,197,118,79,0.598984771573604,0.0160321593522513,0.348991694068006,0.634976146579743
7,"Rheinland-Pfalz",7333021,"Finkenbach-Gersweiler",327,165,162,0.504587155963303,320,164,156,0.5125,0.0160321593522513,0.348991694068006,0.634976146579743
7,"Rheinland-Pfalz",7333022,"Gauersheim",623,321,302,0.515248796147673,626,323,303,0.515974440894569,0.0160321593522513,0.348991694068006,0.634976146579743
7,"Rheinland-Pfalz",7333023,"Gaugrehweiler",570,281,289,0.492982456140351,582,285,297,0.489690721649485,0.0160321593522513,0.348991694068006,0.634976146579743
7,"Rheinland-Pfalz",7333024,"Gehrweiler",339,166,173,0.489675516224189,326,164,162,0.503067484662577,0.0160321593522513,0.348991694068006,0.634976146579743
7,"Rheinland-Pfalz",7333025,"Gerbach",560,271,289,0.483928571428571,565,287,278,0.507964601769912,0.0160321593522513,0.348991694068006,0.634976146579743
7,"Rheinland-Pfalz",7333026,"Göllheim",3700,1813,1887,0.49,3690,1818,1872,0.492682926829268,0.0160321593522513,0.348991694068006,0.634976146579743
7,"Rheinland-Pfalz",7333027,"Gonbach",499,249,250,0.498997995991984,496,246,250,0.495967741935484,0.0160321593522513,0.348991694068006,0.634976146579743
7,"Rheinland-Pfalz",7333028,"Gundersweiler",502,250,252,0.49800796812749,492,250,242,0.508130081300813,0.0160321593522513,0.348991694068006,0.634976146579743
7,"Rheinland-Pfalz",7333030,"Höringen",683,338,345,0.494875549048316,706,349,357,0.494334277620397,0.0160321593522513,0.348991694068006,0.634976146579743
7,"Rheinland-Pfalz",7333031,"Ilbesheim",563,289,274,0.513321492007105,535,270,265,0.504672897196262,0.0160321593522513,0.348991694068006,0.634976146579743
7,"Rheinland-Pfalz",7333032,"Immesheim",147,76,71,0.517006802721088,145,73,72,0.503448275862069,0.0160321593522513,0.348991694068006,0.634976146579743
7,"Rheinland-Pfalz",7333033,"Imsbach",881,439,442,0.498297389330306,903,458,445,0.507198228128461,0.0160321593522513,0.348991694068006,0.634976146579743
7,"Rheinland-Pfalz",7333034,"Imsweiler",563,259,304,0.460035523978686,549,242,307,0.4408014571949,0.0160321593522513,0.348991694068006,0.634976146579743
7,"Rheinland-Pfalz",7333035,"Jakobsweiler",261,127,134,0.486590038314176,260,126,134,0.484615384615385,0.0160321593522513,0.348991694068006,0.634976146579743
7,"Rheinland-Pfalz",7333036,"Kalkofen",177,93,84,0.525423728813559,163,82,81,0.503067484662577,0.0160321593522513,0.348991694068006,0.634976146579743
7,"Rheinland-Pfalz",7333037,"Katzenbach",515,259,256,0.502912621359223,510,252,258,0.494117647058824,0.0160321593522513,0.348991694068006,0.634976146579743
7,"Rheinland-Pfalz",7333038,"Kerzenheim",2118,1069,1049,0.504721435316336,2139,1095,1044,0.511921458625526,0.0160321593522513,0.348991694068006,0.634976146579743
7,"Rheinland-Pfalz",7333039,"Kirchheimbolanden, Stadt",7808,3717,4091,0.476050204918033,7729,3711,4018,0.480139733471342,0.0160321593522513,0.348991694068006,0.634976146579743
7,"Rheinland-Pfalz",7333040,"Kriegsfeld",1028,519,509,0.504863813229572,1043,532,511,0.51006711409396,0.0160321593522513,0.348991694068006,0.634976146579743
7,"Rheinland-Pfalz",7333041,"Lautersheim",632,303,329,0.479430379746835,633,312,321,0.492890995260663,0.0160321593522513,0.348991694068006,0.634976146579743
7,"Rheinland-Pfalz",7333042,"Lohnsfeld",947,467,480,0.493136219640971,952,466,486,0.489495798319328,0.0160321593522513,0.348991694068006,0.634976146579743
7,"Rheinland-Pfalz",7333043,"Mannweiler-Cölln",422,201,221,0.476303317535545,409,191,218,0.466992665036675,0.0160321593522513,0.348991694068006,0.634976146579743
7,"Rheinland-Pfalz",7333045,"Marnheim",1629,797,832,0.489257213014119,1595,788,807,0.494043887147335,0.0160321593522513,0.348991694068006,0.634976146579743
7,"Rheinland-Pfalz",7333046,"Mörsfeld",504,256,248,0.507936507936508,500,251,249,0.502,0.0160321593522513,0.348991694068006,0.634976146579743
7,"Rheinland-Pfalz",7333047,"Morschheim",736,368,368,0.5,734,365,369,0.497275204359673,0.0160321593522513,0.348991694068006,0.634976146579743
7,"Rheinland-Pfalz",7333048,"Münchweiler an der Alsenz",1202,594,608,0.494176372712146,1177,591,586,0.502124044180119,0.0160321593522513,0.348991694068006,0.634976146579743
7,"Rheinland-Pfalz",7333049,"Münsterappel",497,250,247,0.503018108651911,508,256,252,0.503937007874016,0.0160321593522513,0.348991694068006,0.634976146579743
7,"Rheinland-Pfalz",7333050,"Niederhausen an der Appel",238,120,118,0.504201680672269,231,122,109,0.528138528138528,0.0160321593522513,0.348991694068006,0.634976146579743
7,"Rheinland-Pfalz",7333051,"Niedermoschel",497,237,260,0.476861167002012,517,242,275,0.468085106382979,0.0160321593522513,0.348991694068006,0.634976146579743
7,"Rheinland-Pfalz",7333053,"Oberhausen an der Appel",152,71,81,0.467105263157895,141,64,77,0.453900709219858,0.0160321593522513,0.348991694068006,0.634976146579743
7,"Rheinland-Pfalz",7333054,"Obermoschel, Stadt",1063,522,541,0.491063029162747,1084,529,555,0.488007380073801,0.0160321593522513,0.348991694068006,0.634976146579743
7,"Rheinland-Pfalz",7333055,"Oberndorf",263,140,123,0.532319391634981,254,134,120,0.52755905511811,0.0160321593522513,0.348991694068006,0.634976146579743
7,"Rheinland-Pfalz",7333056,"Oberwiesen",493,228,265,0.462474645030426,475,230,245,0.484210526315789,0.0160321593522513,0.348991694068006,0.634976146579743
7,"Rheinland-Pfalz",7333057,"Orbis",719,347,372,0.482614742698192,706,342,364,0.484419263456091,0.0160321593522513,0.348991694068006,0.634976146579743
7,"Rheinland-Pfalz",7333058,"Ottersheim",387,194,193,0.501291989664083,365,184,181,0.504109589041096,0.0160321593522513,0.348991694068006,0.634976146579743
7,"Rheinland-Pfalz",7333060,"Ramsen",1833,895,938,0.488270594653573,1793,875,918,0.488008923591746,0.0160321593522513,0.348991694068006,0.634976146579743
7,"Rheinland-Pfalz",7333061,"Ransweiler",260,127,133,0.488461538461538,271,134,137,0.494464944649447,0.0160321593522513,0.348991694068006,0.634976146579743
7,"Rheinland-Pfalz",7333062,"Rittersheim",186,86,100,0.462365591397849,183,86,97,0.469945355191257,0.0160321593522513,0.348991694068006,0.634976146579743
7,"Rheinland-Pfalz",7333064,"Rüssingen",497,244,253,0.490945674044266,493,238,255,0.482758620689655,0.0160321593522513,0.348991694068006,0.634976146579743
7,"Rheinland-Pfalz",7333065,"Ruppertsecken",354,175,179,0.494350282485876,348,174,174,0.5,0.0160321593522513,0.348991694068006,0.634976146579743
7,"Rheinland-Pfalz",7333066,"Sankt Alban",310,153,157,0.493548387096774,323,157,166,0.486068111455108,0.0160321593522513,0.348991694068006,0.634976146579743
7,"Rheinland-Pfalz",7333067,"Schiersfeld",242,113,129,0.466942148760331,237,112,125,0.472573839662447,0.0160321593522513,0.348991694068006,0.634976146579743
7,"Rheinland-Pfalz",7333068,"Schönborn",134,69,65,0.514925373134328,134,66,68,0.492537313432836,0.0160321593522513,0.348991694068006,0.634976146579743
7,"Rheinland-Pfalz",7333069,"Schweisweiler",344,167,177,0.48546511627907,347,169,178,0.487031700288184,0.0160321593522513,0.348991694068006,0.634976146579743
7,"Rheinland-Pfalz",7333071,"Sippersfeld",1143,569,574,0.497812773403325,1140,572,568,0.501754385964912,0.0160321593522513,0.348991694068006,0.634976146579743
7,"Rheinland-Pfalz",7333072,"Sitters",116,59,57,0.508620689655172,112,55,57,0.491071428571429,0.0160321593522513,0.348991694068006,0.634976146579743
7,"Rheinland-Pfalz",7333073,"Stahlberg",174,82,92,0.471264367816092,171,82,89,0.47953216374269,0.0160321593522513,0.348991694068006,0.634976146579743
7,"Rheinland-Pfalz",7333074,"Standenbühl",206,103,103,0.5,208,103,105,0.495192307692308,0.0160321593522513,0.348991694068006,0.634976146579743
7,"Rheinland-Pfalz",7333075,"Steinbach am Donnersberg",764,377,387,0.493455497382199,773,378,395,0.489003880983182,0.0160321593522513,0.348991694068006,0.634976146579743
7,"Rheinland-Pfalz",7333076,"Stetten",619,292,327,0.47172859450727,612,291,321,0.475490196078431,0.0160321593522513,0.348991694068006,0.634976146579743
7,"Rheinland-Pfalz",7333077,"Teschenmoschel",119,59,60,0.495798319327731,119,58,61,0.487394957983193,0.0160321593522513,0.348991694068006,0.634976146579743
7,"Rheinland-Pfalz",7333078,"Unkenbach",217,114,103,0.525345622119816,219,112,107,0.511415525114155,0.0160321593522513,0.348991694068006,0.634976146579743
7,"Rheinland-Pfalz",7333079,"Waldgrehweiler",219,111,108,0.506849315068493,220,110,110,0.5,0.0160321593522513,0.348991694068006,0.634976146579743
7,"Rheinland-Pfalz",7333080,"Wartenberg-Rohrbach",482,242,240,0.50207468879668,471,236,235,0.501061571125265,0.0160321593522513,0.348991694068006,0.634976146579743
7,"Rheinland-Pfalz",7333081,"Weitersweiler",492,260,232,0.528455284552846,483,250,233,0.5175983436853,0.0160321593522513,0.348991694068006,0.634976146579743
7,"Rheinland-Pfalz",7333083,"Winterborn",185,88,97,0.475675675675676,181,80,101,0.441988950276243,0.0160321593522513,0.348991694068006,0.634976146579743
7,"Rheinland-Pfalz",7333084,"Würzweiler",208,110,98,0.528846153846154,211,113,98,0.535545023696682,0.0160321593522513,0.348991694068006,0.634976146579743
7,"Rheinland-Pfalz",7333201,"Rathskirchen",191,98,93,0.513089005235602,194,100,94,0.515463917525773,0.0160321593522513,0.348991694068006,0.634976146579743
7,"Rheinland-Pfalz",7333202,"Reichsthal",112,59,53,0.526785714285714,105,57,48,0.542857142857143,0.0160321593522513,0.348991694068006,0.634976146579743
7,"Rheinland-Pfalz",7333203,"Seelen",172,81,91,0.47093023255814,168,76,92,0.452380952380952,0.0160321593522513,0.348991694068006,0.634976146579743
7,"Rheinland-Pfalz",7333501,"Zellertal",1227,611,616,0.497962510187449,1232,613,619,0.497564935064935,0.0160321593522513,0.348991694068006,0.634976146579743
7,"Rheinland-Pfalz",7333502,"Rockenhausen, Stadt",5424,2659,2765,0.490228613569322,5332,2641,2691,0.495311327831958,0.0160321593522513,0.348991694068006,0.634976146579743
7,"Rheinland-Pfalz",7333503,"Winnweiler",4736,2330,2406,0.491976351351351,4615,2289,2326,0.495991332611051,0.0160321593522513,0.348991694068006,0.634976146579743
7,"Rheinland-Pfalz",7334001,"Bellheim",8327,4065,4262,0.488171009967575,8349,4103,4246,0.491436100131752,0.0160321593522513,0.348991694068006,0.634976146579743
7,"Rheinland-Pfalz",7334002,"Berg (Pfalz)",2047,997,1050,0.487054225696141,2064,1021,1043,0.494670542635659,0.0160321593522513,0.348991694068006,0.634976146579743
7,"Rheinland-Pfalz",7334004,"Erlenbach bei Kandel",725,373,352,0.51448275862069,706,367,339,0.519830028328612,0.0160321593522513,0.348991694068006,0.634976146579743
7,"Rheinland-Pfalz",7334005,"Freckenfeld",1564,753,811,0.481457800511509,1530,742,788,0.484967320261438,0.0160321593522513,0.348991694068006,0.634976146579743
7,"Rheinland-Pfalz",7334006,"Freisbach",1073,540,533,0.503261882572227,1061,536,525,0.505183788878417,0.0160321593522513,0.348991694068006,0.634976146579743
7,"Rheinland-Pfalz",7334007,"Germersheim, Stadt",19997,9840,10157,0.492073811071661,20693,10037,10656,0.485043251341033,0.0160321593522513,0.348991694068006,0.634976146579743
7,"Rheinland-Pfalz",7334008,"Hagenbach, Stadt",5300,2604,2696,0.491320754716981,5316,2635,2681,0.495673438675696,0.0160321593522513,0.348991694068006,0.634976146579743
7,"Rheinland-Pfalz",7334009,"Hatzenbühl",2951,1592,1359,0.539478143002372,2984,1608,1376,0.53887399463807,0.0160321593522513,0.348991694068006,0.634976146579743
7,"Rheinland-Pfalz",7334011,"Hördt",2434,1237,1197,0.508216926869351,2414,1219,1195,0.504971002485501,0.0160321593522513,0.348991694068006,0.634976146579743
7,"Rheinland-Pfalz",7334012,"Jockgrim",6981,3480,3501,0.498495917490331,7008,3542,3466,0.505422374429224,0.0160321593522513,0.348991694068006,0.634976146579743
7,"Rheinland-Pfalz",7334013,"Kandel, Stadt",8535,4171,4364,0.488693614528412,8530,4181,4349,0.490152403282532,0.0160321593522513,0.348991694068006,0.634976146579743
7,"Rheinland-Pfalz",7334014,"Knittelsheim",1020,504,516,0.494117647058824,1005,499,506,0.496517412935323,0.0160321593522513,0.348991694068006,0.634976146579743
7,"Rheinland-Pfalz",7334015,"Kuhardt",1898,947,951,0.498946259220232,1884,930,954,0.493630573248408,0.0160321593522513,0.348991694068006,0.634976146579743
7,"Rheinland-Pfalz",7334016,"Leimersheim",2601,1258,1343,0.483660130718954,2558,1216,1342,0.475371383893667,0.0160321593522513,0.348991694068006,0.634976146579743
7,"Rheinland-Pfalz",7334017,"Lingenfeld",5551,2774,2777,0.499729778418303,5517,2790,2727,0.505709624796085,0.0160321593522513,0.348991694068006,0.634976146579743
7,"Rheinland-Pfalz",7334018,"Lustadt",3231,1582,1649,0.489631692974311,3193,1582,1611,0.495458816160351,0.0160321593522513,0.348991694068006,0.634976146579743
7,"Rheinland-Pfalz",7334020,"Minfeld",1502,734,768,0.488681757656458,1497,735,762,0.490981963927856,0.0160321593522513,0.348991694068006,0.634976146579743
7,"Rheinland-Pfalz",7334021,"Neuburg am Rhein",2566,1267,1299,0.493764614185503,2552,1263,1289,0.494905956112853,0.0160321593522513,0.348991694068006,0.634976146579743
7,"Rheinland-Pfalz",7334022,"Neupotz",1833,919,914,0.501363884342608,1837,936,901,0.509526401741971,0.0160321593522513,0.348991694068006,0.634976146579743
7,"Rheinland-Pfalz",7334023,"Ottersheim bei Landau",1836,915,921,0.498366013071895,1808,900,908,0.497787610619469,0.0160321593522513,0.348991694068006,0.634976146579743
7,"Rheinland-Pfalz",7334024,"Rheinzabern",4853,2405,2448,0.495569750669689,4949,2488,2461,0.502727823802788,0.0160321593522513,0.348991694068006,0.634976146579743
7,"Rheinland-Pfalz",7334025,"Rülzheim",7782,3815,3967,0.49023387304035,7716,3789,3927,0.491057542768274,0.0160321593522513,0.348991694068006,0.634976146579743
7,"Rheinland-Pfalz",7334027,"Scheibenhardt",665,321,344,0.482706766917293,679,335,344,0.493372606774669,0.0160321593522513,0.348991694068006,0.634976146579743
7,"Rheinland-Pfalz",7334028,"Schwegenheim",2905,1464,1441,0.503958691910499,2899,1483,1416,0.511555708865126,0.0160321593522513,0.348991694068006,0.634976146579743
7,"Rheinland-Pfalz",7334030,"Steinweiler",1895,981,914,0.517678100263852,1918,995,923,0.518769551616267,0.0160321593522513,0.348991694068006,0.634976146579743
7,"Rheinland-Pfalz",7334031,"Vollmersweiler",211,93,118,0.440758293838863,213,95,118,0.446009389671362,0.0160321593522513,0.348991694068006,0.634976146579743
7,"Rheinland-Pfalz",7334032,"Weingarten (Pfalz)",1660,851,809,0.512650602409639,1676,867,809,0.517303102625298,0.0160321593522513,0.348991694068006,0.634976146579743
7,"Rheinland-Pfalz",7334033,"Westheim (Pfalz)",1752,872,880,0.497716894977169,1740,879,861,0.505172413793103,0.0160321593522513,0.348991694068006,0.634976146579743
7,"Rheinland-Pfalz",7334034,"Winden",1062,524,538,0.493408662900188,1081,534,547,0.493987049028677,0.0160321593522513,0.348991694068006,0.634976146579743
7,"Rheinland-Pfalz",7334036,"Zeiskam",2205,1119,1086,0.507482993197279,2246,1152,1094,0.512911843276937,0.0160321593522513,0.348991694068006,0.634976146579743
7,"Rheinland-Pfalz",7334501,"Wörth am Rhein, Stadt",17332,8437,8895,0.486787445188091,17379,8489,8890,0.488463087634501,0.0160321593522513,0.348991694068006,0.634976146579743
7,"Rheinland-Pfalz",7335002,"Bann",2202,1093,1109,0.496366939146231,2195,1101,1094,0.501594533029613,0.0160321593522513,0.348991694068006,0.634976146579743
7,"Rheinland-Pfalz",7335003,"Bruchmühlbach-Miesau",7595,3656,3939,0.481369321922317,7405,3560,3845,0.480756245779878,0.0160321593522513,0.348991694068006,0.634976146579743
7,"Rheinland-Pfalz",7335004,"Enkenbach-Alsenborn",6855,3303,3552,0.481838074398249,6935,3331,3604,0.480317231434751,0.0160321593522513,0.348991694068006,0.634976146579743
7,"Rheinland-Pfalz",7335005,"Erzenhausen",745,361,384,0.484563758389262,724,355,369,0.490331491712707,0.0160321593522513,0.348991694068006,0.634976146579743
7,"Rheinland-Pfalz",7335006,"Eulenbis",488,232,256,0.475409836065574,486,227,259,0.467078189300412,0.0160321593522513,0.348991694068006,0.634976146579743
7,"Rheinland-Pfalz",7335007,"Fischbach",783,404,379,0.515964240102171,801,419,382,0.523096129837703,0.0160321593522513,0.348991694068006,0.634976146579743
7,"Rheinland-Pfalz",7335009,"Frankelbach",319,157,162,0.492163009404389,319,164,155,0.5141065830721,0.0160321593522513,0.348991694068006,0.634976146579743
7,"Rheinland-Pfalz",7335010,"Frankenstein",990,478,512,0.482828282828283,991,484,507,0.488395560040363,0.0160321593522513,0.348991694068006,0.634976146579743
7,"Rheinland-Pfalz",7335011,"Gerhardsbrunn",174,92,82,0.528735632183908,162,85,77,0.524691358024691,0.0160321593522513,0.348991694068006,0.634976146579743
7,"Rheinland-Pfalz",7335012,"Hauptstuhl",1214,604,610,0.497528830313015,1199,589,610,0.491242702251877,0.0160321593522513,0.348991694068006,0.634976146579743
7,"Rheinland-Pfalz",7335013,"Heiligenmoschel",659,320,339,0.485584218512898,653,315,338,0.482388973966309,0.0160321593522513,0.348991694068006,0.634976146579743
7,"Rheinland-Pfalz",7335014,"Hirschhorn/ Pfalz",787,399,388,0.506988564167726,773,389,384,0.503234152652005,0.0160321593522513,0.348991694068006,0.634976146579743
7,"Rheinland-Pfalz",7335015,"Hochspeyer",4533,2283,2250,0.503639973527465,4511,2282,2229,0.505874528929284,0.0160321593522513,0.348991694068006,0.634976146579743
7,"Rheinland-Pfalz",7335016,"Hütschenhausen",3919,1910,2009,0.487369226843583,3800,1847,1953,0.486052631578947,0.0160321593522513,0.348991694068006,0.634976146579743
7,"Rheinland-Pfalz",7335017,"Katzweiler",1695,830,865,0.489675516224189,1728,865,863,0.500578703703704,0.0160321593522513,0.348991694068006,0.634976146579743
7,"Rheinland-Pfalz",7335018,"Kindsbach",2403,1158,1245,0.481897627965044,2348,1117,1231,0.47572402044293,0.0160321593522513,0.348991694068006,0.634976146579743
7,"Rheinland-Pfalz",7335019,"Kollweiler",475,241,234,0.507368421052632,462,234,228,0.506493506493506,0.0160321593522513,0.348991694068006,0.634976146579743
7,"Rheinland-Pfalz",7335020,"Kottweiler-Schwanden",1267,622,645,0.490923441199684,1254,607,647,0.484051036682616,0.0160321593522513,0.348991694068006,0.634976146579743
7,"Rheinland-Pfalz",7335021,"Krickenbach",1181,582,599,0.492802709568163,1157,563,594,0.486603284356093,0.0160321593522513,0.348991694068006,0.634976146579743
7,"Rheinland-Pfalz",7335022,"Landstuhl, Sickingenstadt, Stadt",8458,4033,4425,0.476826672972334,8473,4029,4444,0.475510444942759,0.0160321593522513,0.348991694068006,0.634976146579743
7,"Rheinland-Pfalz",7335023,"Linden",1179,575,604,0.487701441899915,1139,560,579,0.491659350307287,0.0160321593522513,0.348991694068006,0.634976146579743
7,"Rheinland-Pfalz",7335024,"Mackenbach",1978,957,1021,0.483822042467139,1937,958,979,0.494579246257099,0.0160321593522513,0.348991694068006,0.634976146579743
7,"Rheinland-Pfalz",7335025,"Mehlbach",1096,531,565,0.48448905109489,1086,527,559,0.485267034990792,0.0160321593522513,0.348991694068006,0.634976146579743
7,"Rheinland-Pfalz",7335026,"Mehlingen",3752,1855,1897,0.494402985074627,3803,1874,1929,0.492768866684197,0.0160321593522513,0.348991694068006,0.634976146579743
7,"Rheinland-Pfalz",7335027,"Mittelbrunn",662,326,336,0.492447129909366,675,341,334,0.505185185185185,0.0160321593522513,0.348991694068006,0.634976146579743
7,"Rheinland-Pfalz",7335028,"Neuhemsbach",839,411,428,0.489868891537545,842,417,425,0.495249406175772,0.0160321593522513,0.348991694068006,0.634976146579743
7,"Rheinland-Pfalz",7335029,"Niederkirchen",1989,975,1014,0.490196078431373,1985,983,1002,0.495214105793451,0.0160321593522513,0.348991694068006,0.634976146579743
7,"Rheinland-Pfalz",7335030,"Niedermohr",1461,717,744,0.490759753593429,1464,733,731,0.50068306010929,0.0160321593522513,0.348991694068006,0.634976146579743
7,"Rheinland-Pfalz",7335031,"Oberarnbach",422,206,216,0.488151658767773,426,209,217,0.490610328638498,0.0160321593522513,0.348991694068006,0.634976146579743
7,"Rheinland-Pfalz",7335033,"Olsbrücken",1078,533,545,0.49443413729128,1101,550,551,0.499545867393279,0.0160321593522513,0.348991694068006,0.634976146579743
7,"Rheinland-Pfalz",7335034,"Otterbach",3922,1905,2017,0.485721570627231,3992,1963,2029,0.491733466933868,0.0160321593522513,0.348991694068006,0.634976146579743
7,"Rheinland-Pfalz",7335035,"Otterberg, Stadt",5165,2514,2651,0.486737657308809,5244,2573,2671,0.490655987795576,0.0160321593522513,0.348991694068006,0.634976146579743
7,"Rheinland-Pfalz",7335037,"Queidersbach",2815,1368,1447,0.485968028419183,2806,1353,1453,0.482181040627227,0.0160321593522513,0.348991694068006,0.634976146579743
7,"Rheinland-Pfalz",7335038,"Ramstein-Miesenbach, Stadt",7555,3683,3872,0.487491727332892,7359,3617,3742,0.491506998233456,0.0160321593522513,0.348991694068006,0.634976146579743
7,"Rheinland-Pfalz",7335040,"Rodenbach",3110,1504,1606,0.483601286173633,3184,1565,1619,0.491520100502513,0.0160321593522513,0.348991694068006,0.634976146579743
7,"Rheinland-Pfalz",7335041,"Schallodenbach",876,431,445,0.492009132420091,907,445,462,0.490628445424476,0.0160321593522513,0.348991694068006,0.634976146579743
7,"Rheinland-Pfalz",7335042,"Schneckenhausen",595,314,281,0.527731092436975,600,321,279,0.535,0.0160321593522513,0.348991694068006,0.634976146579743
7,"Rheinland-Pfalz",7335043,"Schwedelbach",1005,505,500,0.502487562189055,1006,509,497,0.50596421471173,0.0160321593522513,0.348991694068006,0.634976146579743
7,"Rheinland-Pfalz",7335044,"Steinwenden",2489,1222,1267,0.490960224989956,2453,1209,1244,0.492865878516103,0.0160321593522513,0.348991694068006,0.634976146579743
7,"Rheinland-Pfalz",7335045,"Stelzenberg",1147,562,585,0.489973844812555,1160,578,582,0.498275862068966,0.0160321593522513,0.348991694068006,0.634976146579743
7,"Rheinland-Pfalz",7335046,"Sulzbachtal",441,225,216,0.510204081632653,459,243,216,0.529411764705882,0.0160321593522513,0.348991694068006,0.634976146579743
7,"Rheinland-Pfalz",7335047,"Trippstadt",3078,1480,1598,0.480831708901884,3111,1516,1595,0.487303117968499,0.0160321593522513,0.348991694068006,0.634976146579743
7,"Rheinland-Pfalz",7335048,"Waldleiningen",414,205,209,0.495169082125604,403,205,198,0.508684863523573,0.0160321593522513,0.348991694068006,0.634976146579743
7,"Rheinland-Pfalz",7335049,"Weilerbach",4534,2176,2358,0.479929422143802,4446,2125,2321,0.47795771479982,0.0160321593522513,0.348991694068006,0.634976146579743
7,"Rheinland-Pfalz",7335201,"Lambsborn",744,378,366,0.508064516129032,744,376,368,0.505376344086022,0.0160321593522513,0.348991694068006,0.634976146579743
7,"Rheinland-Pfalz",7335202,"Langwieden",269,144,125,0.535315985130111,264,144,120,0.545454545454545,0.0160321593522513,0.348991694068006,0.634976146579743
7,"Rheinland-Pfalz",7335203,"Martinshöhe",1602,890,712,0.555555555555556,1681,975,706,0.580011897679952,0.0160321593522513,0.348991694068006,0.634976146579743
7,"Rheinland-Pfalz",7335204,"Schopp",1418,707,711,0.498589562764457,1422,703,719,0.494374120956399,0.0160321593522513,0.348991694068006,0.634976146579743
7,"Rheinland-Pfalz",7335205,"Sembach",1127,547,580,0.485359361135759,1132,549,583,0.484982332155477,0.0160321593522513,0.348991694068006,0.634976146579743
7,"Rheinland-Pfalz",7335501,"Reichenbach-Steegen",1406,707,699,0.502844950213371,1400,709,691,0.506428571428571,0.0160321593522513,0.348991694068006,0.634976146579743
7,"Rheinland-Pfalz",7336001,"Adenbach",152,70,82,0.460526315789474,156,76,80,0.487179487179487,0.0160321593522513,0.348991694068006,0.634976146579743
7,"Rheinland-Pfalz",7336002,"Albessen",163,88,75,0.539877300613497,158,85,73,0.537974683544304,0.0160321593522513,0.348991694068006,0.634976146579743
7,"Rheinland-Pfalz",7336003,"Altenglan",2842,1410,1432,0.49612948627727,2806,1387,1419,0.494297933000713,0.0160321593522513,0.348991694068006,0.634976146579743
7,"Rheinland-Pfalz",7336004,"Altenkirchen",1326,688,638,0.518853695324284,1286,653,633,0.507776049766719,0.0160321593522513,0.348991694068006,0.634976146579743
7,"Rheinland-Pfalz",7336005,"Aschbach",341,176,165,0.516129032258065,323,163,160,0.504643962848297,0.0160321593522513,0.348991694068006,0.634976146579743
7,"Rheinland-Pfalz",7336006,"Blaubach",397,194,203,0.488664987405542,386,186,200,0.481865284974093,0.0160321593522513,0.348991694068006,0.634976146579743
7,"Rheinland-Pfalz",7336008,"Börsborn",415,218,197,0.525301204819277,396,207,189,0.522727272727273,0.0160321593522513,0.348991694068006,0.634976146579743
7,"Rheinland-Pfalz",7336009,"Bosenbach",750,378,372,0.504,766,394,372,0.514360313315927,0.0160321593522513,0.348991694068006,0.634976146579743
7,"Rheinland-Pfalz",7336010,"Breitenbach",1899,948,951,0.499210110584518,1895,936,959,0.493931398416887,0.0160321593522513,0.348991694068006,0.634976146579743
7,"Rheinland-Pfalz",7336011,"Brücken (Pfalz)",2199,1097,1102,0.498863119599818,2148,1074,1074,0.5,0.0160321593522513,0.348991694068006,0.634976146579743
7,"Rheinland-Pfalz",7336012,"Buborn",152,89,63,0.585526315789474,153,93,60,0.607843137254902,0.0160321593522513,0.348991694068006,0.634976146579743
7,"Rheinland-Pfalz",7336013,"Cronenberg",146,72,74,0.493150684931507,139,68,71,0.489208633093525,0.0160321593522513,0.348991694068006,0.634976146579743
7,"Rheinland-Pfalz",7336014,"Deimberg",98,49,49,0.5,99,52,47,0.525252525252525,0.0160321593522513,0.348991694068006,0.634976146579743
7,"Rheinland-Pfalz",7336015,"Dennweiler-Frohnbach",284,142,142,0.5,275,136,139,0.494545454545455,0.0160321593522513,0.348991694068006,0.634976146579743
7,"Rheinland-Pfalz",7336016,"Dittweiler",857,424,433,0.494749124854142,863,434,429,0.502896871378911,0.0160321593522513,0.348991694068006,0.634976146579743
7,"Rheinland-Pfalz",7336017,"Dunzweiler",925,445,480,0.481081081081081,925,441,484,0.476756756756757,0.0160321593522513,0.348991694068006,0.634976146579743
7,"Rheinland-Pfalz",7336018,"Ehweiler",175,88,87,0.502857142857143,176,89,87,0.505681818181818,0.0160321593522513,0.348991694068006,0.634976146579743
7,"Rheinland-Pfalz",7336019,"Einöllen",444,218,226,0.490990990990991,443,215,228,0.485327313769752,0.0160321593522513,0.348991694068006,0.634976146579743
7,"Rheinland-Pfalz",7336021,"Elzweiler",111,53,58,0.477477477477477,123,66,57,0.536585365853659,0.0160321593522513,0.348991694068006,0.634976146579743
7,"Rheinland-Pfalz",7336022,"Erdesbach",603,293,310,0.485903814262023,614,300,314,0.488599348534202,0.0160321593522513,0.348991694068006,0.634976146579743
7,"Rheinland-Pfalz",7336023,"Eßweiler",427,216,211,0.505854800936768,413,207,206,0.501210653753027,0.0160321593522513,0.348991694068006,0.634976146579743
7,"Rheinland-Pfalz",7336024,"Etschberg",667,326,341,0.488755622188906,653,314,339,0.480857580398162,0.0160321593522513,0.348991694068006,0.634976146579743
7,"Rheinland-Pfalz",7336025,"Föckelberg",377,185,192,0.490716180371353,399,197,202,0.493734335839599,0.0160321593522513,0.348991694068006,0.634976146579743
7,"Rheinland-Pfalz",7336027,"Frohnhofen",544,271,273,0.498161764705882,557,276,281,0.495511669658887,0.0160321593522513,0.348991694068006,0.634976146579743
7,"Rheinland-Pfalz",7336029,"Ginsweiler",317,173,144,0.545741324921136,320,176,144,0.55,0.0160321593522513,0.348991694068006,0.634976146579743
7,"Rheinland-Pfalz",7336030,"Glanbrücken",488,248,240,0.508196721311475,497,253,244,0.509054325955734,0.0160321593522513,0.348991694068006,0.634976146579743
7,"Rheinland-Pfalz",7336031,"Glan-Münchweiler",1271,581,690,0.457120377655389,1238,567,671,0.457996768982229,0.0160321593522513,0.348991694068006,0.634976146579743
7,"Rheinland-Pfalz",7336032,"Gries",1010,518,492,0.512871287128713,981,498,483,0.507645259938838,0.0160321593522513,0.348991694068006,0.634976146579743
7,"Rheinland-Pfalz",7336033,"Grumbach",458,232,226,0.506550218340611,457,239,218,0.522975929978118,0.0160321593522513,0.348991694068006,0.634976146579743
7,"Rheinland-Pfalz",7336034,"Haschbach am Remigiusberg",707,357,350,0.504950495049505,714,360,354,0.504201680672269,0.0160321593522513,0.348991694068006,0.634976146579743
7,"Rheinland-Pfalz",7336035,"Hausweiler",56,33,23,0.589285714285714,43,22,21,0.511627906976744,0.0160321593522513,0.348991694068006,0.634976146579743
7,"Rheinland-Pfalz",7336036,"Hefersweiler",513,249,264,0.485380116959064,500,245,255,0.49,0.0160321593522513,0.348991694068006,0.634976146579743
7,"Rheinland-Pfalz",7336037,"Henschtal",349,172,177,0.492836676217765,346,171,175,0.494219653179191,0.0160321593522513,0.348991694068006,0.634976146579743
7,"Rheinland-Pfalz",7336038,"Heinzenhausen",278,136,142,0.489208633093525,290,144,146,0.496551724137931,0.0160321593522513,0.348991694068006,0.634976146579743
7,"Rheinland-Pfalz",7336039,"Herchweiler",534,252,282,0.471910112359551,565,269,296,0.476106194690265,0.0160321593522513,0.348991694068006,0.634976146579743
7,"Rheinland-Pfalz",7336040,"Herren-Sulzbach",150,75,75,0.5,149,77,72,0.516778523489933,0.0160321593522513,0.348991694068006,0.634976146579743
7,"Rheinland-Pfalz",7336041,"Herschweiler-Pettersheim",1336,660,676,0.494011976047904,1306,653,653,0.5,0.0160321593522513,0.348991694068006,0.634976146579743
7,"Rheinland-Pfalz",7336042,"Hinzweiler",373,174,199,0.466487935656836,376,184,192,0.48936170212766,0.0160321593522513,0.348991694068006,0.634976146579743
7,"Rheinland-Pfalz",7336043,"Hohenöllen",364,192,172,0.527472527472527,364,194,170,0.532967032967033,0.0160321593522513,0.348991694068006,0.634976146579743
7,"Rheinland-Pfalz",7336044,"Homberg",211,103,108,0.488151658767773,210,98,112,0.466666666666667,0.0160321593522513,0.348991694068006,0.634976146579743
7,"Rheinland-Pfalz",7336045,"Hoppstädten",304,164,140,0.539473684210526,293,159,134,0.542662116040956,0.0160321593522513,0.348991694068006,0.634976146579743
7,"Rheinland-Pfalz",7336046,"Horschbach",275,140,135,0.509090909090909,269,136,133,0.505576208178439,0.0160321593522513,0.348991694068006,0.634976146579743
7,"Rheinland-Pfalz",7336047,"Hüffler",573,287,286,0.50087260034904,560,275,285,0.491071428571429,0.0160321593522513,0.348991694068006,0.634976146579743
7,"Rheinland-Pfalz",7336048,"Jettenbach",867,422,445,0.486735870818916,845,415,430,0.49112426035503,0.0160321593522513,0.348991694068006,0.634976146579743
7,"Rheinland-Pfalz",7336049,"Kappeln",203,104,99,0.512315270935961,131,63,68,0.480916030534351,0.0160321593522513,0.348991694068006,0.634976146579743
7,"Rheinland-Pfalz",7336050,"Kirrweiler",175,85,90,0.485714285714286,170,86,84,0.505882352941176,0.0160321593522513,0.348991694068006,0.634976146579743
7,"Rheinland-Pfalz",7336051,"Körborn",362,185,177,0.511049723756906,356,178,178,0.5,0.0160321593522513,0.348991694068006,0.634976146579743
7,"Rheinland-Pfalz",7336052,"Konken",752,374,378,0.497340425531915,741,373,368,0.503373819163293,0.0160321593522513,0.348991694068006,0.634976146579743
7,"Rheinland-Pfalz",7336053,"Kreimbach-Kaulbach",775,391,384,0.504516129032258,796,403,393,0.506281407035176,0.0160321593522513,0.348991694068006,0.634976146579743
7,"Rheinland-Pfalz",7336054,"Krottelbach",706,353,353,0.5,706,358,348,0.507082152974504,0.0160321593522513,0.348991694068006,0.634976146579743
7,"Rheinland-Pfalz",7336055,"Kusel, Stadt",5069,2448,2621,0.48293549023476,4854,2349,2505,0.483930778739184,0.0160321593522513,0.348991694068006,0.634976146579743
7,"Rheinland-Pfalz",7336056,"Langenbach",451,229,222,0.507760532150776,442,231,211,0.52262443438914,0.0160321593522513,0.348991694068006,0.634976146579743
7,"Rheinland-Pfalz",7336057,"Langweiler",253,115,138,0.454545454545455,251,113,138,0.450199203187251,0.0160321593522513,0.348991694068006,0.634976146579743
7,"Rheinland-Pfalz",7336058,"Lauterecken, Stadt",2162,1011,1151,0.467622571692877,2145,1041,1104,0.485314685314685,0.0160321593522513,0.348991694068006,0.634976146579743
7,"Rheinland-Pfalz",7336060,"Lohnweiler",392,193,199,0.49234693877551,392,201,191,0.512755102040816,0.0160321593522513,0.348991694068006,0.634976146579743
7,"Rheinland-Pfalz",7336061,"Medard",501,257,244,0.512974051896208,493,255,238,0.517241379310345,0.0160321593522513,0.348991694068006,0.634976146579743
7,"Rheinland-Pfalz",7336062,"Merzweiler",182,88,94,0.483516483516484,199,95,104,0.477386934673367,0.0160321593522513,0.348991694068006,0.634976146579743
7,"Rheinland-Pfalz",7336064,"Nanzdietschweiler",1194,601,593,0.503350083752094,1205,605,600,0.50207468879668,0.0160321593522513,0.348991694068006,0.634976146579743
7,"Rheinland-Pfalz",7336065,"Nerzweiler",124,61,63,0.491935483870968,127,64,63,0.503937007874016,0.0160321593522513,0.348991694068006,0.634976146579743
7,"Rheinland-Pfalz",7336066,"Neunkirchen am Potzberg",418,208,210,0.497607655502392,408,204,204,0.5,0.0160321593522513,0.348991694068006,0.634976146579743
7,"Rheinland-Pfalz",7336067,"Niederalben",305,158,147,0.518032786885246,312,159,153,0.509615384615385,0.0160321593522513,0.348991694068006,0.634976146579743
7,"Rheinland-Pfalz",7336068,"Niederstaufenbach",284,137,147,0.482394366197183,277,130,147,0.469314079422383,0.0160321593522513,0.348991694068006,0.634976146579743
7,"Rheinland-Pfalz",7336069,"Nußbach",625,307,318,0.4912,607,298,309,0.490939044481054,0.0160321593522513,0.348991694068006,0.634976146579743
7,"Rheinland-Pfalz",7336070,"Oberalben",246,114,132,0.463414634146341,240,110,130,0.458333333333333,0.0160321593522513,0.348991694068006,0.634976146579743
7,"Rheinland-Pfalz",7336071,"Oberstaufenbach",244,126,118,0.516393442622951,234,118,116,0.504273504273504,0.0160321593522513,0.348991694068006,0.634976146579743
7,"Rheinland-Pfalz",7336072,"Oberweiler im Tal",165,77,88,0.466666666666667,149,73,76,0.48993288590604,0.0160321593522513,0.348991694068006,0.634976146579743
7,"Rheinland-Pfalz",7336073,"Oberweiler-Tiefenbach",294,147,147,0.5,295,145,150,0.491525423728814,0.0160321593522513,0.348991694068006,0.634976146579743
7,"Rheinland-Pfalz",7336074,"Odenbach",866,439,427,0.506928406466513,866,447,419,0.516166281755196,0.0160321593522513,0.348991694068006,0.634976146579743
7,"Rheinland-Pfalz",7336075,"Offenbach-Hundheim",1183,569,614,0.480980557903635,1171,576,595,0.491887275832622,0.0160321593522513,0.348991694068006,0.634976146579743
7,"Rheinland-Pfalz",7336076,"Ohmbach",819,428,391,0.522588522588523,805,427,378,0.530434782608696,0.0160321593522513,0.348991694068006,0.634976146579743
7,"Rheinland-Pfalz",7336077,"Pfeffelbach",946,463,483,0.489429175475687,951,468,483,0.49211356466877,0.0160321593522513,0.348991694068006,0.634976146579743
7,"Rheinland-Pfalz",7336079,"Rammelsbach",1579,780,799,0.493983533882204,1599,805,794,0.503439649781113,0.0160321593522513,0.348991694068006,0.634976146579743
7,"Rheinland-Pfalz",7336081,"Rathsweiler",156,71,85,0.455128205128205,164,77,87,0.469512195121951,0.0160321593522513,0.348991694068006,0.634976146579743
7,"Rheinland-Pfalz",7336082,"Rehweiler",428,211,217,0.492990654205608,430,213,217,0.495348837209302,0.0160321593522513,0.348991694068006,0.634976146579743
7,"Rheinland-Pfalz",7336084,"Reichweiler",531,267,264,0.502824858757062,535,267,268,0.499065420560748,0.0160321593522513,0.348991694068006,0.634976146579743
7,"Rheinland-Pfalz",7336085,"Reipoltskirchen",374,182,192,0.486631016042781,374,184,190,0.491978609625668,0.0160321593522513,0.348991694068006,0.634976146579743
7,"Rheinland-Pfalz",7336086,"Relsberg",193,94,99,0.487046632124352,186,95,91,0.510752688172043,0.0160321593522513,0.348991694068006,0.634976146579743
7,"Rheinland-Pfalz",7336087,"Rothselberg",674,333,341,0.49406528189911,677,334,343,0.493353028064993,0.0160321593522513,0.348991694068006,0.634976146579743
7,"Rheinland-Pfalz",7336088,"Ruthweiler",463,228,235,0.49244060475162,477,240,237,0.50314465408805,0.0160321593522513,0.348991694068006,0.634976146579743
7,"Rheinland-Pfalz",7336089,"Rutsweiler am Glan",327,165,162,0.504587155963303,314,158,156,0.503184713375796,0.0160321593522513,0.348991694068006,0.634976146579743
7,"Rheinland-Pfalz",7336090,"Rutsweiler an der Lauter",371,186,185,0.501347708894879,359,182,177,0.506963788300836,0.0160321593522513,0.348991694068006,0.634976146579743
7,"Rheinland-Pfalz",7336091,"Schellweiler",530,258,272,0.486792452830189,519,251,268,0.483622350674374,0.0160321593522513,0.348991694068006,0.634976146579743
7,"Rheinland-Pfalz",7336092,"Schönenberg-Kübelberg",5606,2728,2878,0.48662147698894,5594,2732,2862,0.48838040757955,0.0160321593522513,0.348991694068006,0.634976146579743
7,"Rheinland-Pfalz",7336094,"Selchenbach",352,167,185,0.474431818181818,358,170,188,0.474860335195531,0.0160321593522513,0.348991694068006,0.634976146579743
7,"Rheinland-Pfalz",7336095,"Sankt Julian",1153,557,596,0.483087597571552,1174,577,597,0.491482112436116,0.0160321593522513,0.348991694068006,0.634976146579743
7,"Rheinland-Pfalz",7336096,"Steinbach am Glan",912,456,456,0.5,893,440,453,0.492721164613662,0.0160321593522513,0.348991694068006,0.634976146579743
7,"Rheinland-Pfalz",7336097,"Thallichtenberg",570,284,286,0.498245614035088,548,270,278,0.492700729927007,0.0160321593522513,0.348991694068006,0.634976146579743
7,"Rheinland-Pfalz",7336098,"Theisbergstegen",675,331,344,0.49037037037037,678,343,335,0.505899705014749,0.0160321593522513,0.348991694068006,0.634976146579743
7,"Rheinland-Pfalz",7336099,"Ulmet",714,359,355,0.502801120448179,705,353,352,0.500709219858156,0.0160321593522513,0.348991694068006,0.634976146579743
7,"Rheinland-Pfalz",7336100,"Unterjeckenbach",68,36,32,0.529411764705882,67,33,34,0.492537313432836,0.0160321593522513,0.348991694068006,0.634976146579743
7,"Rheinland-Pfalz",7336101,"Wahnwegen",709,359,350,0.506346967559944,699,360,339,0.515021459227468,0.0160321593522513,0.348991694068006,0.634976146579743
7,"Rheinland-Pfalz",7336102,"Waldmohr",5137,2528,2609,0.492116021023944,5184,2594,2590,0.500385802469136,0.0160321593522513,0.348991694068006,0.634976146579743
7,"Rheinland-Pfalz",7336103,"Welchweiler",200,105,95,0.525,203,111,92,0.54679802955665,0.0160321593522513,0.348991694068006,0.634976146579743
7,"Rheinland-Pfalz",7336104,"Wiesweiler",402,201,201,0.5,409,204,205,0.498777506112469,0.0160321593522513,0.348991694068006,0.634976146579743
7,"Rheinland-Pfalz",7336105,"Wolfstein, Stadt",1975,965,1010,0.488607594936709,1936,960,976,0.495867768595041,0.0160321593522513,0.348991694068006,0.634976146579743
7,"Rheinland-Pfalz",7336106,"Bedesbach",810,399,411,0.492592592592593,799,399,400,0.499374217772215,0.0160321593522513,0.348991694068006,0.634976146579743
7,"Rheinland-Pfalz",7336107,"Matzenbach",650,320,330,0.492307692307692,697,362,335,0.519368723098996,0.0160321593522513,0.348991694068006,0.634976146579743
7,"Rheinland-Pfalz",7336501,"Quirnbach/ Pfalz",475,240,235,0.505263157894737,472,239,233,0.50635593220339,0.0160321593522513,0.348991694068006,0.634976146579743
7,"Rheinland-Pfalz",7337001,"Albersweiler",1895,906,989,0.478100263852243,1899,905,994,0.476566614007372,0.0160321593522513,0.348991694068006,0.634976146579743
7,"Rheinland-Pfalz",7337002,"Altdorf",742,379,363,0.51078167115903,722,371,351,0.513850415512465,0.0160321593522513,0.348991694068006,0.634976146579743
7,"Rheinland-Pfalz",7337005,"Bad Bergzabern, Stadt",7413,3440,3973,0.464049642519897,7633,3630,4003,0.475566618629635,0.0160321593522513,0.348991694068006,0.634976146579743
7,"Rheinland-Pfalz",7337006,"Barbelroth",594,292,302,0.491582491582492,591,288,303,0.487309644670051,0.0160321593522513,0.348991694068006,0.634976146579743
7,"Rheinland-Pfalz",7337007,"Billigheim-Ingenheim",3900,1936,1964,0.496410256410256,3870,1927,1943,0.497932816537468,0.0160321593522513,0.348991694068006,0.634976146579743
7,"Rheinland-Pfalz",7337008,"Birkenhördt",662,329,333,0.496978851963746,684,345,339,0.504385964912281,0.0160321593522513,0.348991694068006,0.634976146579743
7,"Rheinland-Pfalz",7337009,"Birkweiler",742,384,358,0.517520215633423,744,394,350,0.529569892473118,0.0160321593522513,0.348991694068006,0.634976146579743
7,"Rheinland-Pfalz",7337011,"Böbingen",748,366,382,0.489304812834225,740,374,366,0.505405405405405,0.0160321593522513,0.348991694068006,0.634976146579743
7,"Rheinland-Pfalz",7337012,"Böchingen",785,387,398,0.492993630573248,788,391,397,0.496192893401015,0.0160321593522513,0.348991694068006,0.634976146579743
7,"Rheinland-Pfalz",7337013,"Böllenborn",218,108,110,0.495412844036697,239,111,128,0.464435146443515,0.0160321593522513,0.348991694068006,0.634976146579743
7,"Rheinland-Pfalz",7337014,"Bornheim",1450,720,730,0.496551724137931,1424,710,714,0.498595505617978,0.0160321593522513,0.348991694068006,0.634976146579743
7,"Rheinland-Pfalz",7337015,"Burrweiler",801,376,425,0.469413233458177,827,398,429,0.481257557436518,0.0160321593522513,0.348991694068006,0.634976146579743
7,"Rheinland-Pfalz",7337017,"Dernbach",450,223,227,0.495555555555556,442,218,224,0.493212669683258,0.0160321593522513,0.348991694068006,0.634976146579743
7,"Rheinland-Pfalz",7337018,"Dierbach",558,265,293,0.474910394265233,561,273,288,0.486631016042781,0.0160321593522513,0.348991694068006,0.634976146579743
7,"Rheinland-Pfalz",7337019,"Dörrenbach",914,451,463,0.493435448577681,917,444,473,0.484187568157034,0.0160321593522513,0.348991694068006,0.634976146579743
7,"Rheinland-Pfalz",7337020,"Edenkoben, Stadt",6625,3222,3403,0.486339622641509,6658,3251,3407,0.488284770201262,0.0160321593522513,0.348991694068006,0.634976146579743
7,"Rheinland-Pfalz",7337021,"Edesheim",2266,1131,1135,0.499117387466902,2289,1154,1135,0.504150283966798,0.0160321593522513,0.348991694068006,0.634976146579743
7,"Rheinland-Pfalz",7337022,"Eschbach",632,311,321,0.492088607594937,667,342,325,0.512743628185907,0.0160321593522513,0.348991694068006,0.634976146579743
7,"Rheinland-Pfalz",7337023,"Essingen",2148,1042,1106,0.485102420856611,2178,1056,1122,0.484848484848485,0.0160321593522513,0.348991694068006,0.634976146579743
7,"Rheinland-Pfalz",7337024,"Eußerthal",890,435,455,0.48876404494382,897,437,460,0.487179487179487,0.0160321593522513,0.348991694068006,0.634976146579743
7,"Rheinland-Pfalz",7337025,"Flemlingen",405,205,200,0.506172839506173,398,198,200,0.49748743718593,0.0160321593522513,0.348991694068006,0.634976146579743
7,"Rheinland-Pfalz",7337026,"Frankweiler",893,436,457,0.488241881298992,911,451,460,0.495060373216246,0.0160321593522513,0.348991694068006,0.634976146579743
7,"Rheinland-Pfalz",7337027,"Freimersheim (Pfalz)",935,469,466,0.501604278074866,947,480,467,0.506863780359028,0.0160321593522513,0.348991694068006,0.634976146579743
7,"Rheinland-Pfalz",7337028,"Gleisweiler",601,286,315,0.475873544093178,594,292,302,0.491582491582492,0.0160321593522513,0.348991694068006,0.634976146579743
7,"Rheinland-Pfalz",7337029,"Gleiszellen-Gleishorbach",757,378,379,0.499339498018494,754,378,376,0.50132625994695,0.0160321593522513,0.348991694068006,0.634976146579743
7,"Rheinland-Pfalz",7337031,"Göcklingen",918,442,476,0.481481481481481,895,426,469,0.475977653631285,0.0160321593522513,0.348991694068006,0.634976146579743
7,"Rheinland-Pfalz",7337032,"Gommersheim",1471,727,744,0.494221617946975,1493,737,756,0.493636972538513,0.0160321593522513,0.348991694068006,0.634976146579743
7,"Rheinland-Pfalz",7337033,"Gossersweiler-Stein",1393,692,701,0.496769562096195,1409,712,697,0.505322924059617,0.0160321593522513,0.348991694068006,0.634976146579743
7,"Rheinland-Pfalz",7337035,"Großfischlingen",641,316,325,0.492979719188768,625,310,315,0.496,0.0160321593522513,0.348991694068006,0.634976146579743
7,"Rheinland-Pfalz",7337036,"Hainfeld",799,405,394,0.506883604505632,779,395,384,0.507060333761232,0.0160321593522513,0.348991694068006,0.634976146579743
7,"Rheinland-Pfalz",7337037,"Hergersweiler",214,111,103,0.518691588785047,233,122,111,0.523605150214592,0.0160321593522513,0.348991694068006,0.634976146579743
7,"Rheinland-Pfalz",7337038,"Herxheim bei Landau/ Pfalz",10282,4999,5283,0.486189457304026,10440,5097,5343,0.488218390804598,0.0160321593522513,0.348991694068006,0.634976146579743
7,"Rheinland-Pfalz",7337039,"Herxheimweyher",527,269,258,0.510436432637571,480,247,233,0.514583333333333,0.0160321593522513,0.348991694068006,0.634976146579743
7,"Rheinland-Pfalz",7337040,"Heuchelheim-Klingen",902,452,450,0.501108647450111,903,463,440,0.512735326688815,0.0160321593522513,0.348991694068006,0.634976146579743
7,"Rheinland-Pfalz",7337041,"Hochstadt (Pfalz)",2415,1174,1241,0.486128364389234,2455,1216,1239,0.495315682281059,0.0160321593522513,0.348991694068006,0.634976146579743
7,"Rheinland-Pfalz",7337042,"Ilbesheim bei Landau in der Pfalz",1184,589,595,0.497466216216216,1258,639,619,0.507949125596184,0.0160321593522513,0.348991694068006,0.634976146579743
7,"Rheinland-Pfalz",7337043,"Impflingen",821,417,404,0.507917174177832,819,422,397,0.515262515262515,0.0160321593522513,0.348991694068006,0.634976146579743
7,"Rheinland-Pfalz",7337044,"Insheim",2079,1004,1075,0.482924482924483,2077,1002,1075,0.482426576793452,0.0160321593522513,0.348991694068006,0.634976146579743
7,"Rheinland-Pfalz",7337045,"Kapellen-Drusweiler",968,479,489,0.494834710743802,921,456,465,0.495114006514658,0.0160321593522513,0.348991694068006,0.634976146579743
7,"Rheinland-Pfalz",7337046,"Kapsweyer",967,495,472,0.511892450879007,1020,527,493,0.516666666666667,0.0160321593522513,0.348991694068006,0.634976146579743
7,"Rheinland-Pfalz",7337047,"Kirrweiler (Pfalz)",2041,1042,999,0.510534051935326,2059,1056,1003,0.51287032540068,0.0160321593522513,0.348991694068006,0.634976146579743
7,"Rheinland-Pfalz",7337048,"Kleinfischlingen",256,128,128,0.5,259,125,134,0.482625482625483,0.0160321593522513,0.348991694068006,0.634976146579743
7,"Rheinland-Pfalz",7337049,"Klingenmünster",2199,1124,1075,0.511141427921783,2450,1342,1108,0.547755102040816,0.0160321593522513,0.348991694068006,0.634976146579743
7,"Rheinland-Pfalz",7337050,"Knöringen",475,246,229,0.517894736842105,469,243,226,0.518123667377399,0.0160321593522513,0.348991694068006,0.634976146579743
7,"Rheinland-Pfalz",7337051,"Leinsweiler",391,183,208,0.468030690537084,389,180,209,0.462724935732648,0.0160321593522513,0.348991694068006,0.634976146579743
7,"Rheinland-Pfalz",7337052,"Maikammer",4226,2060,2166,0.487458589682915,4195,2068,2127,0.492967818831943,0.0160321593522513,0.348991694068006,0.634976146579743
7,"Rheinland-Pfalz",7337054,"Münchweiler am Klingbach",210,111,99,0.528571428571429,204,110,94,0.53921568627451,0.0160321593522513,0.348991694068006,0.634976146579743
7,"Rheinland-Pfalz",7337055,"Niederhorbach",485,238,247,0.490721649484536,484,239,245,0.493801652892562,0.0160321593522513,0.348991694068006,0.634976146579743
7,"Rheinland-Pfalz",7337056,"Niederotterbach",327,162,165,0.495412844036697,315,153,162,0.485714285714286,0.0160321593522513,0.348991694068006,0.634976146579743
7,"Rheinland-Pfalz",7337058,"Oberhausen",480,245,235,0.510416666666667,385,195,190,0.506493506493506,0.0160321593522513,0.348991694068006,0.634976146579743
7,"Rheinland-Pfalz",7337059,"Oberotterbach",1168,572,596,0.48972602739726,1195,583,612,0.487866108786611,0.0160321593522513,0.348991694068006,0.634976146579743
7,"Rheinland-Pfalz",7337060,"Oberschlettenbach",142,67,75,0.471830985915493,139,64,75,0.460431654676259,0.0160321593522513,0.348991694068006,0.634976146579743
7,"Rheinland-Pfalz",7337061,"Offenbach an der Queich",6084,2992,3092,0.491781722550953,6155,3054,3101,0.496181965881397,0.0160321593522513,0.348991694068006,0.634976146579743
7,"Rheinland-Pfalz",7337062,"Pleisweiler-Oberhofen",816,403,413,0.493872549019608,808,393,415,0.486386138613861,0.0160321593522513,0.348991694068006,0.634976146579743
7,"Rheinland-Pfalz",7337064,"Ramberg",959,482,477,0.502606882168926,964,483,481,0.50103734439834,0.0160321593522513,0.348991694068006,0.634976146579743
7,"Rheinland-Pfalz",7337065,"Ranschbach",649,310,339,0.477657935285054,651,314,337,0.482334869431644,0.0160321593522513,0.348991694068006,0.634976146579743
7,"Rheinland-Pfalz",7337066,"Rhodt unter Rietburg",1115,543,572,0.486995515695067,1104,544,560,0.492753623188406,0.0160321593522513,0.348991694068006,0.634976146579743
7,"Rheinland-Pfalz",7337067,"Rinnthal",616,307,309,0.498376623376623,636,316,320,0.49685534591195,0.0160321593522513,0.348991694068006,0.634976146579743
7,"Rheinland-Pfalz",7337068,"Rohrbach",1575,788,787,0.50031746031746,1556,784,772,0.503856041131105,0.0160321593522513,0.348991694068006,0.634976146579743
7,"Rheinland-Pfalz",7337069,"Roschbach",842,404,438,0.479809976247031,841,397,444,0.47205707491082,0.0160321593522513,0.348991694068006,0.634976146579743
7,"Rheinland-Pfalz",7337070,"Sankt Martin",1784,877,907,0.491591928251121,1817,896,921,0.493120528343423,0.0160321593522513,0.348991694068006,0.634976146579743
7,"Rheinland-Pfalz",7337071,"Schweigen-Rechtenbach",1442,707,735,0.490291262135922,1449,717,732,0.494824016563147,0.0160321593522513,0.348991694068006,0.634976146579743
7,"Rheinland-Pfalz",7337072,"Schweighofen",575,285,290,0.495652173913044,568,285,283,0.501760563380282,0.0160321593522513,0.348991694068006,0.634976146579743
7,"Rheinland-Pfalz",7337073,"Siebeldingen",1028,510,518,0.496108949416342,1007,507,500,0.503475670307845,0.0160321593522513,0.348991694068006,0.634976146579743
7,"Rheinland-Pfalz",7337074,"Silz",801,393,408,0.49063670411985,829,396,433,0.477683956574186,0.0160321593522513,0.348991694068006,0.634976146579743
7,"Rheinland-Pfalz",7337076,"Steinfeld",1893,939,954,0.496038034865293,1892,923,969,0.48784355179704,0.0160321593522513,0.348991694068006,0.634976146579743
7,"Rheinland-Pfalz",7337077,"Venningen",925,474,451,0.512432432432432,935,477,458,0.510160427807487,0.0160321593522513,0.348991694068006,0.634976146579743
7,"Rheinland-Pfalz",7337078,"Völkersweiler",607,301,306,0.495881383855025,601,300,301,0.499168053244592,0.0160321593522513,0.348991694068006,0.634976146579743
7,"Rheinland-Pfalz",7337079,"Vorderweidenthal",642,323,319,0.503115264797508,635,316,319,0.497637795275591,0.0160321593522513,0.348991694068006,0.634976146579743
7,"Rheinland-Pfalz",7337080,"Waldhambach",362,180,182,0.497237569060773,354,177,177,0.5,0.0160321593522513,0.348991694068006,0.634976146579743
7,"Rheinland-Pfalz",7337081,"Waldrohrbach",381,184,197,0.482939632545932,387,189,198,0.488372093023256,0.0160321593522513,0.348991694068006,0.634976146579743
7,"Rheinland-Pfalz",7337082,"Walsheim",546,268,278,0.490842490842491,528,257,271,0.486742424242424,0.0160321593522513,0.348991694068006,0.634976146579743
7,"Rheinland-Pfalz",7337083,"Wernersberg",1109,542,567,0.488728584310189,1097,535,562,0.487693710118505,0.0160321593522513,0.348991694068006,0.634976146579743
7,"Rheinland-Pfalz",7337084,"Weyher in der Pfalz",550,265,285,0.481818181818182,488,231,257,0.473360655737705,0.0160321593522513,0.348991694068006,0.634976146579743
7,"Rheinland-Pfalz",7337501,"Annweiler am Trifels, Stadt",6994,3431,3563,0.490563340005719,6849,3396,3453,0.495838808585195,0.0160321593522513,0.348991694068006,0.634976146579743
7,"Rheinland-Pfalz",7338001,"Altrip",7638,3766,3872,0.493061010735795,7619,3747,3872,0.491796823730148,0.0160321593522513,0.348991694068006,0.634976146579743
7,"Rheinland-Pfalz",7338002,"Beindersheim",3089,1542,1547,0.499190676594367,3090,1534,1556,0.496440129449838,0.0160321593522513,0.348991694068006,0.634976146579743
7,"Rheinland-Pfalz",7338003,"Birkenheide",3095,1504,1591,0.4859450726979,3142,1525,1617,0.485359643539147,0.0160321593522513,0.348991694068006,0.634976146579743
7,"Rheinland-Pfalz",7338004,"Bobenheim-Roxheim",9852,4779,5073,0.485079171741778,9862,4807,5055,0.487426485499899,0.0160321593522513,0.348991694068006,0.634976146579743
7,"Rheinland-Pfalz",7338005,"Böhl-Iggelheim",10160,4953,5207,0.4875,10421,5086,5335,0.488052969964495,0.0160321593522513,0.348991694068006,0.634976146579743
7,"Rheinland-Pfalz",7338006,"Dannstadt-Schauernheim",6777,3329,3448,0.491220303969308,6910,3427,3483,0.495947901591896,0.0160321593522513,0.348991694068006,0.634976146579743
7,"Rheinland-Pfalz",7338007,"Dudenhofen",5732,2823,2909,0.492498255408234,5731,2831,2900,0.493980108183563,0.0160321593522513,0.348991694068006,0.634976146579743
7,"Rheinland-Pfalz",7338008,"Fußgönheim",2543,1236,1307,0.486040110106174,2526,1224,1302,0.484560570071259,0.0160321593522513,0.348991694068006,0.634976146579743
7,"Rheinland-Pfalz",7338009,"Großniedesheim",1260,632,628,0.501587301587302,1362,695,667,0.510279001468429,0.0160321593522513,0.348991694068006,0.634976146579743
7,"Rheinland-Pfalz",7338010,"Hanhofen",2438,1193,1245,0.489335520918786,2436,1188,1248,0.487684729064039,0.0160321593522513,0.348991694068006,0.634976146579743
7,"Rheinland-Pfalz",7338011,"Harthausen",3012,1511,1501,0.501660026560425,3038,1524,1514,0.50164581961817,0.0160321593522513,0.348991694068006,0.634976146579743
7,"Rheinland-Pfalz",7338012,"Heßheim",3015,1454,1561,0.482255389718076,2989,1447,1542,0.484108397457344,0.0160321593522513,0.348991694068006,0.634976146579743
7,"Rheinland-Pfalz",7338013,"Heuchelheim bei Frankenthal",1217,609,608,0.500410846343468,1255,636,619,0.506772908366534,0.0160321593522513,0.348991694068006,0.634976146579743
7,"Rheinland-Pfalz",7338014,"Hochdorf-Assenheim",3062,1549,1513,0.50587851077727,3103,1584,1519,0.510473735095069,0.0160321593522513,0.348991694068006,0.634976146579743
7,"Rheinland-Pfalz",7338015,"Kleinniedesheim",929,473,456,0.509149623250807,943,478,465,0.506892895015907,0.0160321593522513,0.348991694068006,0.634976146579743
7,"Rheinland-Pfalz",7338016,"Lambsheim",6481,3153,3328,0.486498997068354,6482,3155,3327,0.486732489972231,0.0160321593522513,0.348991694068006,0.634976146579743
7,"Rheinland-Pfalz",7338017,"Limburgerhof",10819,5119,5700,0.473149089564655,10840,5137,5703,0.473892988929889,0.0160321593522513,0.348991694068006,0.634976146579743
7,"Rheinland-Pfalz",7338018,"Maxdorf",7003,3402,3601,0.48579180351278,6956,3372,3584,0.484761357101783,0.0160321593522513,0.348991694068006,0.634976146579743
7,"Rheinland-Pfalz",7338019,"Mutterstadt",12431,5990,6441,0.481859866462875,12719,6188,6531,0.48651623555311,0.0160321593522513,0.348991694068006,0.634976146579743
7,"Rheinland-Pfalz",7338020,"Neuhofen",7014,3424,3590,0.488166524094668,7091,3507,3584,0.49457058242843,0.0160321593522513,0.348991694068006,0.634976146579743
7,"Rheinland-Pfalz",7338021,"Otterstadt",3319,1645,1674,0.495631214221151,3366,1685,1681,0.500594177064765,0.0160321593522513,0.348991694068006,0.634976146579743
7,"Rheinland-Pfalz",7338022,"Rödersheim-Gronau",2867,1391,1476,0.485176142309034,2843,1393,1450,0.489975378121702,0.0160321593522513,0.348991694068006,0.634976146579743
7,"Rheinland-Pfalz",7338023,"Römerberg",9400,4613,4787,0.490744680851064,9359,4588,4771,0.490223314456673,0.0160321593522513,0.348991694068006,0.634976146579743
7,"Rheinland-Pfalz",7338025,"Schifferstadt, Stadt",18852,9310,9542,0.493846806704859,19533,9675,9858,0.495315619720473,0.0160321593522513,0.348991694068006,0.634976146579743
7,"Rheinland-Pfalz",7338026,"Waldsee",5336,2622,2714,0.491379310344828,5396,2674,2722,0.495552260934025,0.0160321593522513,0.348991694068006,0.634976146579743
7,"Rheinland-Pfalz",7339001,"Appenheim",1417,698,719,0.492589978828511,1407,685,722,0.486851457000711,0.0160321593522513,0.348991694068006,0.634976146579743
7,"Rheinland-Pfalz",7339002,"Aspisheim",907,441,466,0.486218302094818,907,440,467,0.485115766262404,0.0160321593522513,0.348991694068006,0.634976146579743
7,"Rheinland-Pfalz",7339003,"Bacharach, Stadt",1914,940,974,0.491118077324974,1932,947,985,0.490165631469979,0.0160321593522513,0.348991694068006,0.634976146579743
7,"Rheinland-Pfalz",7339004,"Badenheim",589,280,309,0.475382003395586,583,280,303,0.480274442538593,0.0160321593522513,0.348991694068006,0.634976146579743
7,"Rheinland-Pfalz",7339005,"Bingen am Rhein, Stadt",23886,11675,12211,0.488780038516286,24413,11945,12468,0.489288493835252,0.0160321593522513,0.348991694068006,0.634976146579743
7,"Rheinland-Pfalz",7339006,"Bodenheim",7086,3445,3641,0.486169912503528,7103,3492,3611,0.491623257778403,0.0160321593522513,0.348991694068006,0.634976146579743
7,"Rheinland-Pfalz",7339007,"Breitscheid",128,69,59,0.5390625,114,59,55,0.517543859649123,0.0160321593522513,0.348991694068006,0.634976146579743
7,"Rheinland-Pfalz",7339008,"Bubenheim",874,444,430,0.508009153318078,851,434,417,0.509988249118684,0.0160321593522513,0.348991694068006,0.634976146579743
7,"Rheinland-Pfalz",7339009,"Budenheim",8334,4061,4273,0.487281017518599,8529,4204,4325,0.492906554109509,0.0160321593522513,0.348991694068006,0.634976146579743
7,"Rheinland-Pfalz",7339010,"Dalheim",1020,501,519,0.491176470588235,1030,506,524,0.49126213592233,0.0160321593522513,0.348991694068006,0.634976146579743
7,"Rheinland-Pfalz",7339011,"Dexheim",1426,702,724,0.492286115007013,1574,769,805,0.48856416772554,0.0160321593522513,0.348991694068006,0.634976146579743
7,"Rheinland-Pfalz",7339012,"Dienheim",2153,1090,1063,0.506270320483047,2161,1091,1070,0.504858861638131,0.0160321593522513,0.348991694068006,0.634976146579743
7,"Rheinland-Pfalz",7339013,"Dolgesheim",905,451,454,0.498342541436464,917,455,462,0.49618320610687,0.0160321593522513,0.348991694068006,0.634976146579743
7,"Rheinland-Pfalz",7339015,"Eimsheim",524,249,275,0.475190839694656,552,274,278,0.496376811594203,0.0160321593522513,0.348991694068006,0.634976146579743
7,"Rheinland-Pfalz",7339016,"Engelstadt",735,350,385,0.476190476190476,749,350,399,0.467289719626168,0.0160321593522513,0.348991694068006,0.634976146579743
7,"Rheinland-Pfalz",7339017,"Essenheim",3405,1619,1786,0.475477239353891,3436,1653,1783,0.481082654249127,0.0160321593522513,0.348991694068006,0.634976146579743
7,"Rheinland-Pfalz",7339018,"Friesenheim",686,357,329,0.520408163265306,677,351,326,0.518463810930576,0.0160321593522513,0.348991694068006,0.634976146579743
7,"Rheinland-Pfalz",7339019,"Gau-Algesheim, Stadt",6640,3166,3474,0.476807228915663,6590,3155,3435,0.478755690440061,0.0160321593522513,0.348991694068006,0.634976146579743
7,"Rheinland-Pfalz",7339020,"Gau-Bischofsheim",1843,889,954,0.482365708084645,1851,896,955,0.484062668827661,0.0160321593522513,0.348991694068006,0.634976146579743
7,"Rheinland-Pfalz",7339021,"Gensingen",3728,1809,1919,0.48524678111588,3734,1819,1915,0.487145152651312,0.0160321593522513,0.348991694068006,0.634976146579743
7,"Rheinland-Pfalz",7339022,"Grolsheim",1232,640,592,0.519480519480519,1263,660,603,0.522565320665083,0.0160321593522513,0.348991694068006,0.634976146579743
7,"Rheinland-Pfalz",7339024,"Guntersblum",3718,1814,1904,0.487896718665949,3696,1805,1891,0.488365800865801,0.0160321593522513,0.348991694068006,0.634976146579743
7,"Rheinland-Pfalz",7339025,"Hahnheim",1577,771,806,0.488902980342422,1567,777,790,0.495851946394384,0.0160321593522513,0.348991694068006,0.634976146579743
7,"Rheinland-Pfalz",7339026,"Harxheim",2151,1074,1077,0.499302649930265,2189,1113,1076,0.508451347647328,0.0160321593522513,0.348991694068006,0.634976146579743
7,"Rheinland-Pfalz",7339027,"Heidesheim am Rhein",7215,3580,3635,0.496188496188496,7282,3596,3686,0.493820379016754,0.0160321593522513,0.348991694068006,0.634976146579743
7,"Rheinland-Pfalz",7339028,"Hillesheim",610,309,301,0.50655737704918,587,297,290,0.505962521294719,0.0160321593522513,0.348991694068006,0.634976146579743
7,"Rheinland-Pfalz",7339029,"Horrweiler",706,342,364,0.484419263456091,734,359,375,0.489100817438692,0.0160321593522513,0.348991694068006,0.634976146579743
7,"Rheinland-Pfalz",7339030,"Ingelheim am Rhein, Stadt",24025,11706,12319,0.487242455775234,24341,11932,12409,0.490201717267162,0.0160321593522513,0.348991694068006,0.634976146579743
7,"Rheinland-Pfalz",7339031,"Jugenheim in Rheinhessen",1573,786,787,0.499682136045772,1615,811,804,0.502167182662539,0.0160321593522513,0.348991694068006,0.634976146579743
7,"Rheinland-Pfalz",7339032,"Klein-Winternheim",3487,1749,1738,0.501577287066246,3546,1757,1789,0.495487873660462,0.0160321593522513,0.348991694068006,0.634976146579743
7,"Rheinland-Pfalz",7339033,"Köngernheim",1386,674,712,0.486291486291486,1380,681,699,0.493478260869565,0.0160321593522513,0.348991694068006,0.634976146579743
7,"Rheinland-Pfalz",7339034,"Lörzweiler",2140,1061,1079,0.495794392523364,2155,1071,1084,0.496983758700696,0.0160321593522513,0.348991694068006,0.634976146579743
7,"Rheinland-Pfalz",7339035,"Ludwigshöhe",547,269,278,0.491773308957952,540,260,280,0.481481481481481,0.0160321593522513,0.348991694068006,0.634976146579743
7,"Rheinland-Pfalz",7339036,"Manubach",322,159,163,0.493788819875776,313,155,158,0.495207667731629,0.0160321593522513,0.348991694068006,0.634976146579743
7,"Rheinland-Pfalz",7339037,"Mommenheim",3059,1501,1558,0.490683229813665,3050,1482,1568,0.485901639344262,0.0160321593522513,0.348991694068006,0.634976146579743
7,"Rheinland-Pfalz",7339038,"Münster-Sarmsheim",2863,1393,1470,0.486552567237164,2856,1408,1448,0.492997198879552,0.0160321593522513,0.348991694068006,0.634976146579743
7,"Rheinland-Pfalz",7339039,"Nackenheim",5564,2756,2808,0.495327102803738,5559,2759,2800,0.496312286382443,0.0160321593522513,0.348991694068006,0.634976146579743
7,"Rheinland-Pfalz",7339040,"Niederheimbach",758,364,394,0.480211081794195,765,363,402,0.474509803921569,0.0160321593522513,0.348991694068006,0.634976146579743
7,"Rheinland-Pfalz",7339041,"Nieder-Hilbersheim",626,318,308,0.507987220447284,630,321,309,0.509523809523809,0.0160321593522513,0.348991694068006,0.634976146579743
7,"Rheinland-Pfalz",7339042,"Nieder-Olm, Stadt",9214,4420,4794,0.47970479704797,9060,4358,4702,0.481015452538631,0.0160321593522513,0.348991694068006,0.634976146579743
7,"Rheinland-Pfalz",7339043,"Nierstein",7877,3814,4063,0.484194490288181,7908,3863,4045,0.488492665655033,0.0160321593522513,0.348991694068006,0.634976146579743
7,"Rheinland-Pfalz",7339044,"Oberdiebach",866,432,434,0.498845265588915,852,426,426,0.5,0.0160321593522513,0.348991694068006,0.634976146579743
7,"Rheinland-Pfalz",7339045,"Oberheimbach",576,284,292,0.493055555555556,602,304,298,0.504983388704319,0.0160321593522513,0.348991694068006,0.634976146579743
7,"Rheinland-Pfalz",7339046,"Ober-Hilbersheim",1019,513,506,0.503434739941119,1026,516,510,0.502923976608187,0.0160321593522513,0.348991694068006,0.634976146579743
7,"Rheinland-Pfalz",7339047,"Ober-Olm",4158,2060,2098,0.495430495430495,4355,2125,2230,0.487944890929966,0.0160321593522513,0.348991694068006,0.634976146579743
7,"Rheinland-Pfalz",7339048,"Ockenheim",2499,1242,1257,0.496998799519808,2501,1260,1241,0.503798480607757,0.0160321593522513,0.348991694068006,0.634976146579743
7,"Rheinland-Pfalz",7339049,"Oppenheim, Stadt",7022,3326,3696,0.473654229564227,7054,3352,3702,0.475191380776864,0.0160321593522513,0.348991694068006,0.634976146579743
7,"Rheinland-Pfalz",7339050,"Sankt Johann",843,424,419,0.502965599051008,828,416,412,0.502415458937198,0.0160321593522513,0.348991694068006,0.634976146579743
7,"Rheinland-Pfalz",7339051,"Schwabenheim an der Selz",2568,1285,1283,0.500389408099688,2593,1298,1295,0.500578480524489,0.0160321593522513,0.348991694068006,0.634976146579743
7,"Rheinland-Pfalz",7339053,"Selzen",1544,780,764,0.505181347150259,1541,770,771,0.499675535366645,0.0160321593522513,0.348991694068006,0.634976146579743
7,"Rheinland-Pfalz",7339054,"Sörgenloch",1169,593,576,0.507271171941831,1168,597,571,0.511130136986301,0.0160321593522513,0.348991694068006,0.634976146579743
7,"Rheinland-Pfalz",7339056,"Sprendlingen",4079,2027,2052,0.496935523412601,4066,2022,2044,0.497294638465322,0.0160321593522513,0.348991694068006,0.634976146579743
7,"Rheinland-Pfalz",7339057,"Stadecken-Elsheim",4574,2235,2339,0.488631394840402,4613,2245,2368,0.486668111857793,0.0160321593522513,0.348991694068006,0.634976146579743
7,"Rheinland-Pfalz",7339058,"Trechtingshausen",995,488,507,0.490452261306533,975,474,501,0.486153846153846,0.0160321593522513,0.348991694068006,0.634976146579743
7,"Rheinland-Pfalz",7339059,"Uelversheim",1093,549,544,0.502287282708143,1094,548,546,0.50091407678245,0.0160321593522513,0.348991694068006,0.634976146579743
7,"Rheinland-Pfalz",7339060,"Undenheim",2699,1306,1393,0.483882919599852,2708,1314,1394,0.485228951255539,0.0160321593522513,0.348991694068006,0.634976146579743
7,"Rheinland-Pfalz",7339061,"Wackernheim",2539,1270,1269,0.50019692792438,2599,1299,1300,0.499807618314736,0.0160321593522513,0.348991694068006,0.634976146579743
7,"Rheinland-Pfalz",7339062,"Waldalgesheim",4021,1951,2070,0.48520268589903,4055,1972,2083,0.486313193588163,0.0160321593522513,0.348991694068006,0.634976146579743
7,"Rheinland-Pfalz",7339063,"Weiler bei Bingen",2554,1227,1327,0.480422866092404,2566,1251,1315,0.487529228371005,0.0160321593522513,0.348991694068006,0.634976146579743
7,"Rheinland-Pfalz",7339064,"Weinolsheim",733,383,350,0.522510231923602,708,373,335,0.52683615819209,0.0160321593522513,0.348991694068006,0.634976146579743
7,"Rheinland-Pfalz",7339065,"Welgesheim",593,300,293,0.505902192242833,601,306,295,0.509151414309484,0.0160321593522513,0.348991694068006,0.634976146579743
7,"Rheinland-Pfalz",7339066,"Wintersheim",317,153,164,0.482649842271293,304,146,158,0.480263157894737,0.0160321593522513,0.348991694068006,0.634976146579743
7,"Rheinland-Pfalz",7339067,"Zornheim",3674,1811,1863,0.49292324442025,3665,1800,1865,0.491132332878581,0.0160321593522513,0.348991694068006,0.634976146579743
7,"Rheinland-Pfalz",7339068,"Zotzenheim",628,320,308,0.509554140127389,633,324,309,0.511848341232227,0.0160321593522513,0.348991694068006,0.634976146579743
7,"Rheinland-Pfalz",7339201,"Dorn-Dürkheim",925,454,471,0.490810810810811,905,454,451,0.501657458563536,0.0160321593522513,0.348991694068006,0.634976146579743
7,"Rheinland-Pfalz",7339202,"Wolfsheim",726,357,369,0.491735537190083,734,359,375,0.489100817438692,0.0160321593522513,0.348991694068006,0.634976146579743
7,"Rheinland-Pfalz",7340001,"Bobenthal",318,165,153,0.518867924528302,328,177,151,0.539634146341463,0.0160321593522513,0.348991694068006,0.634976146579743
7,"Rheinland-Pfalz",7340002,"Busenberg",1291,650,641,0.503485670023238,1293,657,636,0.508120649651972,0.0160321593522513,0.348991694068006,0.634976146579743
7,"Rheinland-Pfalz",7340003,"Clausen",1397,675,722,0.483178239083751,1470,710,760,0.482993197278912,0.0160321593522513,0.348991694068006,0.634976146579743
7,"Rheinland-Pfalz",7340004,"Dahn, Stadt",4432,2127,2305,0.479918772563177,4457,2172,2285,0.487323311644604,0.0160321593522513,0.348991694068006,0.634976146579743
7,"Rheinland-Pfalz",7340005,"Darstein",214,109,105,0.509345794392523,217,112,105,0.516129032258065,0.0160321593522513,0.348991694068006,0.634976146579743
7,"Rheinland-Pfalz",7340006,"Dimbach",170,83,87,0.488235294117647,168,85,83,0.505952380952381,0.0160321593522513,0.348991694068006,0.634976146579743
7,"Rheinland-Pfalz",7340007,"Donsieders",997,490,507,0.491474423269809,1001,499,502,0.498501498501498,0.0160321593522513,0.348991694068006,0.634976146579743
7,"Rheinland-Pfalz",7340008,"Eppenbrunn",1404,691,713,0.492165242165242,1382,672,710,0.486251808972504,0.0160321593522513,0.348991694068006,0.634976146579743
7,"Rheinland-Pfalz",7340009,"Erfweiler",1190,619,571,0.520168067226891,1182,607,575,0.513536379018612,0.0160321593522513,0.348991694068006,0.634976146579743
7,"Rheinland-Pfalz",7340010,"Erlenbach bei Dahn",332,163,169,0.490963855421687,342,171,171,0.5,0.0160321593522513,0.348991694068006,0.634976146579743
7,"Rheinland-Pfalz",7340011,"Fischbach bei Dahn",1603,757,846,0.472239550842171,1577,759,818,0.481293595434369,0.0160321593522513,0.348991694068006,0.634976146579743
7,"Rheinland-Pfalz",7340012,"Geiselberg",856,415,441,0.48481308411215,875,430,445,0.491428571428571,0.0160321593522513,0.348991694068006,0.634976146579743
7,"Rheinland-Pfalz",7340014,"Hauenstein",4009,1940,2069,0.483911199800449,4006,1964,2042,0.490264603095357,0.0160321593522513,0.348991694068006,0.634976146579743
7,"Rheinland-Pfalz",7340015,"Heltersberg",2101,1029,1072,0.489766777724893,2101,1046,1055,0.497858162779629,0.0160321593522513,0.348991694068006,0.634976146579743
7,"Rheinland-Pfalz",7340016,"Hermersberg",1697,855,842,0.503830288744844,1727,859,868,0.497394325419803,0.0160321593522513,0.348991694068006,0.634976146579743
7,"Rheinland-Pfalz",7340017,"Herschberg",841,427,414,0.507728894173603,859,451,408,0.525029103608847,0.0160321593522513,0.348991694068006,0.634976146579743
7,"Rheinland-Pfalz",7340018,"Hettenhausen",255,132,123,0.517647058823529,246,124,122,0.504065040650406,0.0160321593522513,0.348991694068006,0.634976146579743
7,"Rheinland-Pfalz",7340019,"Hilst",346,164,182,0.473988439306358,353,169,184,0.478753541076487,0.0160321593522513,0.348991694068006,0.634976146579743
7,"Rheinland-Pfalz",7340020,"Hinterweidenthal",1563,766,797,0.490083173384517,1607,799,808,0.497199751088986,0.0160321593522513,0.348991694068006,0.634976146579743
7,"Rheinland-Pfalz",7340021,"Hirschthal",98,49,49,0.5,102,52,50,0.509803921568627,0.0160321593522513,0.348991694068006,0.634976146579743
7,"Rheinland-Pfalz",7340022,"Höheinöd",1243,611,632,0.491552695092518,1198,587,611,0.489983305509182,0.0160321593522513,0.348991694068006,0.634976146579743
7,"Rheinland-Pfalz",7340023,"Höheischweiler",900,453,447,0.503333333333333,925,470,455,0.508108108108108,0.0160321593522513,0.348991694068006,0.634976146579743
7,"Rheinland-Pfalz",7340024,"Höhfröschen",876,447,429,0.51027397260274,882,453,429,0.513605442176871,0.0160321593522513,0.348991694068006,0.634976146579743
7,"Rheinland-Pfalz",7340025,"Horbach",539,271,268,0.50278293135436,537,270,267,0.502793296089385,0.0160321593522513,0.348991694068006,0.634976146579743
7,"Rheinland-Pfalz",7340026,"Kröppen",732,356,376,0.486338797814208,737,353,384,0.478968792401628,0.0160321593522513,0.348991694068006,0.634976146579743
7,"Rheinland-Pfalz",7340027,"Leimen",1000,508,492,0.508,937,474,463,0.505869797225187,0.0160321593522513,0.348991694068006,0.634976146579743
7,"Rheinland-Pfalz",7340028,"Lemberg",3915,1895,2020,0.484035759897829,3901,1907,1994,0.488849013073571,0.0160321593522513,0.348991694068006,0.634976146579743
7,"Rheinland-Pfalz",7340029,"Ludwigswinkel",780,394,386,0.505128205128205,807,418,389,0.517967781908302,0.0160321593522513,0.348991694068006,0.634976146579743
7,"Rheinland-Pfalz",7340030,"Lug",615,301,314,0.489430894308943,604,290,314,0.480132450331126,0.0160321593522513,0.348991694068006,0.634976146579743
7,"Rheinland-Pfalz",7340031,"Merzalben",1209,581,628,0.480562448304384,1182,560,622,0.473773265651438,0.0160321593522513,0.348991694068006,0.634976146579743
7,"Rheinland-Pfalz",7340032,"Münchweiler an der Rodalb",2897,1405,1492,0.484984466689679,2935,1447,1488,0.493015332197615,0.0160321593522513,0.348991694068006,0.634976146579743
7,"Rheinland-Pfalz",7340033,"Niederschlettenbach",322,165,157,0.512422360248447,314,160,154,0.509554140127389,0.0160321593522513,0.348991694068006,0.634976146579743
7,"Rheinland-Pfalz",7340034,"Nothweiler",137,70,67,0.510948905109489,151,80,71,0.529801324503311,0.0160321593522513,0.348991694068006,0.634976146579743
7,"Rheinland-Pfalz",7340035,"Nünschweiler",748,360,388,0.481283422459893,743,361,382,0.485868102288022,0.0160321593522513,0.348991694068006,0.634976146579743
7,"Rheinland-Pfalz",7340036,"Obersimten",634,311,323,0.490536277602524,626,310,316,0.495207667731629,0.0160321593522513,0.348991694068006,0.634976146579743
7,"Rheinland-Pfalz",7340037,"Petersberg",878,409,469,0.465831435079727,874,405,469,0.463386727688787,0.0160321593522513,0.348991694068006,0.634976146579743
7,"Rheinland-Pfalz",7340038,"Rodalben, Stadt",7135,3530,3605,0.494744218640505,7147,3543,3604,0.495732475164405,0.0160321593522513,0.348991694068006,0.634976146579743
7,"Rheinland-Pfalz",7340039,"Rumbach",459,235,224,0.5119825708061,452,232,220,0.513274336283186,0.0160321593522513,0.348991694068006,0.634976146579743
7,"Rheinland-Pfalz",7340040,"Ruppertsweiler",1446,720,726,0.49792531120332,1422,716,706,0.50351617440225,0.0160321593522513,0.348991694068006,0.634976146579743
7,"Rheinland-Pfalz",7340041,"Saalstadt",312,149,163,0.477564102564103,321,155,166,0.482866043613707,0.0160321593522513,0.348991694068006,0.634976146579743
7,"Rheinland-Pfalz",7340042,"Schauerberg",193,93,100,0.481865284974093,193,95,98,0.492227979274611,0.0160321593522513,0.348991694068006,0.634976146579743
7,"Rheinland-Pfalz",7340043,"Schindhard",580,299,281,0.51551724137931,580,307,273,0.529310344827586,0.0160321593522513,0.348991694068006,0.634976146579743
7,"Rheinland-Pfalz",7340044,"Schmalenberg",775,376,399,0.485161290322581,748,364,384,0.486631016042781,0.0160321593522513,0.348991694068006,0.634976146579743
7,"Rheinland-Pfalz",7340045,"Schönau (Pfalz)",408,195,213,0.477941176470588,422,207,215,0.490521327014218,0.0160321593522513,0.348991694068006,0.634976146579743
7,"Rheinland-Pfalz",7340047,"Schwanheim",588,307,281,0.522108843537415,578,305,273,0.527681660899654,0.0160321593522513,0.348991694068006,0.634976146579743
7,"Rheinland-Pfalz",7340048,"Schweix",348,174,174,0.5,344,173,171,0.502906976744186,0.0160321593522513,0.348991694068006,0.634976146579743
7,"Rheinland-Pfalz",7340049,"Spirkelbach",691,330,361,0.477568740955137,681,332,349,0.487518355359765,0.0160321593522513,0.348991694068006,0.634976146579743
7,"Rheinland-Pfalz",7340050,"Steinalben",430,214,216,0.497674418604651,428,216,212,0.504672897196262,0.0160321593522513,0.348991694068006,0.634976146579743
7,"Rheinland-Pfalz",7340051,"Thaleischweiler-Fröschen",3432,1624,1808,0.473193473193473,3415,1661,1754,0.486383601756955,0.0160321593522513,0.348991694068006,0.634976146579743
7,"Rheinland-Pfalz",7340052,"Trulben",1301,628,673,0.482705611068409,1297,625,672,0.481881264456438,0.0160321593522513,0.348991694068006,0.634976146579743
7,"Rheinland-Pfalz",7340053,"Vinningen",1693,836,857,0.493797991730656,1667,825,842,0.494901019796041,0.0160321593522513,0.348991694068006,0.634976146579743
7,"Rheinland-Pfalz",7340054,"Waldfischbach-Burgalben",4888,2381,2507,0.487111292962357,4835,2382,2453,0.492657704239917,0.0160321593522513,0.348991694068006,0.634976146579743
7,"Rheinland-Pfalz",7340055,"Weselberg",1345,679,666,0.504832713754647,1329,676,653,0.508653122648608,0.0160321593522513,0.348991694068006,0.634976146579743
7,"Rheinland-Pfalz",7340057,"Wilgartswiesen",1015,512,503,0.504433497536946,1060,530,530,0.5,0.0160321593522513,0.348991694068006,0.634976146579743
7,"Rheinland-Pfalz",7340201,"Althornbach",750,370,380,0.493333333333333,714,358,356,0.50140056022409,0.0160321593522513,0.348991694068006,0.634976146579743
7,"Rheinland-Pfalz",7340202,"Battweiler",719,370,349,0.514603616133519,715,366,349,0.511888111888112,0.0160321593522513,0.348991694068006,0.634976146579743
7,"Rheinland-Pfalz",7340203,"Bechhofen",2180,1054,1126,0.48348623853211,2141,1035,1106,0.483418963101355,0.0160321593522513,0.348991694068006,0.634976146579743
7,"Rheinland-Pfalz",7340204,"Biedershausen",218,114,104,0.522935779816514,272,156,116,0.573529411764706,0.0160321593522513,0.348991694068006,0.634976146579743
7,"Rheinland-Pfalz",7340205,"Bottenbach",736,371,365,0.504076086956522,728,372,356,0.510989010989011,0.0160321593522513,0.348991694068006,0.634976146579743
7,"Rheinland-Pfalz",7340206,"Contwig",4846,2392,2454,0.493602971522905,4865,2411,2454,0.495580678314491,0.0160321593522513,0.348991694068006,0.634976146579743
7,"Rheinland-Pfalz",7340207,"Dellfeld",1385,702,683,0.506859205776173,1394,709,685,0.508608321377331,0.0160321593522513,0.348991694068006,0.634976146579743
7,"Rheinland-Pfalz",7340208,"Dietrichingen",364,176,188,0.483516483516484,387,184,203,0.475452196382429,0.0160321593522513,0.348991694068006,0.634976146579743
7,"Rheinland-Pfalz",7340209,"Großbundenbach",363,189,174,0.520661157024793,373,198,175,0.53083109919571,0.0160321593522513,0.348991694068006,0.634976146579743
7,"Rheinland-Pfalz",7340210,"Großsteinhausen",613,304,309,0.495921696574225,601,300,301,0.499168053244592,0.0160321593522513,0.348991694068006,0.634976146579743
7,"Rheinland-Pfalz",7340211,"Hornbach, Stadt",1491,737,754,0.494299128101945,1563,792,771,0.506717850287908,0.0160321593522513,0.348991694068006,0.634976146579743
7,"Rheinland-Pfalz",7340212,"Käshofen",681,342,339,0.502202643171806,697,346,351,0.496413199426112,0.0160321593522513,0.348991694068006,0.634976146579743
7,"Rheinland-Pfalz",7340213,"Kleinbundenbach",424,211,213,0.497641509433962,414,203,211,0.490338164251208,0.0160321593522513,0.348991694068006,0.634976146579743
7,"Rheinland-Pfalz",7340214,"Kleinsteinhausen",775,377,398,0.486451612903226,795,398,397,0.50062893081761,0.0160321593522513,0.348991694068006,0.634976146579743
7,"Rheinland-Pfalz",7340215,"Knopp-Labach",427,217,210,0.508196721311475,447,231,216,0.516778523489933,0.0160321593522513,0.348991694068006,0.634976146579743
7,"Rheinland-Pfalz",7340216,"Krähenberg",148,74,74,0.5,143,73,70,0.510489510489511,0.0160321593522513,0.348991694068006,0.634976146579743
7,"Rheinland-Pfalz",7340217,"Maßweiler",1052,526,526,0.5,1057,522,535,0.493850520340587,0.0160321593522513,0.348991694068006,0.634976146579743
7,"Rheinland-Pfalz",7340218,"Mauschbach",304,148,156,0.486842105263158,300,144,156,0.48,0.0160321593522513,0.348991694068006,0.634976146579743
7,"Rheinland-Pfalz",7340219,"Obernheim-Kirchenarnbach",1762,901,861,0.511350737797957,1748,882,866,0.504576659038902,0.0160321593522513,0.348991694068006,0.634976146579743
7,"Rheinland-Pfalz",7340220,"Reifenberg",820,411,409,0.501219512195122,817,409,408,0.500611995104039,0.0160321593522513,0.348991694068006,0.634976146579743
7,"Rheinland-Pfalz",7340221,"Riedelberg",479,230,249,0.480167014613779,481,237,244,0.492723492723493,0.0160321593522513,0.348991694068006,0.634976146579743
7,"Rheinland-Pfalz",7340222,"Rieschweiler-Mühlbach",2160,1093,1067,0.506018518518519,2214,1116,1098,0.504065040650406,0.0160321593522513,0.348991694068006,0.634976146579743
7,"Rheinland-Pfalz",7340223,"Rosenkopf",380,187,193,0.492105263157895,374,184,190,0.491978609625668,0.0160321593522513,0.348991694068006,0.634976146579743
7,"Rheinland-Pfalz",7340224,"Schmitshausen",410,206,204,0.502439024390244,402,200,202,0.497512437810945,0.0160321593522513,0.348991694068006,0.634976146579743
7,"Rheinland-Pfalz",7340225,"Wallhalben",853,435,418,0.509964830011723,798,408,390,0.511278195488722,0.0160321593522513,0.348991694068006,0.634976146579743
7,"Rheinland-Pfalz",7340226,"Walshausen",328,160,168,0.48780487804878,338,165,173,0.488165680473373,0.0160321593522513,0.348991694068006,0.634976146579743
7,"Rheinland-Pfalz",7340227,"Wiesbach",547,275,272,0.502742230347349,533,264,269,0.4953095684803,0.0160321593522513,0.348991694068006,0.634976146579743
7,"Rheinland-Pfalz",7340228,"Winterbach (Pfalz)",511,253,258,0.495107632093933,501,249,252,0.497005988023952,0.0160321593522513,0.348991694068006,0.634976146579743
7,"Rheinland-Pfalz",7340501,"Bruchweiler-Bärenbach",1576,784,792,0.49746192893401,1594,785,809,0.492471769134253,0.0160321593522513,0.348991694068006,0.634976146579743
7,"Rheinland-Pfalz",7340502,"Bundenthal",1128,559,569,0.495567375886525,1143,567,576,0.496062992125984,0.0160321593522513,0.348991694068006,0.634976146579743
8,"Baden-Württemberg",8111000,"Stuttgart, Landeshauptstadt",591015,290117,300898,0.490879250103635,613392,305347,308045,0.497800753840937,0.00659711656054247,0.3901600188325,0.603242864606958
8,"Baden-Württemberg",8115001,"Aidlingen",8773,4302,4471,0.49036817508264,9058,4478,4580,0.494369618017222,0.00659711656054247,0.3901600188325,0.603242864606958
8,"Baden-Württemberg",8115002,"Altdorf",4524,2245,2279,0.496242263483643,4527,2235,2292,0.493704440026508,0.00659711656054247,0.3901600188325,0.603242864606958
8,"Baden-Württemberg",8115003,"Böblingen, Stadt",45167,21846,23321,0.483671707219873,46890,23031,23859,0.491170825335893,0.00659711656054247,0.3901600188325,0.603242864606958
8,"Baden-Württemberg",8115004,"Bondorf",5721,2848,2873,0.497815067295927,5885,2932,2953,0.4982158028887,0.00659711656054247,0.3901600188325,0.603242864606958
8,"Baden-Württemberg",8115010,"Deckenpfronn",3216,1567,1649,0.487251243781095,3208,1576,1632,0.491271820448878,0.00659711656054247,0.3901600188325,0.603242864606958
8,"Baden-Württemberg",8115013,"Ehningen",7805,3871,3934,0.495964125560538,7897,3949,3948,0.500063315182981,0.00659711656054247,0.3901600188325,0.603242864606958
8,"Baden-Württemberg",8115015,"Gärtringen",11577,5627,5950,0.486049926578561,12242,5983,6259,0.488727332135272,0.00659711656054247,0.3901600188325,0.603242864606958
8,"Baden-Württemberg",8115016,"Gäufelden",9053,4501,4552,0.497183254169888,9262,4648,4614,0.501835456704815,0.00659711656054247,0.3901600188325,0.603242864606958
8,"Baden-Württemberg",8115021,"Herrenberg, Stadt",29935,14599,15336,0.487689994989143,31249,15412,15837,0.493199782393037,0.00659711656054247,0.3901600188325,0.603242864606958
8,"Baden-Württemberg",8115022,"Hildrizhausen",3530,1770,1760,0.501416430594901,3593,1817,1776,0.505705538547175,0.00659711656054247,0.3901600188325,0.603242864606958
8,"Baden-Württemberg",8115024,"Holzgerlingen, Stadt",12180,5958,6222,0.489162561576355,12728,6275,6453,0.493007542426147,0.00659711656054247,0.3901600188325,0.603242864606958
8,"Baden-Württemberg",8115028,"Leonberg, Stadt",44749,21944,22805,0.490379673288789,45333,22307,23026,0.492069794630843,0.00659711656054247,0.3901600188325,0.603242864606958
8,"Baden-Württemberg",8115029,"Magstadt",8896,4484,4412,0.504046762589928,8889,4452,4437,0.500843739453257,0.00659711656054247,0.3901600188325,0.603242864606958
8,"Baden-Württemberg",8115034,"Mötzingen",3605,1765,1840,0.489597780859917,3662,1802,1860,0.49208083014746,0.00659711656054247,0.3901600188325,0.603242864606958
8,"Baden-Württemberg",8115037,"Nufringen",5396,2705,2691,0.501297257227576,5418,2706,2712,0.499446290143965,0.00659711656054247,0.3901600188325,0.603242864606958
8,"Baden-Württemberg",8115041,"Renningen, Stadt",16758,8270,8488,0.493495643871584,17365,8569,8796,0.493463864094443,0.00659711656054247,0.3901600188325,0.603242864606958
8,"Baden-Württemberg",8115042,"Rutesheim, Stadt",9822,4833,4989,0.492058643860721,10323,5120,5203,0.49597985081856,0.00659711656054247,0.3901600188325,0.603242864606958
8,"Baden-Württemberg",8115044,"Schönaich",9700,4817,4883,0.49659793814433,9733,4849,4884,0.498201993218946,0.00659711656054247,0.3901600188325,0.603242864606958
8,"Baden-Württemberg",8115045,"Sindelfingen, Stadt",60452,29843,30609,0.493664394891815,60287,29880,30407,0.495629240134689,0.00659711656054247,0.3901600188325,0.603242864606958
8,"Baden-Württemberg",8115046,"Steinenbronn",5995,2992,3003,0.499082568807339,6085,3087,2998,0.507313064913722,0.00659711656054247,0.3901600188325,0.603242864606958
8,"Baden-Württemberg",8115048,"Waldenbuch, Stadt",8426,4145,4281,0.491929741277,8559,4206,4353,0.491412548194883,0.00659711656054247,0.3901600188325,0.603242864606958
8,"Baden-Württemberg",8115050,"Weil der Stadt, Stadt",18260,8961,9299,0.490744797371303,18866,9397,9469,0.498091805364147,0.00659711656054247,0.3901600188325,0.603242864606958
8,"Baden-Württemberg",8115051,"Weil im Schönbuch",9688,4757,4931,0.491019818331957,9810,4842,4968,0.493577981651376,0.00659711656054247,0.3901600188325,0.603242864606958
8,"Baden-Württemberg",8115052,"Weissach",7387,3651,3736,0.494246649519426,7451,3725,3726,0.499932894913434,0.00659711656054247,0.3901600188325,0.603242864606958
8,"Baden-Württemberg",8115053,"Jettingen",7450,3662,3788,0.491543624161074,7492,3689,3803,0.492391884676989,0.00659711656054247,0.3901600188325,0.603242864606958
8,"Baden-Württemberg",8115054,"Grafenau",6393,3195,3198,0.499765368371657,6522,3289,3233,0.504293161606869,0.00659711656054247,0.3901600188325,0.603242864606958
8,"Baden-Württemberg",8116004,"Altbach",5827,2883,2944,0.494765745666724,5900,2926,2974,0.495932203389831,0.00659711656054247,0.3901600188325,0.603242864606958
8,"Baden-Württemberg",8116005,"Altdorf",1475,749,726,0.507796610169492,1477,760,717,0.51455653351388,0.00659711656054247,0.3901600188325,0.603242864606958
8,"Baden-Württemberg",8116006,"Altenriet",1904,952,952,0.5,1904,948,956,0.497899159663866,0.00659711656054247,0.3901600188325,0.603242864606958
8,"Baden-Württemberg",8116007,"Baltmannsweiler",5608,2726,2882,0.486091298145506,5573,2728,2845,0.489502960703391,0.00659711656054247,0.3901600188325,0.603242864606958
8,"Baden-Württemberg",8116008,"Bempflingen",3372,1673,1699,0.496144721233689,3322,1627,1695,0.489765201685732,0.00659711656054247,0.3901600188325,0.603242864606958
8,"Baden-Württemberg",8116011,"Beuren",3376,1641,1735,0.486078199052133,3376,1645,1731,0.487263033175355,0.00659711656054247,0.3901600188325,0.603242864606958
8,"Baden-Württemberg",8116012,"Bissingen an der Teck",3379,1704,1675,0.504291210417283,3489,1748,1741,0.501003152765836,0.00659711656054247,0.3901600188325,0.603242864606958
8,"Baden-Württemberg",8116014,"Deizisau",6512,3325,3187,0.510595823095823,6559,3361,3198,0.512425674645525,0.00659711656054247,0.3901600188325,0.603242864606958
8,"Baden-Württemberg",8116015,"Denkendorf",10276,5051,5225,0.491533670688984,10407,5150,5257,0.494859229364851,0.00659711656054247,0.3901600188325,0.603242864606958
8,"Baden-Württemberg",8116016,"Dettingen unter Teck",5775,2880,2895,0.498701298701299,5778,2893,2885,0.500692281066113,0.00659711656054247,0.3901600188325,0.603242864606958
8,"Baden-Württemberg",8116018,"Erkenbrechtsweiler",2048,1006,1042,0.4912109375,2056,1005,1051,0.488813229571984,0.00659711656054247,0.3901600188325,0.603242864606958
8,"Baden-Württemberg",8116019,"Esslingen am Neckar, Stadt",87519,42636,44883,0.487162787508998,92629,45596,47033,0.492243249954118,0.00659711656054247,0.3901600188325,0.603242864606958
8,"Baden-Württemberg",8116020,"Frickenhausen",8608,4253,4355,0.494075278810409,8753,4362,4391,0.49834342511139,0.00659711656054247,0.3901600188325,0.603242864606958
8,"Baden-Württemberg",8116022,"Großbettlingen",4188,2010,2178,0.479942693409742,4205,2033,2172,0.483472057074911,0.00659711656054247,0.3901600188325,0.603242864606958
8,"Baden-Württemberg",8116027,"Hochdorf",4599,2278,2321,0.495325070667536,4672,2287,2385,0.48951198630137,0.00659711656054247,0.3901600188325,0.603242864606958
8,"Baden-Württemberg",8116029,"Holzmaden",2115,1042,1073,0.492671394799054,2131,1057,1074,0.496011262318161,0.00659711656054247,0.3901600188325,0.603242864606958
8,"Baden-Württemberg",8116033,"Kirchheim unter Teck, Stadt",39048,18894,20154,0.483866011063307,40134,19543,20591,0.486943738476105,0.00659711656054247,0.3901600188325,0.603242864606958
8,"Baden-Württemberg",8116035,"Köngen",9453,4610,4843,0.48767587009415,9667,4743,4924,0.490638253853315,0.00659711656054247,0.3901600188325,0.603242864606958
8,"Baden-Württemberg",8116036,"Kohlberg",2271,1124,1147,0.494936151475121,2248,1131,1117,0.503113879003559,0.00659711656054247,0.3901600188325,0.603242864606958
8,"Baden-Württemberg",8116037,"Lichtenwald",2452,1215,1237,0.495513866231648,2487,1222,1265,0.49135504624045,0.00659711656054247,0.3901600188325,0.603242864606958
8,"Baden-Württemberg",8116041,"Neckartailfingen",3708,1849,1859,0.498651564185545,3719,1844,1875,0.495832212960473,0.00659711656054247,0.3901600188325,0.603242864606958
8,"Baden-Württemberg",8116042,"Neckartenzlingen",6314,3141,3173,0.497465948685461,6313,3135,3178,0.496594329162047,0.00659711656054247,0.3901600188325,0.603242864606958
8,"Baden-Württemberg",8116043,"Neidlingen",1790,882,908,0.492737430167598,1806,893,913,0.494462901439646,0.00659711656054247,0.3901600188325,0.603242864606958
8,"Baden-Württemberg",8116046,"Neuffen, Stadt",6070,3026,3044,0.498517298187809,6116,3029,3087,0.495258338783519,0.00659711656054247,0.3901600188325,0.603242864606958
8,"Baden-Württemberg",8116047,"Neuhausen auf den Fildern",11259,5498,5761,0.488320454747313,11393,5551,5842,0.48722900026332,0.00659711656054247,0.3901600188325,0.603242864606958
8,"Baden-Württemberg",8116048,"Notzingen",3627,1840,1787,0.507306313757927,3576,1829,1747,0.511465324384787,0.00659711656054247,0.3901600188325,0.603242864606958
8,"Baden-Württemberg",8116049,"Nürtingen, Stadt",39295,19321,19974,0.491691054841583,40438,19875,20563,0.491493150007419,0.00659711656054247,0.3901600188325,0.603242864606958
8,"Baden-Württemberg",8116050,"Oberboihingen",5333,2615,2718,0.490343146446653,5386,2678,2708,0.497215001856665,0.00659711656054247,0.3901600188325,0.603242864606958
8,"Baden-Württemberg",8116053,"Ohmden",1712,871,841,0.508761682242991,1720,885,835,0.51453488372093,0.00659711656054247,0.3901600188325,0.603242864606958
8,"Baden-Württemberg",8116054,"Owen, Stadt",3421,1720,1701,0.502776965799474,3435,1733,1702,0.504512372634643,0.00659711656054247,0.3901600188325,0.603242864606958
8,"Baden-Württemberg",8116056,"Plochingen, Stadt",13495,6600,6895,0.489070025935532,14089,6999,7090,0.496770530200866,0.00659711656054247,0.3901600188325,0.603242864606958
8,"Baden-Württemberg",8116058,"Reichenbach an der Fils",7980,3899,4081,0.48859649122807,7930,3888,4042,0.490290037831021,0.00659711656054247,0.3901600188325,0.603242864606958
8,"Baden-Württemberg",8116063,"Schlaitdorf",1820,896,924,0.492307692307692,1801,881,920,0.48917268184342,0.00659711656054247,0.3901600188325,0.603242864606958
8,"Baden-Württemberg",8116068,"Unterensingen",4557,2282,2275,0.500768049155146,4566,2278,2288,0.498904949627683,0.00659711656054247,0.3901600188325,0.603242864606958
8,"Baden-Württemberg",8116070,"Weilheim an der Teck, Stadt",9520,4701,4819,0.493802521008403,9447,4684,4763,0.495818778448185,0.00659711656054247,0.3901600188325,0.603242864606958
8,"Baden-Württemberg",8116071,"Wendlingen am Neckar, Stadt",15571,7513,8058,0.482499518335367,15996,7788,8208,0.486871717929482,0.00659711656054247,0.3901600188325,0.603242864606958
8,"Baden-Württemberg",8116072,"Wernau (Neckar), Stadt",11858,5839,6019,0.492410187215382,12486,6189,6297,0.495675156174916,0.00659711656054247,0.3901600188325,0.603242864606958
8,"Baden-Württemberg",8116073,"Wolfschlugen",6191,3011,3180,0.486351154902277,6316,3081,3235,0.487808739708676,0.00659711656054247,0.3901600188325,0.603242864606958
8,"Baden-Württemberg",8116076,"Aichwald",7434,3590,3844,0.482916330373957,7491,3610,3881,0.481911627286077,0.00659711656054247,0.3901600188325,0.603242864606958
8,"Baden-Württemberg",8116077,"Filderstadt, Stadt",44064,21668,22396,0.491739288307916,44679,22035,22644,0.493184717652588,0.00659711656054247,0.3901600188325,0.603242864606958
8,"Baden-Württemberg",8116078,"Leinfelden-Echterdingen, Stadt",36508,17769,18739,0.486715240495234,37378,18209,19169,0.487158221413666,0.00659711656054247,0.3901600188325,0.603242864606958
8,"Baden-Württemberg",8116079,"Lenningen",7991,4014,3977,0.502315104492554,8101,4094,4007,0.505369707443525,0.00659711656054247,0.3901600188325,0.603242864606958
8,"Baden-Württemberg",8116080,"Ostfildern, Stadt",36093,17540,18553,0.485966807968304,36584,17872,18712,0.488519571397332,0.00659711656054247,0.3901600188325,0.603242864606958
8,"Baden-Württemberg",8116081,"Aichtal, Stadt",9545,4733,4812,0.495861707700367,9672,4819,4853,0.498242349048801,0.00659711656054247,0.3901600188325,0.603242864606958
8,"Baden-Württemberg",8117001,"Adelberg",1958,976,982,0.498467824310521,1981,989,992,0.499242806663301,0.00659711656054247,0.3901600188325,0.603242864606958
8,"Baden-Württemberg",8117002,"Aichelberg",1246,641,605,0.514446227929374,1254,638,616,0.508771929824561,0.00659711656054247,0.3901600188325,0.603242864606958
8,"Baden-Württemberg",8117003,"Albershausen",4233,2099,2134,0.495865816206,4298,2146,2152,0.499302000930665,0.00659711656054247,0.3901600188325,0.603242864606958
8,"Baden-Württemberg",8117006,"Bad Ditzenbach",3556,1741,1815,0.489595050618673,3675,1793,1882,0.487891156462585,0.00659711656054247,0.3901600188325,0.603242864606958
8,"Baden-Württemberg",8117007,"Bad Überkingen",3834,1886,1948,0.491914449660929,3844,1844,2000,0.479708636836629,0.00659711656054247,0.3901600188325,0.603242864606958
8,"Baden-Württemberg",8117009,"Birenbach",1893,935,958,0.49392498679345,1861,921,940,0.494895217624933,0.00659711656054247,0.3901600188325,0.603242864606958
8,"Baden-Württemberg",8117010,"Böhmenkirch",5486,2847,2639,0.518957345971564,5568,2890,2678,0.519037356321839,0.00659711656054247,0.3901600188325,0.603242864606958
8,"Baden-Württemberg",8117011,"Börtlingen",1713,853,860,0.497956800934034,1743,870,873,0.499139414802065,0.00659711656054247,0.3901600188325,0.603242864606958
8,"Baden-Württemberg",8117012,"Bad Boll",5023,2404,2619,0.478598447143142,5183,2451,2732,0.472892147404978,0.00659711656054247,0.3901600188325,0.603242864606958
8,"Baden-Württemberg",8117014,"Deggingen",5214,2566,2648,0.492136555427695,5386,2661,2725,0.494058670627553,0.00659711656054247,0.3901600188325,0.603242864606958
8,"Baden-Württemberg",8117015,"Donzdorf, Stadt",10718,5308,5410,0.495241649561485,10757,5315,5442,0.49409686715627,0.00659711656054247,0.3901600188325,0.603242864606958
8,"Baden-Württemberg",8117016,"Drackenstein",421,209,212,0.496437054631829,432,217,215,0.502314814814815,0.00659711656054247,0.3901600188325,0.603242864606958
8,"Baden-Württemberg",8117017,"Dürnau",2062,1012,1050,0.49078564500485,2081,1034,1047,0.496876501681884,0.00659711656054247,0.3901600188325,0.603242864606958
8,"Baden-Württemberg",8117018,"Ebersbach an der Fils, Stadt",14874,7328,7546,0.492671776253866,15306,7599,7707,0.496471971775774,0.00659711656054247,0.3901600188325,0.603242864606958
8,"Baden-Württemberg",8117019,"Eislingen/Fils, Stadt",19686,9523,10163,0.483744793254089,20373,9988,10385,0.490256712315319,0.00659711656054247,0.3901600188325,0.603242864606958
8,"Baden-Württemberg",8117020,"Eschenbach",2182,1080,1102,0.494958753437214,2215,1107,1108,0.499774266365689,0.00659711656054247,0.3901600188325,0.603242864606958
8,"Baden-Württemberg",8117023,"Gammelshausen",1459,755,704,0.517477724468814,1470,766,704,0.52108843537415,0.00659711656054247,0.3901600188325,0.603242864606958
8,"Baden-Württemberg",8117024,"Geislingen an der Steige, Stadt",26133,12802,13331,0.489878697432365,26823,13213,13610,0.492599634641912,0.00659711656054247,0.3901600188325,0.603242864606958
8,"Baden-Württemberg",8117025,"Gingen an der Fils",4336,2108,2228,0.486162361623616,4283,2109,2174,0.492411860845202,0.00659711656054247,0.3901600188325,0.603242864606958
8,"Baden-Württemberg",8117026,"Göppingen, Stadt",55099,26848,28251,0.487268371476796,56834,27923,28911,0.491308019847275,0.00659711656054247,0.3901600188325,0.603242864606958
8,"Baden-Württemberg",8117028,"Gruibingen",2079,1059,1020,0.509379509379509,2063,1068,995,0.517692680562288,0.00659711656054247,0.3901600188325,0.603242864606958
8,"Baden-Württemberg",8117029,"Hattenhofen",2919,1422,1497,0.487153134635149,2942,1436,1506,0.488103331067301,0.00659711656054247,0.3901600188325,0.603242864606958
8,"Baden-Württemberg",8117030,"Heiningen",5033,2458,2575,0.488376713689648,5154,2566,2588,0.497865735351184,0.00659711656054247,0.3901600188325,0.603242864606958
8,"Baden-Württemberg",8117031,"Hohenstadt",725,356,369,0.491034482758621,715,347,368,0.485314685314685,0.00659711656054247,0.3901600188325,0.603242864606958
8,"Baden-Württemberg",8117033,"Kuchen",5452,2690,2762,0.493396918561996,5420,2715,2705,0.500922509225092,0.00659711656054247,0.3901600188325,0.603242864606958
8,"Baden-Württemberg",8117035,"Mühlhausen im Täle",977,486,491,0.497441146366428,966,483,483,0.5,0.00659711656054247,0.3901600188325,0.603242864606958
8,"Baden-Württemberg",8117037,"Ottenbach",2389,1182,1207,0.494767685223943,2428,1197,1231,0.492998352553542,0.00659711656054247,0.3901600188325,0.603242864606958
8,"Baden-Württemberg",8117038,"Rechberghausen",5288,2562,2726,0.484493192133132,5374,2589,2785,0.481764049125419,0.00659711656054247,0.3901600188325,0.603242864606958
8,"Baden-Württemberg",8117042,"Salach",7680,3723,3957,0.484765625,7724,3784,3940,0.48990160538581,0.00659711656054247,0.3901600188325,0.603242864606958
8,"Baden-Württemberg",8117043,"Schlat",1663,818,845,0.491882140709561,1687,842,845,0.499110847658566,0.00659711656054247,0.3901600188325,0.603242864606958
8,"Baden-Württemberg",8117044,"Schlierbach",3752,1844,1908,0.491471215351812,3765,1873,1892,0.497476759628154,0.00659711656054247,0.3901600188325,0.603242864606958
8,"Baden-Württemberg",8117049,"Süßen, Stadt",9650,4776,4874,0.494922279792746,9982,5015,4967,0.502404327790022,0.00659711656054247,0.3901600188325,0.603242864606958
8,"Baden-Württemberg",8117051,"Uhingen, Stadt",13819,6859,6960,0.496345611115131,13560,6718,6842,0.495427728613569,0.00659711656054247,0.3901600188325,0.603242864606958
8,"Baden-Württemberg",8117053,"Wäschenbeuren",3896,1902,1994,0.488193018480493,3958,1956,2002,0.494188984335523,0.00659711656054247,0.3901600188325,0.603242864606958
8,"Baden-Württemberg",8117055,"Wangen",3098,1514,1584,0.488702388637831,3122,1529,1593,0.489750160153748,0.00659711656054247,0.3901600188325,0.603242864606958
8,"Baden-Württemberg",8117058,"Wiesensteig, Stadt",2031,1002,1029,0.493353028064993,2085,1038,1047,0.497841726618705,0.00659711656054247,0.3901600188325,0.603242864606958
8,"Baden-Württemberg",8117060,"Zell unter Aichelberg",3022,1507,1515,0.49867637326274,3031,1523,1508,0.502474430880897,0.00659711656054247,0.3901600188325,0.603242864606958
8,"Baden-Württemberg",8117061,"Lauterstein, Stadt",2595,1273,1322,0.490558766859345,2659,1312,1347,0.493418578412937,0.00659711656054247,0.3901600188325,0.603242864606958
8,"Baden-Württemberg",8118001,"Affalterbach",4462,2235,2227,0.500896458987001,4555,2287,2268,0.502085620197585,0.00659711656054247,0.3901600188325,0.603242864606958
8,"Baden-Württemberg",8118003,"Asperg, Stadt",12867,6299,6568,0.489546902929976,13160,6520,6640,0.495440729483283,0.00659711656054247,0.3901600188325,0.603242864606958
8,"Baden-Württemberg",8118006,"Benningen am Neckar",5893,2927,2966,0.49669098930935,5799,2873,2926,0.49543024659424,0.00659711656054247,0.3901600188325,0.603242864606958
8,"Baden-Württemberg",8118007,"Besigheim, Stadt",11793,5809,5984,0.492580344272026,11988,5891,6097,0.491408074741408,0.00659711656054247,0.3901600188325,0.603242864606958
8,"Baden-Württemberg",8118010,"Bönnigheim, Stadt",7137,3484,3653,0.48816029143898,7487,3698,3789,0.493922799519167,0.00659711656054247,0.3901600188325,0.603242864606958
8,"Baden-Württemberg",8118011,"Ditzingen, Stadt",24039,11772,12267,0.489704230625234,24573,12130,12443,0.493631221259106,0.00659711656054247,0.3901600188325,0.603242864606958
8,"Baden-Württemberg",8118012,"Eberdingen",6518,3251,3267,0.498772629640994,6477,3226,3251,0.498070094179404,0.00659711656054247,0.3901600188325,0.603242864606958
8,"Baden-Württemberg",8118014,"Erdmannhausen",4740,2369,2371,0.499789029535865,4727,2364,2363,0.500105775333192,0.00659711656054247,0.3901600188325,0.603242864606958
8,"Baden-Württemberg",8118015,"Erligheim",2670,1346,1324,0.504119850187266,2707,1381,1326,0.510158847432582,0.00659711656054247,0.3901600188325,0.603242864606958
8,"Baden-Württemberg",8118016,"Freudental",2363,1174,1189,0.496826068556919,2408,1216,1192,0.504983388704319,0.00659711656054247,0.3901600188325,0.603242864606958
8,"Baden-Württemberg",8118018,"Gemmrigheim",3850,1929,1921,0.501038961038961,3887,1938,1949,0.498585027013121,0.00659711656054247,0.3901600188325,0.603242864606958
8,"Baden-Württemberg",8118019,"Gerlingen, Stadt",18756,9116,9640,0.486031136702922,19224,9451,9773,0.49162505201831,0.00659711656054247,0.3901600188325,0.603242864606958
8,"Baden-Württemberg",8118021,"Großbottwar, Stadt",8065,4027,4038,0.499318040917545,8175,4121,4054,0.504097859327217,0.00659711656054247,0.3901600188325,0.603242864606958
8,"Baden-Württemberg",8118027,"Hemmingen",7351,3681,3670,0.500748197524146,7365,3682,3683,0.499932111337407,0.00659711656054247,0.3901600188325,0.603242864606958
8,"Baden-Württemberg",8118028,"Hessigheim",2286,1115,1171,0.487751531058618,2229,1098,1131,0.492597577388964,0.00659711656054247,0.3901600188325,0.603242864606958
8,"Baden-Württemberg",8118040,"Kirchheim am Neckar",5225,2588,2637,0.495311004784689,5205,2608,2597,0.501056676272815,0.00659711656054247,0.3901600188325,0.603242864606958
8,"Baden-Württemberg",8118046,"Kornwestheim, Stadt",31053,15155,15898,0.488036582616816,31539,15502,16037,0.491518437490092,0.00659711656054247,0.3901600188325,0.603242864606958
8,"Baden-Württemberg",8118047,"Löchgau",5482,2688,2794,0.490331995622036,5365,2653,2712,0.494501397949674,0.00659711656054247,0.3901600188325,0.603242864606958
8,"Baden-Württemberg",8118048,"Ludwigsburg, Stadt",86939,42113,44826,0.484397106016862,88673,43135,45538,0.486450215962018,0.00659711656054247,0.3901600188325,0.603242864606958
8,"Baden-Württemberg",8118049,"Marbach am Neckar, Stadt",15216,7474,7742,0.491193480546793,15435,7661,7774,0.496339488176223,0.00659711656054247,0.3901600188325,0.603242864606958
8,"Baden-Württemberg",8118050,"Markgröningen, Stadt",14181,7088,7093,0.499823707778013,14448,7230,7218,0.500415282392027,0.00659711656054247,0.3901600188325,0.603242864606958
8,"Baden-Württemberg",8118051,"Möglingen",10561,5230,5331,0.495218255846984,10760,5355,5405,0.497676579925651,0.00659711656054247,0.3901600188325,0.603242864606958
8,"Baden-Württemberg",8118053,"Mundelsheim",3227,1646,1581,0.510071273628757,3163,1597,1566,0.504900411002213,0.00659711656054247,0.3901600188325,0.603242864606958
8,"Baden-Württemberg",8118054,"Murr",6185,3051,3134,0.493290218270008,6192,3044,3148,0.491602067183463,0.00659711656054247,0.3901600188325,0.603242864606958
8,"Baden-Württemberg",8118059,"Oberriexingen, Stadt",3235,1629,1606,0.50355486862442,3178,1593,1585,0.501258653241032,0.00659711656054247,0.3901600188325,0.603242864606958
8,"Baden-Württemberg",8118060,"Oberstenfeld",7862,3873,3989,0.492622742304757,7916,3897,4019,0.492294087923194,0.00659711656054247,0.3901600188325,0.603242864606958
8,"Baden-Württemberg",8118063,"Pleidelsheim",6255,3086,3169,0.493365307753797,6313,3107,3206,0.492159036907968,0.00659711656054247,0.3901600188325,0.603242864606958
8,"Baden-Württemberg",8118067,"Schwieberdingen",11137,5576,5561,0.500673430905989,11466,5825,5641,0.508023722309437,0.00659711656054247,0.3901600188325,0.603242864606958
8,"Baden-Württemberg",8118068,"Sersheim",5285,2594,2691,0.490823084200568,5299,2591,2708,0.488960181166258,0.00659711656054247,0.3901600188325,0.603242864606958
8,"Baden-Württemberg",8118070,"Steinheim an der Murr, Stadt",11939,5847,6092,0.489739509171622,12019,5945,6074,0.494633496963142,0.00659711656054247,0.3901600188325,0.603242864606958
8,"Baden-Württemberg",8118071,"Tamm",12248,6120,6128,0.499673416067929,12443,6155,6288,0.494655629671301,0.00659711656054247,0.3901600188325,0.603242864606958
8,"Baden-Württemberg",8118073,"Vaihingen an der Enz, Stadt",27971,13805,14166,0.493546887848128,28896,14354,14542,0.496746954595792,0.00659711656054247,0.3901600188325,0.603242864606958
8,"Baden-Württemberg",8118074,"Walheim",3044,1509,1535,0.495729303547963,2987,1504,1483,0.503515232674925,0.00659711656054247,0.3901600188325,0.603242864606958
8,"Baden-Württemberg",8118076,"Sachsenheim, Stadt",17339,8540,8799,0.492531287848203,17846,8925,8921,0.500112069931637,0.00659711656054247,0.3901600188325,0.603242864606958
8,"Baden-Württemberg",8118077,"Ingersheim",6063,2933,3130,0.483753917202705,6043,2942,3101,0.486844282641072,0.00659711656054247,0.3901600188325,0.603242864606958
8,"Baden-Württemberg",8118078,"Freiberg am Neckar, Stadt",15480,7493,7987,0.484043927648579,15766,7672,8094,0.486616770265128,0.00659711656054247,0.3901600188325,0.603242864606958
8,"Baden-Württemberg",8118079,"Bietigheim-Bissingen, Stadt",41739,20234,21505,0.484774431586765,43007,20990,22017,0.488060083242263,0.00659711656054247,0.3901600188325,0.603242864606958
8,"Baden-Württemberg",8118080,"Korntal-Münchingen, Stadt",18240,8964,9276,0.491447368421053,18608,9186,9422,0.49365864144454,0.00659711656054247,0.3901600188325,0.603242864606958
8,"Baden-Württemberg",8118081,"Remseck am Neckar, Stadt",23390,11524,11866,0.492689183411714,23686,11766,11920,0.496749134509837,0.00659711656054247,0.3901600188325,0.603242864606958
8,"Baden-Württemberg",8119001,"Alfdorf",7051,3553,3498,0.50390015600624,7075,3565,3510,0.503886925795053,0.00659711656054247,0.3901600188325,0.603242864606958
8,"Baden-Württemberg",8119003,"Allmersbach im Tal",4618,2275,2343,0.492637505413599,4749,2361,2388,0.4971572962729,0.00659711656054247,0.3901600188325,0.603242864606958
8,"Baden-Württemberg",8119004,"Althütte",4082,2037,2045,0.499020088192063,4146,2074,2072,0.500241196333816,0.00659711656054247,0.3901600188325,0.603242864606958
8,"Baden-Württemberg",8119006,"Auenwald",6777,3366,3411,0.49667994687915,6819,3385,3434,0.496407097814929,0.00659711656054247,0.3901600188325,0.603242864606958
8,"Baden-Württemberg",8119008,"Backnang, Stadt",34276,16876,17400,0.492356167580815,35421,17641,17780,0.498037887129104,0.00659711656054247,0.3901600188325,0.603242864606958
8,"Baden-Württemberg",8119018,"Burgstetten",3469,1729,1740,0.498414528682617,3436,1706,1730,0.4965075669383,0.00659711656054247,0.3901600188325,0.603242864606958
8,"Baden-Württemberg",8119020,"Fellbach, Stadt",43640,21128,22512,0.484142988084326,44762,21876,22886,0.488718109110406,0.00659711656054247,0.3901600188325,0.603242864606958
8,"Baden-Württemberg",8119024,"Großerlach",2406,1268,1138,0.527015793848712,2485,1336,1149,0.537625754527163,0.00659711656054247,0.3901600188325,0.603242864606958
8,"Baden-Württemberg",8119037,"Kaisersbach",2515,1273,1242,0.506163021868787,2633,1331,1302,0.505507026205849,0.00659711656054247,0.3901600188325,0.603242864606958
8,"Baden-Württemberg",8119038,"Kirchberg an der Murr",3601,1796,1805,0.498750347125798,3670,1847,1823,0.503269754768392,0.00659711656054247,0.3901600188325,0.603242864606958
8,"Baden-Württemberg",8119041,"Korb",9936,4833,5103,0.486413043478261,10342,5107,5235,0.493811641848772,0.00659711656054247,0.3901600188325,0.603242864606958
8,"Baden-Württemberg",8119042,"Leutenbach",10667,5218,5449,0.489172213368332,10944,5330,5614,0.48702485380117,0.00659711656054247,0.3901600188325,0.603242864606958
8,"Baden-Württemberg",8119044,"Murrhardt, Stadt",13534,6609,6925,0.488325698241466,13831,6791,7040,0.490998481671607,0.00659711656054247,0.3901600188325,0.603242864606958
8,"Baden-Württemberg",8119053,"Oppenweiler",3994,2005,1989,0.50200300450676,4023,2006,2017,0.498632861048968,0.00659711656054247,0.3901600188325,0.603242864606958
8,"Baden-Württemberg",8119055,"Plüderhausen",9268,4538,4730,0.489641778161416,9294,4568,4726,0.491499892403701,0.00659711656054247,0.3901600188325,0.603242864606958
8,"Baden-Württemberg",8119061,"Rudersberg",11012,5492,5520,0.498728659644025,11274,5595,5679,0.496274614156466,0.00659711656054247,0.3901600188325,0.603242864606958
8,"Baden-Württemberg",8119067,"Schorndorf, Stadt",38351,18580,19771,0.484472373601731,39351,19180,20171,0.487408198012757,0.00659711656054247,0.3901600188325,0.603242864606958
8,"Baden-Württemberg",8119068,"Schwaikheim",9308,4553,4755,0.489149119037387,9322,4579,4743,0.491203604376743,0.00659711656054247,0.3901600188325,0.603242864606958
8,"Baden-Württemberg",8119069,"Spiegelberg",2075,1064,1011,0.512771084337349,2125,1109,1016,0.521882352941176,0.00659711656054247,0.3901600188325,0.603242864606958
8,"Baden-Württemberg",8119075,"Sulzbach an der Murr",5111,2488,2623,0.486793191156329,5242,2520,2722,0.480732544830217,0.00659711656054247,0.3901600188325,0.603242864606958
8,"Baden-Württemberg",8119076,"Urbach",8688,4316,4372,0.496777163904236,8713,4324,4389,0.496269941466774,0.00659711656054247,0.3901600188325,0.603242864606958
8,"Baden-Württemberg",8119079,"Waiblingen, Stadt",51798,25066,26732,0.483918298003784,53288,26023,27265,0.488346344392734,0.00659711656054247,0.3901600188325,0.603242864606958
8,"Baden-Württemberg",8119083,"Weissach im Tal",6972,3448,3524,0.494549627079748,6986,3439,3547,0.492270254795305,0.00659711656054247,0.3901600188325,0.603242864606958
8,"Baden-Württemberg",8119084,"Welzheim, Stadt",11042,5393,5649,0.488407897120087,10993,5392,5601,0.490493950695897,0.00659711656054247,0.3901600188325,0.603242864606958
8,"Baden-Württemberg",8119085,"Winnenden, Stadt",27219,13434,13785,0.493552298027113,27775,13747,14028,0.494941494149415,0.00659711656054247,0.3901600188325,0.603242864606958
8,"Baden-Württemberg",8119086,"Winterbach",7620,3673,3947,0.482020997375328,7663,3671,3992,0.479055200313193,0.00659711656054247,0.3901600188325,0.603242864606958
8,"Baden-Württemberg",8119087,"Aspach",8015,3986,4029,0.49731752963194,8196,4060,4136,0.495363591996096,0.00659711656054247,0.3901600188325,0.603242864606958
8,"Baden-Württemberg",8119089,"Berglen",5921,2943,2978,0.497044418172606,5977,3009,2968,0.503429814288104,0.00659711656054247,0.3901600188325,0.603242864606958
8,"Baden-Württemberg",8119090,"Remshalden",13455,6633,6822,0.492976588628763,13414,6654,6760,0.496048904130013,0.00659711656054247,0.3901600188325,0.603242864606958
8,"Baden-Württemberg",8119091,"Weinstadt, Stadt",25947,12604,13343,0.485759432689714,26429,12870,13559,0.486965076242007,0.00659711656054247,0.3901600188325,0.603242864606958
8,"Baden-Württemberg",8119093,"Kernen im Remstal",14782,7296,7486,0.493573264781491,15341,7494,7847,0.488494882993286,0.00659711656054247,0.3901600188325,0.603242864606958
8,"Baden-Württemberg",8121000,"Heilbronn, Stadt",116716,57570,59146,0.493248569176463,124257,61698,62559,0.496535406455974,0.00659711656054247,0.3901600188325,0.603242864606958
8,"Baden-Württemberg",8125001,"Abstatt",4475,2218,2257,0.495642458100559,4485,2226,2259,0.496321070234114,0.00659711656054247,0.3901600188325,0.603242864606958
8,"Baden-Württemberg",8125005,"Bad Friedrichshall, Stadt",18181,9017,9164,0.495957318079314,18773,9357,9416,0.498428594257711,0.00659711656054247,0.3901600188325,0.603242864606958
8,"Baden-Württemberg",8125006,"Bad Rappenau, Stadt",20012,9741,10271,0.48675794523286,20554,10048,10506,0.488858616327722,0.00659711656054247,0.3901600188325,0.603242864606958
8,"Baden-Württemberg",8125007,"Bad Wimpfen, Stadt",6743,3336,3407,0.494735281032182,6872,3430,3442,0.499126891734575,0.00659711656054247,0.3901600188325,0.603242864606958
8,"Baden-Württemberg",8125008,"Beilstein, Stadt",6081,2991,3090,0.49185989146522,6074,2987,3087,0.491768192295028,0.00659711656054247,0.3901600188325,0.603242864606958
8,"Baden-Württemberg",8125013,"Brackenheim, Stadt",14976,7379,7597,0.492721688034188,15184,7534,7650,0.49618018967334,0.00659711656054247,0.3901600188325,0.603242864606958
8,"Baden-Württemberg",8125017,"Cleebronn",2697,1366,1331,0.506488691138302,2720,1381,1339,0.507720588235294,0.00659711656054247,0.3901600188325,0.603242864606958
8,"Baden-Württemberg",8125021,"Eberstadt",3128,1514,1614,0.484015345268542,3171,1534,1637,0.483759066540523,0.00659711656054247,0.3901600188325,0.603242864606958
8,"Baden-Württemberg",8125024,"Ellhofen",3327,1655,1672,0.497445145776976,3360,1693,1667,0.503869047619048,0.00659711656054247,0.3901600188325,0.603242864606958
8,"Baden-Württemberg",8125026,"Eppingen, Stadt",20795,10277,10518,0.494205337821592,21386,10542,10844,0.492939306088095,0.00659711656054247,0.3901600188325,0.603242864606958
8,"Baden-Württemberg",8125027,"Erlenbach",4902,2437,2465,0.497144022847817,4928,2466,2462,0.500405844155844,0.00659711656054247,0.3901600188325,0.603242864606958
8,"Baden-Württemberg",8125030,"Flein",6502,3099,3403,0.47662257766841,6714,3188,3526,0.474828716115579,0.00659711656054247,0.3901600188325,0.603242864606958
8,"Baden-Württemberg",8125034,"Gemmingen",4895,2451,2444,0.500715015321757,4861,2443,2418,0.502571487348282,0.00659711656054247,0.3901600188325,0.603242864606958
8,"Baden-Württemberg",8125038,"Güglingen, Stadt",5940,2993,2947,0.503872053872054,5999,3050,2949,0.50841806967828,0.00659711656054247,0.3901600188325,0.603242864606958
8,"Baden-Württemberg",8125039,"Gundelsheim, Stadt",7120,3522,3598,0.494662921348315,7182,3568,3614,0.496797549429128,0.00659711656054247,0.3901600188325,0.603242864606958
8,"Baden-Württemberg",8125046,"Ilsfeld",8663,4306,4357,0.497056446958329,8595,4291,4304,0.499243746364165,0.00659711656054247,0.3901600188325,0.603242864606958
8,"Baden-Württemberg",8125047,"Ittlingen",2405,1220,1185,0.507276507276507,2434,1256,1178,0.516023007395234,0.00659711656054247,0.3901600188325,0.603242864606958
8,"Baden-Württemberg",8125048,"Jagsthausen",1577,786,791,0.498414711477489,1569,793,776,0.505417463352454,0.00659711656054247,0.3901600188325,0.603242864606958
8,"Baden-Württemberg",8125049,"Kirchardt",5407,2717,2690,0.502496763454781,5432,2770,2662,0.509941089837997,0.00659711656054247,0.3901600188325,0.603242864606958
8,"Baden-Württemberg",8125056,"Lauffen am Neckar, Stadt",10795,5237,5558,0.485132005558129,10922,5345,5577,0.489379234572423,0.00659711656054247,0.3901600188325,0.603242864606958
8,"Baden-Württemberg",8125057,"Lehrensteinsfeld",2218,1121,1097,0.505410279531109,2189,1119,1070,0.511192325262677,0.00659711656054247,0.3901600188325,0.603242864606958
8,"Baden-Württemberg",8125058,"Leingarten",10842,5292,5550,0.488101826231323,10781,5290,5491,0.490678044708283,0.00659711656054247,0.3901600188325,0.603242864606958
8,"Baden-Württemberg",8125059,"Löwenstein, Stadt",3125,1545,1580,0.4944,3123,1537,1586,0.492154979186679,0.00659711656054247,0.3901600188325,0.603242864606958
8,"Baden-Württemberg",8125061,"Massenbachhausen",3399,1696,1703,0.498970285378052,3501,1779,1722,0.508140531276778,0.00659711656054247,0.3901600188325,0.603242864606958
8,"Baden-Württemberg",8125063,"Möckmühl, Stadt",7790,3897,3893,0.500256739409499,8105,4170,3935,0.514497223935842,0.00659711656054247,0.3901600188325,0.603242864606958
8,"Baden-Württemberg",8125065,"Neckarsulm, Stadt",25533,12525,13008,0.490541651979791,26598,13208,13390,0.496578690127077,0.00659711656054247,0.3901600188325,0.603242864606958
8,"Baden-Württemberg",8125066,"Neckarwestheim",3471,1738,1733,0.500720253529242,3528,1789,1739,0.507086167800454,0.00659711656054247,0.3901600188325,0.603242864606958
8,"Baden-Württemberg",8125068,"Neudenau, Stadt",5050,2510,2540,0.497029702970297,5177,2564,2613,0.495267529457215,0.00659711656054247,0.3901600188325,0.603242864606958
8,"Baden-Württemberg",8125069,"Neuenstadt am Kocher, Stadt",9542,4774,4768,0.500314399496961,9601,4833,4768,0.503385064055828,0.00659711656054247,0.3901600188325,0.603242864606958
8,"Baden-Württemberg",8125074,"Nordheim",7613,3761,3852,0.494023381058715,7502,3706,3796,0.494001599573447,0.00659711656054247,0.3901600188325,0.603242864606958
8,"Baden-Württemberg",8125078,"Oedheim",5932,2931,3001,0.49409979770735,5979,2996,2983,0.501087138317444,0.00659711656054247,0.3901600188325,0.603242864606958
8,"Baden-Württemberg",8125079,"Offenau",2636,1289,1347,0.488998482549317,2650,1316,1334,0.496603773584906,0.00659711656054247,0.3901600188325,0.603242864606958
8,"Baden-Württemberg",8125081,"Pfaffenhofen",2271,1126,1145,0.495816820783796,2321,1159,1162,0.499353726841879,0.00659711656054247,0.3901600188325,0.603242864606958
8,"Baden-Württemberg",8125084,"Roigheim",1425,736,689,0.516491228070175,1482,758,724,0.511470985155196,0.00659711656054247,0.3901600188325,0.603242864606958
8,"Baden-Württemberg",8125086,"Schwaigern, Stadt",10794,5331,5463,0.493885491939967,11016,5464,5552,0.4960058097313,0.00659711656054247,0.3901600188325,0.603242864606958
8,"Baden-Württemberg",8125087,"Siegelsbach",1620,821,799,0.50679012345679,1623,829,794,0.510782501540357,0.00659711656054247,0.3901600188325,0.603242864606958
8,"Baden-Württemberg",8125094,"Talheim",4803,2401,2402,0.499895898396835,4794,2391,2403,0.498748435544431,0.00659711656054247,0.3901600188325,0.603242864606958
8,"Baden-Württemberg",8125096,"Untereisesheim",4078,2017,2061,0.494605198626778,4136,2066,2070,0.499516441005803,0.00659711656054247,0.3901600188325,0.603242864606958
8,"Baden-Württemberg",8125098,"Untergruppenbach",7877,3883,3994,0.49295417036943,7867,3888,3979,0.494216346764968,0.00659711656054247,0.3901600188325,0.603242864606958
8,"Baden-Württemberg",8125102,"Weinsberg, Stadt",11302,5564,5738,0.492302247389843,11623,5772,5851,0.496601565860793,0.00659711656054247,0.3901600188325,0.603242864606958
8,"Baden-Württemberg",8125103,"Widdern, Stadt",1854,944,910,0.509169363538296,1948,1005,943,0.515913757700205,0.00659711656054247,0.3901600188325,0.603242864606958
8,"Baden-Württemberg",8125107,"Wüstenrot",6528,3133,3395,0.479932598039216,6613,3204,3409,0.484500226825949,0.00659711656054247,0.3901600188325,0.603242864606958
8,"Baden-Württemberg",8125108,"Zaberfeld",3895,1900,1995,0.48780487804878,3894,1901,1993,0.488186954288649,0.00659711656054247,0.3901600188325,0.603242864606958
8,"Baden-Württemberg",8125110,"Obersulm",13359,6688,6671,0.500636275170297,13898,6990,6908,0.502950064757519,0.00659711656054247,0.3901600188325,0.603242864606958
8,"Baden-Württemberg",8125111,"Hardthausen am Kocher",3936,2024,1912,0.514227642276423,3931,2016,1915,0.512846603917578,0.00659711656054247,0.3901600188325,0.603242864606958
8,"Baden-Württemberg",8125113,"Langenbrettach",3654,1849,1805,0.506020799124247,3636,1845,1791,0.507425742574257,0.00659711656054247,0.3901600188325,0.603242864606958
8,"Baden-Württemberg",8126011,"Bretzfeld",11998,5980,6018,0.498416402733789,12136,6089,6047,0.501730388925511,0.00659711656054247,0.3901600188325,0.603242864606958
8,"Baden-Württemberg",8126020,"Dörzbach",2417,1195,1222,0.494414563508482,2434,1213,1221,0.49835661462613,0.00659711656054247,0.3901600188325,0.603242864606958
8,"Baden-Württemberg",8126028,"Forchtenberg, Stadt",4882,2439,2443,0.499590331831217,4937,2468,2469,0.49989872392141,0.00659711656054247,0.3901600188325,0.603242864606958
8,"Baden-Württemberg",8126039,"Ingelfingen, Stadt",5635,2757,2878,0.489263531499556,5691,2788,2903,0.489896327534704,0.00659711656054247,0.3901600188325,0.603242864606958
8,"Baden-Württemberg",8126045,"Krautheim, Stadt",4578,2366,2212,0.516819571865443,4699,2440,2259,0.519259416897212,0.00659711656054247,0.3901600188325,0.603242864606958
8,"Baden-Württemberg",8126046,"Künzelsau, Stadt",14530,7220,7310,0.496902959394357,14829,7291,7538,0.49167172432396,0.00659711656054247,0.3901600188325,0.603242864606958
8,"Baden-Württemberg",8126047,"Kupferzell",5730,2872,2858,0.501221640488656,5840,2946,2894,0.504452054794521,0.00659711656054247,0.3901600188325,0.603242864606958
8,"Baden-Württemberg",8126056,"Mulfingen",3738,1940,1798,0.518994114499732,3709,1931,1778,0.520625505527096,0.00659711656054247,0.3901600188325,0.603242864606958
8,"Baden-Württemberg",8126058,"Neuenstein, Stadt",6206,3159,3047,0.509023525620367,6260,3205,3055,0.511980830670926,0.00659711656054247,0.3901600188325,0.603242864606958
8,"Baden-Württemberg",8126060,"Niedernhall, Stadt",3878,1937,1941,0.499484270242393,3925,2032,1893,0.517707006369427,0.00659711656054247,0.3901600188325,0.603242864606958
8,"Baden-Württemberg",8126066,"Öhringen, Stadt",22476,11033,11443,0.490879159992881,22875,11290,11585,0.493551912568306,0.00659711656054247,0.3901600188325,0.603242864606958
8,"Baden-Württemberg",8126069,"Pfedelbach",8911,4399,4512,0.493659521939176,8904,4418,4486,0.49618149146451,0.00659711656054247,0.3901600188325,0.603242864606958
8,"Baden-Württemberg",8126072,"Schöntal",5632,2864,2768,0.508522727272727,5683,2906,2777,0.511349639275031,0.00659711656054247,0.3901600188325,0.603242864606958
8,"Baden-Württemberg",8126085,"Waldenburg, Stadt",2891,1438,1453,0.4974057419578,3009,1488,1521,0.494516450648056,0.00659711656054247,0.3901600188325,0.603242864606958
8,"Baden-Württemberg",8126086,"Weißbach",2065,1050,1015,0.508474576271186,2078,1058,1020,0.509143407122233,0.00659711656054247,0.3901600188325,0.603242864606958
8,"Baden-Württemberg",8126094,"Zweiflingen",1633,816,817,0.499693815064299,1823,942,881,0.516730663741086,0.00659711656054247,0.3901600188325,0.603242864606958
8,"Baden-Württemberg",8127008,"Blaufelden",5137,2638,2499,0.513529297255207,5172,2671,2501,0.516434648105182,0.00659711656054247,0.3901600188325,0.603242864606958
8,"Baden-Württemberg",8127009,"Braunsbach",2441,1219,1222,0.499385497746825,2327,1159,1168,0.498066179630425,0.00659711656054247,0.3901600188325,0.603242864606958
8,"Baden-Württemberg",8127012,"Bühlertann",3030,1500,1530,0.495049504950495,3056,1528,1528,0.5,0.00659711656054247,0.3901600188325,0.603242864606958
8,"Baden-Württemberg",8127013,"Bühlerzell",2050,1057,993,0.515609756097561,2061,1048,1013,0.508491023774867,0.00659711656054247,0.3901600188325,0.603242864606958
8,"Baden-Württemberg",8127014,"Crailsheim, Stadt",32342,15977,16365,0.494001607816462,33086,16428,16658,0.496524209635495,0.00659711656054247,0.3901600188325,0.603242864606958
8,"Baden-Württemberg",8127023,"Fichtenberg",2851,1418,1433,0.497369344089793,2815,1396,1419,0.495914742451155,0.00659711656054247,0.3901600188325,0.603242864606958
8,"Baden-Württemberg",8127025,"Gaildorf, Stadt",11943,5851,6092,0.489910407770242,12286,6105,6181,0.496907048673287,0.00659711656054247,0.3901600188325,0.603242864606958
8,"Baden-Württemberg",8127032,"Gerabronn, Stadt",4232,2140,2092,0.505671077504726,4272,2181,2091,0.510533707865168,0.00659711656054247,0.3901600188325,0.603242864606958
8,"Baden-Württemberg",8127043,"Ilshofen, Stadt",6239,3152,3087,0.505209168135919,6220,3162,3058,0.508360128617363,0.00659711656054247,0.3901600188325,0.603242864606958
8,"Baden-Württemberg",8127046,"Kirchberg an der Jagst, Stadt",4113,2138,1975,0.519815220034038,4312,2257,2055,0.523423005565863,0.00659711656054247,0.3901600188325,0.603242864606958
8,"Baden-Württemberg",8127047,"Langenburg, Stadt",1739,883,856,0.507763082231167,1766,882,884,0.499433748584371,0.00659711656054247,0.3901600188325,0.603242864606958
8,"Baden-Württemberg",8127052,"Mainhardt",5745,2823,2922,0.491383812010444,5723,2807,2916,0.490477022540626,0.00659711656054247,0.3901600188325,0.603242864606958
8,"Baden-Württemberg",8127056,"Michelbach an der Bilz",3373,1673,1700,0.495997628224133,3330,1668,1662,0.500900900900901,0.00659711656054247,0.3901600188325,0.603242864606958
8,"Baden-Württemberg",8127059,"Michelfeld",3669,1852,1817,0.504769692014173,3705,1847,1858,0.498515519568151,0.00659711656054247,0.3901600188325,0.603242864606958
8,"Baden-Württemberg",8127062,"Oberrot",3622,1787,1835,0.49337382661513,3648,1804,1844,0.494517543859649,0.00659711656054247,0.3901600188325,0.603242864606958
8,"Baden-Württemberg",8127063,"Obersontheim",4712,2364,2348,0.50169779286927,4752,2365,2387,0.497685185185185,0.00659711656054247,0.3901600188325,0.603242864606958
8,"Baden-Württemberg",8127071,"Rot am See",5223,2651,2572,0.507562703427149,5226,2673,2553,0.511481056257176,0.00659711656054247,0.3901600188325,0.603242864606958
8,"Baden-Württemberg",8127073,"Satteldorf",5182,2637,2545,0.508876881512929,5203,2625,2578,0.504516625024025,0.00659711656054247,0.3901600188325,0.603242864606958
8,"Baden-Württemberg",8127075,"Schrozberg, Stadt",5740,2940,2800,0.51219512195122,5752,2954,2798,0.51356050069541,0.00659711656054247,0.3901600188325,0.603242864606958
8,"Baden-Württemberg",8127076,"Schwäbisch Hall, Stadt",36846,17682,19164,0.479889268848722,37408,17915,19493,0.478908254918734,0.00659711656054247,0.3901600188325,0.603242864606958
8,"Baden-Württemberg",8127079,"Sulzbach-Laufen",2537,1296,1241,0.510839574300355,2521,1284,1237,0.509321697738992,0.00659711656054247,0.3901600188325,0.603242864606958
8,"Baden-Württemberg",8127086,"Untermünkheim",2961,1501,1460,0.506923336710571,2950,1500,1450,0.508474576271186,0.00659711656054247,0.3901600188325,0.603242864606958
8,"Baden-Württemberg",8127089,"Vellberg, Stadt",4205,2069,2136,0.492033293697979,4278,2112,2166,0.493688639551192,0.00659711656054247,0.3901600188325,0.603242864606958
8,"Baden-Württemberg",8127091,"Wallhausen",3574,1797,1777,0.502797985450476,3601,1807,1794,0.501805054151625,0.00659711656054247,0.3901600188325,0.603242864606958
8,"Baden-Württemberg",8127099,"Wolpertshausen",2041,1042,999,0.510534051935326,2049,1043,1006,0.509028794533919,0.00659711656054247,0.3901600188325,0.603242864606958
8,"Baden-Württemberg",8127100,"Rosengarten",5020,2450,2570,0.48804780876494,5051,2465,2586,0.488022173826965,0.00659711656054247,0.3901600188325,0.603242864606958
8,"Baden-Württemberg",8127101,"Kreßberg",3736,1884,1852,0.504282655246253,3785,1910,1875,0.504623513870542,0.00659711656054247,0.3901600188325,0.603242864606958
8,"Baden-Württemberg",8127102,"Fichtenau",4479,2260,2219,0.504576914489841,4505,2269,2236,0.503662597114317,0.00659711656054247,0.3901600188325,0.603242864606958
8,"Baden-Württemberg",8127103,"Frankenhardt",4738,2417,2321,0.510130856901646,4653,2377,2276,0.510853212980873,0.00659711656054247,0.3901600188325,0.603242864606958
8,"Baden-Württemberg",8127104,"Stimpfach",2907,1480,1427,0.509115927072583,2936,1500,1436,0.510899182561308,0.00659711656054247,0.3901600188325,0.603242864606958
8,"Baden-Württemberg",8128006,"Assamstadt",2135,1062,1073,0.497423887587822,2109,1046,1063,0.495969653864391,0.00659711656054247,0.3901600188325,0.603242864606958
8,"Baden-Württemberg",8128007,"Bad Mergentheim, Stadt",22173,10550,11623,0.475803905651017,22534,10660,11874,0.473062927132333,0.00659711656054247,0.3901600188325,0.603242864606958
8,"Baden-Württemberg",8128014,"Boxberg, Stadt",6661,3318,3343,0.49812340489416,6879,3424,3455,0.497746765518244,0.00659711656054247,0.3901600188325,0.603242864606958
8,"Baden-Württemberg",8128020,"Creglingen, Stadt",4729,2378,2351,0.50285472615775,4626,2350,2276,0.507998270644185,0.00659711656054247,0.3901600188325,0.603242864606958
8,"Baden-Württemberg",8128039,"Freudenberg, Stadt",3768,1873,1895,0.49708067940552,3848,1910,1938,0.496361746361746,0.00659711656054247,0.3901600188325,0.603242864606958
8,"Baden-Württemberg",8128045,"Großrinderfeld",4011,2016,1995,0.50261780104712,4040,2045,1995,0.506188118811881,0.00659711656054247,0.3901600188325,0.603242864606958
8,"Baden-Württemberg",8128047,"Grünsfeld, Stadt",3664,1861,1803,0.507914847161572,3684,1882,1802,0.51085776330076,0.00659711656054247,0.3901600188325,0.603242864606958
8,"Baden-Württemberg",8128058,"Igersheim",5601,2762,2839,0.493126227459382,5673,2792,2881,0.492155825841706,0.00659711656054247,0.3901600188325,0.603242864606958
8,"Baden-Württemberg",8128061,"Königheim",3091,1539,1552,0.497897120672921,3125,1574,1551,0.50368,0.00659711656054247,0.3901600188325,0.603242864606958
8,"Baden-Württemberg",8128064,"Külsheim, Stadt",5329,2738,2591,0.513792456370801,5449,2858,2591,0.524499908240044,0.00659711656054247,0.3901600188325,0.603242864606958
8,"Baden-Württemberg",8128082,"Niederstetten, Stadt",4888,2491,2397,0.509615384615385,5169,2703,2466,0.522925130586187,0.00659711656054247,0.3901600188325,0.603242864606958
8,"Baden-Württemberg",8128115,"Tauberbischofsheim, Stadt",12770,6195,6575,0.485121378230227,13075,6427,6648,0.491548757170172,0.00659711656054247,0.3901600188325,0.603242864606958
8,"Baden-Württemberg",8128126,"Weikersheim, Stadt",7311,3607,3704,0.493366160579948,7356,3614,3742,0.491299619358347,0.00659711656054247,0.3901600188325,0.603242864606958
8,"Baden-Württemberg",8128128,"Werbach",3377,1688,1689,0.499851939591353,3435,1730,1705,0.503639010189229,0.00659711656054247,0.3901600188325,0.603242864606958
8,"Baden-Württemberg",8128131,"Wertheim, Stadt",22564,10983,11581,0.486748803403652,23521,11534,11987,0.49037030738489,0.00659711656054247,0.3901600188325,0.603242864606958
8,"Baden-Württemberg",8128137,"Wittighausen",1649,836,813,0.506973923590055,1681,861,820,0.51219512195122,0.00659711656054247,0.3901600188325,0.603242864606958
8,"Baden-Württemberg",8128138,"Ahorn",2190,1120,1070,0.511415525114155,2233,1130,1103,0.506045678459472,0.00659711656054247,0.3901600188325,0.603242864606958
8,"Baden-Württemberg",8128139,"Lauda-Königshofen, Stadt",14520,7184,7336,0.494765840220386,14556,7242,7314,0.497526793075021,0.00659711656054247,0.3901600188325,0.603242864606958
8,"Baden-Württemberg",8135010,"Dischingen",4354,2245,2109,0.515617822691778,4380,2283,2097,0.521232876712329,0.00659711656054247,0.3901600188325,0.603242864606958
8,"Baden-Württemberg",8135015,"Gerstetten",11553,5704,5849,0.4937245737038,11601,5750,5851,0.495646926989053,0.00659711656054247,0.3901600188325,0.603242864606958
8,"Baden-Württemberg",8135016,"Giengen an der Brenz, Stadt",18995,9385,9610,0.494077388786523,19436,9645,9791,0.49624408314468,0.00659711656054247,0.3901600188325,0.603242864606958
8,"Baden-Württemberg",8135019,"Heidenheim an der Brenz, Stadt",46063,22391,23672,0.486095130582029,48112,23424,24688,0.486863984037246,0.00659711656054247,0.3901600188325,0.603242864606958
8,"Baden-Württemberg",8135020,"Herbrechtingen, Stadt",12855,6276,6579,0.488214702450408,13107,6453,6654,0.49233234149691,0.00659711656054247,0.3901600188325,0.603242864606958
8,"Baden-Württemberg",8135021,"Hermaringen",2237,1143,1094,0.510952168082253,2268,1175,1093,0.518077601410935,0.00659711656054247,0.3901600188325,0.603242864606958
8,"Baden-Württemberg",8135025,"Königsbronn",7038,3468,3570,0.492753623188406,7054,3492,3562,0.495038276155373,0.00659711656054247,0.3901600188325,0.603242864606958
8,"Baden-Württemberg",8135026,"Nattheim",6180,3062,3118,0.49546925566343,6226,3092,3134,0.496627047863797,0.00659711656054247,0.3901600188325,0.603242864606958
8,"Baden-Württemberg",8135027,"Niederstotzingen, Stadt",4491,2220,2271,0.494321977287909,4555,2251,2304,0.494182217343578,0.00659711656054247,0.3901600188325,0.603242864606958
8,"Baden-Württemberg",8135031,"Sontheim an der Brenz",5426,2748,2678,0.506450423884998,5500,2796,2704,0.508363636363636,0.00659711656054247,0.3901600188325,0.603242864606958
8,"Baden-Württemberg",8135032,"Steinheim am Albuch",8499,4214,4285,0.495823038004471,8480,4236,4244,0.499528301886792,0.00659711656054247,0.3901600188325,0.603242864606958
8,"Baden-Württemberg",8136002,"Abtsgmünd",7257,3582,3675,0.493592393551054,7348,3638,3710,0.495100707675558,0.00659711656054247,0.3901600188325,0.603242864606958
8,"Baden-Württemberg",8136003,"Adelmannsfelden",1798,890,908,0.494994438264739,1815,903,912,0.497520661157025,0.00659711656054247,0.3901600188325,0.603242864606958
8,"Baden-Württemberg",8136007,"Bartholomä",2065,1005,1060,0.486682808716707,2141,1034,1107,0.482951891639421,0.00659711656054247,0.3901600188325,0.603242864606958
8,"Baden-Württemberg",8136009,"Böbingen an der Rems",4562,2283,2279,0.50043840420868,4601,2275,2326,0.494457726581178,0.00659711656054247,0.3901600188325,0.603242864606958
8,"Baden-Württemberg",8136010,"Bopfingen, Stadt",11887,5807,6080,0.488516867165811,12056,5945,6111,0.493115461181155,0.00659711656054247,0.3901600188325,0.603242864606958
8,"Baden-Württemberg",8136015,"Durlangen",2877,1474,1403,0.51233924226625,2854,1456,1398,0.510161177295025,0.00659711656054247,0.3901600188325,0.603242864606958
8,"Baden-Württemberg",8136018,"Ellenberg",1659,827,832,0.498493068113321,1688,856,832,0.507109004739337,0.00659711656054247,0.3901600188325,0.603242864606958
8,"Baden-Württemberg",8136019,"Ellwangen (Jagst), Stadt",23715,11557,12158,0.487328694918828,24600,12169,12431,0.494674796747967,0.00659711656054247,0.3901600188325,0.603242864606958
8,"Baden-Württemberg",8136020,"Eschach",1773,887,886,0.500282007896221,1798,911,887,0.506674082313682,0.00659711656054247,0.3901600188325,0.603242864606958
8,"Baden-Württemberg",8136021,"Essingen",6397,3201,3196,0.50039080819134,6397,3203,3194,0.500703454744411,0.00659711656054247,0.3901600188325,0.603242864606958
8,"Baden-Württemberg",8136024,"Göggingen",2454,1214,1240,0.494702526487368,2468,1211,1257,0.490680713128039,0.00659711656054247,0.3901600188325,0.603242864606958
8,"Baden-Württemberg",8136027,"Gschwend",4886,2451,2435,0.501637331150225,4932,2475,2457,0.501824817518248,0.00659711656054247,0.3901600188325,0.603242864606958
8,"Baden-Württemberg",8136028,"Heubach, Stadt",9668,4768,4900,0.493173355399255,10032,4962,5070,0.494617224880383,0.00659711656054247,0.3901600188325,0.603242864606958
8,"Baden-Württemberg",8136029,"Heuchlingen",1814,927,887,0.511025358324146,1812,924,888,0.509933774834437,0.00659711656054247,0.3901600188325,0.603242864606958
8,"Baden-Württemberg",8136033,"Hüttlingen",5915,2940,2975,0.497041420118343,5885,2929,2956,0.497706032285472,0.00659711656054247,0.3901600188325,0.603242864606958
8,"Baden-Württemberg",8136034,"Iggingen",2546,1261,1285,0.49528672427337,2558,1273,1285,0.497654417513683,0.00659711656054247,0.3901600188325,0.603242864606958
8,"Baden-Württemberg",8136035,"Jagstzell",2350,1186,1164,0.50468085106383,2397,1220,1177,0.508969545264914,0.00659711656054247,0.3901600188325,0.603242864606958
8,"Baden-Württemberg",8136037,"Kirchheim am Ries",1874,949,925,0.506403415154749,1894,969,925,0.511615628299894,0.00659711656054247,0.3901600188325,0.603242864606958
8,"Baden-Württemberg",8136038,"Lauchheim, Stadt",4682,2338,2344,0.499359248184537,4658,2323,2335,0.498711893516531,0.00659711656054247,0.3901600188325,0.603242864606958
8,"Baden-Württemberg",8136040,"Leinzell",2046,1002,1044,0.489736070381232,2061,994,1067,0.482290150412421,0.00659711656054247,0.3901600188325,0.603242864606958
8,"Baden-Württemberg",8136042,"Lorch, Stadt",10552,5224,5328,0.495072024260804,10977,5476,5501,0.4988612553521,0.00659711656054247,0.3901600188325,0.603242864606958
8,"Baden-Württemberg",8136043,"Mögglingen",4148,2033,2115,0.490115718418515,4149,2039,2110,0.491443721378645,0.00659711656054247,0.3901600188325,0.603242864606958
8,"Baden-Württemberg",8136044,"Mutlangen",6499,3161,3338,0.486382520387752,6564,3186,3378,0.485374771480804,0.00659711656054247,0.3901600188325,0.603242864606958
8,"Baden-Württemberg",8136045,"Neresheim, Stadt",7878,3991,3887,0.506600660066007,7965,4060,3905,0.509730069052103,0.00659711656054247,0.3901600188325,0.603242864606958
8,"Baden-Württemberg",8136046,"Neuler",3098,1564,1534,0.50484183344093,3143,1596,1547,0.507795100222717,0.00659711656054247,0.3901600188325,0.603242864606958
8,"Baden-Württemberg",8136049,"Obergröningen",466,250,216,0.536480686695279,461,245,216,0.531453362255965,0.00659711656054247,0.3901600188325,0.603242864606958
8,"Baden-Württemberg",8136050,"Oberkochen, Stadt",7710,3771,3939,0.489105058365759,7744,3801,3943,0.490831611570248,0.00659711656054247,0.3901600188325,0.603242864606958
8,"Baden-Württemberg",8136060,"Rosenberg",2675,1386,1289,0.518130841121495,2594,1353,1241,0.521588280647648,0.00659711656054247,0.3901600188325,0.603242864606958
8,"Baden-Württemberg",8136061,"Ruppertshofen",1802,933,869,0.517758046614872,1793,915,878,0.51031790295594,0.00659711656054247,0.3901600188325,0.603242864606958
8,"Baden-Württemberg",8136062,"Schechingen",2331,1136,1195,0.487344487344487,2325,1125,1200,0.483870967741935,0.00659711656054247,0.3901600188325,0.603242864606958
8,"Baden-Württemberg",8136065,"Schwäbisch Gmünd, Stadt",58191,28104,30087,0.482961282672578,59749,29072,30677,0.486568812867161,0.00659711656054247,0.3901600188325,0.603242864606958
8,"Baden-Württemberg",8136066,"Spraitbach",3308,1628,1680,0.492140266021765,3357,1655,1702,0.492999702114984,0.00659711656054247,0.3901600188325,0.603242864606958
8,"Baden-Württemberg",8136068,"Stödtlen",1948,981,967,0.503593429158111,2017,1012,1005,0.501735250371839,0.00659711656054247,0.3901600188325,0.603242864606958
8,"Baden-Württemberg",8136070,"Täferrot",1027,522,505,0.508276533592989,1011,509,502,0.503461918892186,0.00659711656054247,0.3901600188325,0.603242864606958
8,"Baden-Württemberg",8136071,"Tannhausen",1839,899,940,0.488852637302882,1843,914,929,0.495930548019533,0.00659711656054247,0.3901600188325,0.603242864606958
8,"Baden-Württemberg",8136075,"Unterschneidheim",4516,2333,2183,0.516607617360496,4579,2362,2217,0.515833151343088,0.00659711656054247,0.3901600188325,0.603242864606958
8,"Baden-Württemberg",8136079,"Waldstetten",7081,3460,3621,0.488631549216212,7124,3503,3621,0.49171813587872,0.00659711656054247,0.3901600188325,0.603242864606958
8,"Baden-Württemberg",8136082,"Westhausen",5853,2914,2939,0.497864343071929,5859,2915,2944,0.49752517494453,0.00659711656054247,0.3901600188325,0.603242864606958
8,"Baden-Württemberg",8136084,"Wört",1337,683,654,0.510845175766642,1362,687,675,0.504405286343612,0.00659711656054247,0.3901600188325,0.603242864606958
8,"Baden-Württemberg",8136087,"Riesbürg",2209,1084,1125,0.490719782707107,2224,1101,1123,0.495053956834532,0.00659711656054247,0.3901600188325,0.603242864606958
8,"Baden-Württemberg",8136088,"Aalen, Stadt",66410,32606,33804,0.490980274055112,66277,32780,33497,0.494590883715316,0.00659711656054247,0.3901600188325,0.603242864606958
8,"Baden-Württemberg",8136089,"Rainau",3322,1672,1650,0.503311258278146,3253,1664,1589,0.511527820473409,0.00659711656054247,0.3901600188325,0.603242864606958
8,"Baden-Württemberg",8211000,"Baden-Baden, Stadt",52424,24545,27879,0.468201587059362,54461,25481,28980,0.467876094820147,0.00659711656054247,0.3901600188325,0.603242864606958
8,"Baden-Württemberg",8212000,"Karlsruhe, Stadt",291995,145580,146415,0.49857018099625,297488,149559,147929,0.502739606303447,0.00659711656054247,0.3901600188325,0.603242864606958
8,"Baden-Württemberg",8215007,"Bretten, Stadt",27587,13515,14072,0.489904665240874,28467,14084,14383,0.494748305054976,0.00659711656054247,0.3901600188325,0.603242864606958
8,"Baden-Württemberg",8215009,"Bruchsal, Stadt",42161,20747,21414,0.49208984606627,43327,21560,21767,0.497611189327671,0.00659711656054247,0.3901600188325,0.603242864606958
8,"Baden-Württemberg",8215017,"Ettlingen, Stadt",38638,18711,19927,0.484264195869351,38507,18643,19864,0.484145739735632,0.00659711656054247,0.3901600188325,0.603242864606958
8,"Baden-Württemberg",8215021,"Forst",7796,3887,3909,0.498589020010262,7945,3978,3967,0.500692259282568,0.00659711656054247,0.3901600188325,0.603242864606958
8,"Baden-Württemberg",8215025,"Gondelsheim",3425,1706,1719,0.498102189781022,3403,1703,1700,0.500440787540406,0.00659711656054247,0.3901600188325,0.603242864606958
8,"Baden-Württemberg",8215029,"Hambrücken",5493,2751,2742,0.500819224467504,5479,2740,2739,0.500091257528746,0.00659711656054247,0.3901600188325,0.603242864606958
8,"Baden-Württemberg",8215039,"Kronau",5497,2717,2780,0.494269601600873,5504,2716,2788,0.493459302325581,0.00659711656054247,0.3901600188325,0.603242864606958
8,"Baden-Württemberg",8215040,"Kürnbach",2253,1103,1150,0.489569462938305,2286,1124,1162,0.491688538932633,0.00659711656054247,0.3901600188325,0.603242864606958
8,"Baden-Württemberg",8215046,"Malsch",14017,6926,7091,0.494114289790968,14504,7175,7329,0.49469111969112,0.00659711656054247,0.3901600188325,0.603242864606958
8,"Baden-Württemberg",8215047,"Marxzell",4981,2490,2491,0.499899618550492,5331,2643,2688,0.495779403489026,0.00659711656054247,0.3901600188325,0.603242864606958
8,"Baden-Württemberg",8215059,"Oberderdingen",10364,5120,5244,0.494017753763026,10428,5139,5289,0.492807825086306,0.00659711656054247,0.3901600188325,0.603242864606958
8,"Baden-Württemberg",8215064,"Östringen, Stadt",12521,6282,6239,0.501717115246386,12816,6447,6369,0.503043071161049,0.00659711656054247,0.3901600188325,0.603242864606958
8,"Baden-Württemberg",8215066,"Philippsburg, Stadt",12294,6175,6119,0.502277533756304,12428,6238,6190,0.501931123270035,0.00659711656054247,0.3901600188325,0.603242864606958
8,"Baden-Württemberg",8215082,"Sulzfeld",4579,2270,2309,0.495741428259445,4604,2307,2297,0.501086012163336,0.00659711656054247,0.3901600188325,0.603242864606958
8,"Baden-Württemberg",8215084,"Ubstadt-Weiher",12738,6317,6421,0.495917726487675,12880,6432,6448,0.499378881987578,0.00659711656054247,0.3901600188325,0.603242864606958
8,"Baden-Württemberg",8215089,"Walzbachtal",9241,4518,4723,0.488908126826101,9218,4467,4751,0.484595356910393,0.00659711656054247,0.3901600188325,0.603242864606958
8,"Baden-Württemberg",8215090,"Weingarten (Baden)",9938,4847,5091,0.487723888106259,10067,4930,5137,0.489718883480679,0.00659711656054247,0.3901600188325,0.603242864606958
8,"Baden-Württemberg",8215094,"Zaisenhausen",1655,852,803,0.514803625377643,1695,876,819,0.516814159292035,0.00659711656054247,0.3901600188325,0.603242864606958
8,"Baden-Württemberg",8215096,"Karlsbad",15550,7531,8019,0.484308681672026,15674,7630,8044,0.486793415847901,0.00659711656054247,0.3901600188325,0.603242864606958
8,"Baden-Württemberg",8215097,"Kraichtal, Stadt",14493,7140,7353,0.492651624922376,14894,7410,7484,0.497515778165704,0.00659711656054247,0.3901600188325,0.603242864606958
8,"Baden-Württemberg",8215099,"Graben-Neudorf",11571,5723,5848,0.494598565378965,11577,5777,5800,0.499006651118597,0.00659711656054247,0.3901600188325,0.603242864606958
8,"Baden-Württemberg",8215100,"Bad Schönborn",12306,5987,6319,0.486510645213717,12679,6215,6464,0.490180613613061,0.00659711656054247,0.3901600188325,0.603242864606958
8,"Baden-Württemberg",8215101,"Pfinztal",17664,8628,9036,0.488451086956522,17804,8690,9114,0.488092563468883,0.00659711656054247,0.3901600188325,0.603242864606958
8,"Baden-Württemberg",8215102,"Eggenstein-Leopoldshafen",15594,7609,7985,0.487944081056817,16135,7883,8252,0.48856523086458,0.00659711656054247,0.3901600188325,0.603242864606958
8,"Baden-Württemberg",8215103,"Karlsdorf-Neuthard",9978,4954,5024,0.49649228302265,10065,5022,5043,0.498956780923994,0.00659711656054247,0.3901600188325,0.603242864606958
8,"Baden-Württemberg",8215105,"Linkenheim-Hochstetten",11592,5646,5946,0.487060041407868,11984,5932,6052,0.494993324432577,0.00659711656054247,0.3901600188325,0.603242864606958
8,"Baden-Württemberg",8215106,"Waghäusel, Stadt",19945,9716,10229,0.487139633993482,20659,10205,10454,0.493973570840796,0.00659711656054247,0.3901600188325,0.603242864606958
8,"Baden-Württemberg",8215107,"Oberhausen-Rheinhausen",9439,4628,4811,0.490306176501748,9524,4650,4874,0.488240235195296,0.00659711656054247,0.3901600188325,0.603242864606958
8,"Baden-Württemberg",8215108,"Rheinstetten, Stadt",19837,9455,10382,0.476634571759843,20495,9861,10634,0.481141741888265,0.00659711656054247,0.3901600188325,0.603242864606958
8,"Baden-Württemberg",8215109,"Stutensee, Stadt",23061,11247,11814,0.487706517497073,23608,11719,11889,0.496399525584548,0.00659711656054247,0.3901600188325,0.603242864606958
8,"Baden-Württemberg",8215110,"Waldbronn",11861,5849,6012,0.493128741252845,12486,6204,6282,0.496876501681884,0.00659711656054247,0.3901600188325,0.603242864606958
8,"Baden-Württemberg",8215111,"Dettenheim",6441,3241,3200,0.503182735600062,6504,3280,3224,0.504305043050431,0.00659711656054247,0.3901600188325,0.603242864606958
8,"Baden-Württemberg",8216002,"Au am Rhein",3287,1627,1660,0.494980225129297,3340,1651,1689,0.494311377245509,0.00659711656054247,0.3901600188325,0.603242864606958
8,"Baden-Württemberg",8216005,"Bietigheim",6077,2911,3166,0.479019252920849,6086,2922,3164,0.480118304304962,0.00659711656054247,0.3901600188325,0.603242864606958
8,"Baden-Württemberg",8216006,"Bischweier",3026,1472,1554,0.486450760079313,3120,1503,1617,0.481730769230769,0.00659711656054247,0.3901600188325,0.603242864606958
8,"Baden-Württemberg",8216007,"Bühl, Stadt",28470,13766,14704,0.483526519142958,29489,14384,15105,0.487775102580623,0.00659711656054247,0.3901600188325,0.603242864606958
8,"Baden-Württemberg",8216008,"Bühlertal",7954,3963,3991,0.49823987930601,7942,3956,3986,0.498111306975573,0.00659711656054247,0.3901600188325,0.603242864606958
8,"Baden-Württemberg",8216009,"Durmersheim",11740,5783,5957,0.492589437819421,12202,6055,6147,0.496230126208818,0.00659711656054247,0.3901600188325,0.603242864606958
8,"Baden-Württemberg",8216012,"Elchesheim-Illingen",3224,1610,1614,0.499379652605459,3266,1626,1640,0.497856705450092,0.00659711656054247,0.3901600188325,0.603242864606958
8,"Baden-Württemberg",8216013,"Forbach",4912,2426,2486,0.493892508143322,5177,2557,2620,0.493915395016419,0.00659711656054247,0.3901600188325,0.603242864606958
8,"Baden-Württemberg",8216015,"Gaggenau, Stadt",28550,13857,14693,0.485359019264448,28850,13989,14861,0.484887348353553,0.00659711656054247,0.3901600188325,0.603242864606958
8,"Baden-Württemberg",8216017,"Gernsbach, Stadt",13719,6724,6995,0.490123186821197,14307,7063,7244,0.493674425106591,0.00659711656054247,0.3901600188325,0.603242864606958
8,"Baden-Württemberg",8216022,"Hügelsheim",4980,2500,2480,0.502008032128514,5017,2530,2487,0.504285429539565,0.00659711656054247,0.3901600188325,0.603242864606958
8,"Baden-Württemberg",8216023,"Iffezheim",4753,2358,2395,0.496107721439091,4905,2450,2455,0.499490316004077,0.00659711656054247,0.3901600188325,0.603242864606958
8,"Baden-Württemberg",8216024,"Kuppenheim, Stadt",7825,3845,3980,0.491373801916933,7957,3935,4022,0.49453311549579,0.00659711656054247,0.3901600188325,0.603242864606958
8,"Baden-Württemberg",8216028,"Lichtenau, Stadt",4914,2449,2465,0.498371998371998,4987,2474,2513,0.496089833567275,0.00659711656054247,0.3901600188325,0.603242864606958
8,"Baden-Württemberg",8216029,"Loffenau",2525,1257,1268,0.497821782178218,2566,1290,1276,0.502727981293843,0.00659711656054247,0.3901600188325,0.603242864606958
8,"Baden-Württemberg",8216033,"Muggensturm",6156,3033,3123,0.492690058479532,6150,3031,3119,0.492845528455285,0.00659711656054247,0.3901600188325,0.603242864606958
8,"Baden-Württemberg",8216039,"Ötigheim",4522,2258,2264,0.499336576735958,4523,2266,2257,0.500994914879505,0.00659711656054247,0.3901600188325,0.603242864606958
8,"Baden-Württemberg",8216041,"Ottersweier",5856,2927,2929,0.499829234972678,6043,3045,2998,0.503888796955155,0.00659711656054247,0.3901600188325,0.603242864606958
8,"Baden-Württemberg",8216043,"Rastatt, Stadt",46769,22789,23980,0.48726720691056,47663,23416,24247,0.491282546209848,0.00659711656054247,0.3901600188325,0.603242864606958
8,"Baden-Württemberg",8216049,"Sinzheim",10863,5303,5560,0.488170855196539,11224,5470,5754,0.487348538845331,0.00659711656054247,0.3901600188325,0.603242864606958
8,"Baden-Württemberg",8216052,"Steinmauern",2957,1479,1478,0.500169090294217,3009,1511,1498,0.502160186108342,0.00659711656054247,0.3901600188325,0.603242864606958
8,"Baden-Württemberg",8216059,"Weisenbach",2495,1254,1241,0.502605210420842,2503,1273,1230,0.508589692369157,0.00659711656054247,0.3901600188325,0.603242864606958
8,"Baden-Württemberg",8216063,"Rheinmünster",6627,3344,3283,0.504602384185906,6576,3346,3230,0.508819951338199,0.00659711656054247,0.3901600188325,0.603242864606958
8,"Baden-Württemberg",8221000,"Heidelberg, Stadt",148415,70128,78287,0.472512886163797,149633,70991,78642,0.474434115469181,0.00659711656054247,0.3901600188325,0.603242864606958
8,"Baden-Württemberg",8222000,"Mannheim, Universitätsstadt",291458,142730,148728,0.489710352778102,314931,156890,158041,0.498172615588812,0.00659711656054247,0.3901600188325,0.603242864606958
8,"Baden-Württemberg",8225001,"Adelsheim, Stadt",4911,2543,2368,0.51781714518428,5302,2827,2475,0.533195020746888,0.00659711656054247,0.3901600188325,0.603242864606958
8,"Baden-Württemberg",8225002,"Aglasterhausen",4841,2359,2482,0.487296013220409,4893,2393,2500,0.489066012671163,0.00659711656054247,0.3901600188325,0.603242864606958
8,"Baden-Württemberg",8225009,"Billigheim",5753,2899,2854,0.50391100295498,5722,2897,2825,0.506291506466271,0.00659711656054247,0.3901600188325,0.603242864606958
8,"Baden-Württemberg",8225010,"Binau",1382,707,675,0.511577424023155,1398,721,677,0.515736766809728,0.00659711656054247,0.3901600188325,0.603242864606958
8,"Baden-Württemberg",8225014,"Buchen (Odenwald), Stadt",17720,8704,9016,0.491196388261851,18163,8995,9168,0.495237570885867,0.00659711656054247,0.3901600188325,0.603242864606958
8,"Baden-Württemberg",8225024,"Fahrenbach",2784,1372,1412,0.492816091954023,2798,1389,1409,0.496426018584703,0.00659711656054247,0.3901600188325,0.603242864606958
8,"Baden-Württemberg",8225032,"Hardheim",6816,3388,3428,0.497065727699531,7085,3579,3506,0.50515172900494,0.00659711656054247,0.3901600188325,0.603242864606958
8,"Baden-Württemberg",8225033,"Haßmersheim",4824,2392,2432,0.495854063018242,4850,2417,2433,0.498350515463918,0.00659711656054247,0.3901600188325,0.603242864606958
8,"Baden-Württemberg",8225039,"Höpfingen",3089,1524,1565,0.49336354807381,3140,1553,1587,0.494585987261146,0.00659711656054247,0.3901600188325,0.603242864606958
8,"Baden-Württemberg",8225042,"Hüffenhardt",2029,985,1044,0.485460818137013,2035,982,1053,0.482555282555283,0.00659711656054247,0.3901600188325,0.603242864606958
8,"Baden-Württemberg",8225052,"Limbach",4431,2195,2236,0.495373504852178,4455,2227,2228,0.499887766554433,0.00659711656054247,0.3901600188325,0.603242864606958
8,"Baden-Württemberg",8225058,"Mosbach, Stadt",23017,11234,11783,0.488074032237042,24233,11962,12271,0.493624396484133,0.00659711656054247,0.3901600188325,0.603242864606958
8,"Baden-Württemberg",8225060,"Mudau",4876,2461,2415,0.504716981132076,4918,2508,2410,0.509963399755998,0.00659711656054247,0.3901600188325,0.603242864606958
8,"Baden-Württemberg",8225064,"Neckargerach",2339,1125,1214,0.480974775545105,2322,1129,1193,0.486218776916451,0.00659711656054247,0.3901600188325,0.603242864606958
8,"Baden-Württemberg",8225067,"Neckarzimmern",1535,758,777,0.493811074918567,1529,748,781,0.489208633093525,0.00659711656054247,0.3901600188325,0.603242864606958
8,"Baden-Württemberg",8225068,"Neunkirchen",1830,890,940,0.486338797814208,1834,898,936,0.489640130861505,0.00659711656054247,0.3901600188325,0.603242864606958
8,"Baden-Württemberg",8225074,"Obrigheim",5141,2506,2635,0.487453802762109,5210,2573,2637,0.493857965451056,0.00659711656054247,0.3901600188325,0.603242864606958
8,"Baden-Württemberg",8225075,"Osterburken, Stadt",6433,3234,3199,0.50272034820457,6536,3303,3233,0.505354957160343,0.00659711656054247,0.3901600188325,0.603242864606958
8,"Baden-Württemberg",8225082,"Rosenberg",2067,1035,1032,0.500725689404935,2122,1064,1058,0.501413760603205,0.00659711656054247,0.3901600188325,0.603242864606958
8,"Baden-Württemberg",8225091,"Seckach",4191,2120,2071,0.505845860176569,4283,2179,2104,0.508755545178613,0.00659711656054247,0.3901600188325,0.603242864606958
8,"Baden-Württemberg",8225109,"Walldürn, Stadt",11304,5649,5655,0.499734607218684,11691,5877,5814,0.502694380292533,0.00659711656054247,0.3901600188325,0.603242864606958
8,"Baden-Württemberg",8225113,"Zwingenberg",697,347,350,0.497847919655667,652,326,326,0.5,0.00659711656054247,0.3901600188325,0.603242864606958
8,"Baden-Württemberg",8225114,"Ravenstein, Stadt",2865,1485,1380,0.518324607329843,2934,1517,1417,0.517041581458759,0.00659711656054247,0.3901600188325,0.603242864606958
8,"Baden-Württemberg",8225115,"Schefflenz",4013,1980,2033,0.493396461500125,4113,2035,2078,0.49477267201556,0.00659711656054247,0.3901600188325,0.603242864606958
8,"Baden-Württemberg",8225116,"Schwarzach",2937,1554,1383,0.529111338100102,3195,1712,1483,0.535837245696401,0.00659711656054247,0.3901600188325,0.603242864606958
8,"Baden-Württemberg",8225117,"Elztal",5930,2980,2950,0.502529510961214,5967,3033,2934,0.508295625942685,0.00659711656054247,0.3901600188325,0.603242864606958
8,"Baden-Württemberg",8225118,"Waldbrunn",4680,2256,2424,0.482051282051282,4778,2348,2430,0.491419003767267,0.00659711656054247,0.3901600188325,0.603242864606958
8,"Baden-Württemberg",8226003,"Altlußheim",5361,2620,2741,0.488714792016415,5267,2553,2714,0.48471615720524,0.00659711656054247,0.3901600188325,0.603242864606958
8,"Baden-Württemberg",8226006,"Bammental",6371,3067,3304,0.481400094176738,6511,3186,3325,0.489325756412225,0.00659711656054247,0.3901600188325,0.603242864606958
8,"Baden-Württemberg",8226009,"Brühl",13848,6567,7281,0.474220103986135,14181,6771,7410,0.47746985403004,0.00659711656054247,0.3901600188325,0.603242864606958
8,"Baden-Württemberg",8226010,"Dielheim",8808,4379,4429,0.497161671207993,8799,4360,4439,0.49551085350608,0.00659711656054247,0.3901600188325,0.603242864606958
8,"Baden-Württemberg",8226012,"Dossenheim",12004,5687,6317,0.473758747084305,12688,6079,6609,0.479114123581337,0.00659711656054247,0.3901600188325,0.603242864606958
8,"Baden-Württemberg",8226013,"Eberbach, Stadt",14421,6894,7527,0.478052839608904,14783,7054,7729,0.477169721977948,0.00659711656054247,0.3901600188325,0.603242864606958
8,"Baden-Württemberg",8226017,"Epfenbach",2483,1266,1217,0.509867096254531,2488,1273,1215,0.511655948553055,0.00659711656054247,0.3901600188325,0.603242864606958
8,"Baden-Württemberg",8226018,"Eppelheim, Stadt",14808,7129,7679,0.481428957320367,15069,7356,7713,0.488154489348995,0.00659711656054247,0.3901600188325,0.603242864606958
8,"Baden-Württemberg",8226020,"Eschelbronn",2571,1291,1280,0.502139245429794,2515,1276,1239,0.507355864811133,0.00659711656054247,0.3901600188325,0.603242864606958
8,"Baden-Württemberg",8226022,"Gaiberg",2317,1120,1197,0.483383685800604,2670,1411,1259,0.528464419475655,0.00659711656054247,0.3901600188325,0.603242864606958
8,"Baden-Württemberg",8226027,"Heddesbach",477,235,242,0.492662473794549,471,229,242,0.48619957537155,0.00659711656054247,0.3901600188325,0.603242864606958
8,"Baden-Württemberg",8226028,"Heddesheim",11125,5359,5766,0.481707865168539,11589,5611,5978,0.484166019501251,0.00659711656054247,0.3901600188325,0.603242864606958
8,"Baden-Württemberg",8226029,"Heiligkreuzsteinach",2659,1319,1340,0.496051147047762,2861,1477,1384,0.516253058371199,0.00659711656054247,0.3901600188325,0.603242864606958
8,"Baden-Württemberg",8226031,"Hemsbach, Stadt",11919,5764,6155,0.483597617249769,12235,6062,6173,0.495463833265223,0.00659711656054247,0.3901600188325,0.603242864606958
8,"Baden-Württemberg",8226032,"Hockenheim, Stadt",20770,10162,10608,0.489263360616273,21168,10418,10750,0.492157974300831,0.00659711656054247,0.3901600188325,0.603242864606958
8,"Baden-Württemberg",8226036,"Ilvesheim",8597,4163,4434,0.484238687914389,8705,4216,4489,0.484319356691557,0.00659711656054247,0.3901600188325,0.603242864606958
8,"Baden-Württemberg",8226037,"Ketsch",12608,6060,6548,0.480647208121827,12780,6253,6527,0.489280125195618,0.00659711656054247,0.3901600188325,0.603242864606958
8,"Baden-Württemberg",8226038,"Ladenburg, Stadt",11224,5339,5885,0.475677120456165,11441,5522,5919,0.482650117996679,0.00659711656054247,0.3901600188325,0.603242864606958
8,"Baden-Württemberg",8226040,"Laudenbach",6010,2980,3030,0.495840266222962,6014,2949,3065,0.490355836381776,0.00659711656054247,0.3901600188325,0.603242864606958
8,"Baden-Württemberg",8226041,"Leimen, Stadt",25475,12317,13158,0.483493621197252,27470,13472,13998,0.490425919184565,0.00659711656054247,0.3901600188325,0.603242864606958
8,"Baden-Württemberg",8226046,"Malsch",3488,1718,1770,0.492545871559633,3518,1741,1777,0.49488345650938,0.00659711656054247,0.3901600188325,0.603242864606958
8,"Baden-Württemberg",8226048,"Mauer",3977,1900,2077,0.477747045511692,3963,1930,2033,0.487004794347716,0.00659711656054247,0.3901600188325,0.603242864606958
8,"Baden-Württemberg",8226049,"Meckesheim",5033,2490,2543,0.494734750645738,5248,2638,2610,0.502667682926829,0.00659711656054247,0.3901600188325,0.603242864606958
8,"Baden-Württemberg",8226054,"Mühlhausen",8158,4069,4089,0.49877420936504,8218,4114,4104,0.500608420540277,0.00659711656054247,0.3901600188325,0.603242864606958
8,"Baden-Württemberg",8226055,"Neckarbischofsheim, Stadt",3899,1935,1964,0.496281097717363,3954,1959,1995,0.495447647951442,0.00659711656054247,0.3901600188325,0.603242864606958
8,"Baden-Württemberg",8226056,"Neckargemünd, Stadt",12910,6263,6647,0.485127807900852,13834,6800,7034,0.491542576261385,0.00659711656054247,0.3901600188325,0.603242864606958
8,"Baden-Württemberg",8226058,"Neidenstein",1856,916,940,0.493534482758621,1836,905,931,0.492919389978213,0.00659711656054247,0.3901600188325,0.603242864606958
8,"Baden-Württemberg",8226059,"Neulußheim",6533,3220,3313,0.492882289912751,6623,3234,3389,0.488298354220142,0.00659711656054247,0.3901600188325,0.603242864606958
8,"Baden-Württemberg",8226060,"Nußloch",10478,5162,5316,0.492651269326207,10701,5202,5499,0.486122792262405,0.00659711656054247,0.3901600188325,0.603242864606958
8,"Baden-Württemberg",8226062,"Oftersheim",11278,5428,5850,0.481291009044157,11298,5417,5881,0.479465392104797,0.00659711656054247,0.3901600188325,0.603242864606958
8,"Baden-Württemberg",8226063,"Plankstadt",9742,4695,5047,0.48193389447752,9775,4709,5066,0.481739130434783,0.00659711656054247,0.3901600188325,0.603242864606958
8,"Baden-Württemberg",8226065,"Rauenberg, Stadt",8042,4006,4036,0.498134792340214,8049,4032,4017,0.500931792769288,0.00659711656054247,0.3901600188325,0.603242864606958
8,"Baden-Württemberg",8226066,"Reichartshausen",2044,1015,1029,0.496575342465753,2061,1027,1034,0.498301795245027,0.00659711656054247,0.3901600188325,0.603242864606958
8,"Baden-Württemberg",8226068,"Reilingen",7122,3506,3616,0.492277450154451,7150,3517,3633,0.491888111888112,0.00659711656054247,0.3901600188325,0.603242864606958
8,"Baden-Württemberg",8226076,"Sandhausen",14376,6952,7424,0.483583750695604,14556,7019,7537,0.482206650178621,0.00659711656054247,0.3901600188325,0.603242864606958
8,"Baden-Württemberg",8226080,"Schönau, Stadt",4434,2192,2242,0.494361750112765,4499,2215,2284,0.492331629250945,0.00659711656054247,0.3901600188325,0.603242864606958
8,"Baden-Württemberg",8226081,"Schönbrunn",2855,1441,1414,0.504728546409807,2884,1473,1411,0.510748959778086,0.00659711656054247,0.3901600188325,0.603242864606958
8,"Baden-Württemberg",8226082,"Schriesheim, Stadt",14603,7068,7535,0.484010134903787,14917,7269,7648,0.487296373265402,0.00659711656054247,0.3901600188325,0.603242864606958
8,"Baden-Württemberg",8226084,"Schwetzingen, Stadt",21115,10104,11011,0.478522377456784,21911,10569,11342,0.482360458217334,0.00659711656054247,0.3901600188325,0.603242864606958
8,"Baden-Württemberg",8226085,"Sinsheim, Stadt",34682,17144,17538,0.49431982007958,35373,17487,17886,0.494360105164956,0.00659711656054247,0.3901600188325,0.603242864606958
8,"Baden-Württemberg",8226086,"Spechbach",1785,882,903,0.494117647058824,1791,898,893,0.501395868230039,0.00659711656054247,0.3901600188325,0.603242864606958
8,"Baden-Württemberg",8226091,"Waibstadt, Stadt",5608,2737,2871,0.488052781740371,5687,2791,2896,0.490768419201688,0.00659711656054247,0.3901600188325,0.603242864606958
8,"Baden-Württemberg",8226095,"Walldorf, Stadt",14405,7130,7275,0.494967025338424,14957,7498,7459,0.501303737380491,0.00659711656054247,0.3901600188325,0.603242864606958
8,"Baden-Württemberg",8226096,"Weinheim, Stadt",43170,20899,22271,0.484109335186472,44008,21398,22610,0.48622977640429,0.00659711656054247,0.3901600188325,0.603242864606958
8,"Baden-Württemberg",8226097,"Wiesenbach",3059,1466,1593,0.479241582216411,3097,1486,1611,0.479819179851469,0.00659711656054247,0.3901600188325,0.603242864606958
8,"Baden-Württemberg",8226098,"Wiesloch, Stadt",24828,12068,12760,0.486064121153536,26178,12847,13331,0.490755596302239,0.00659711656054247,0.3901600188325,0.603242864606958
8,"Baden-Württemberg",8226099,"Wilhelmsfeld",3192,1552,1640,0.486215538847118,3266,1595,1671,0.488364972443356,0.00659711656054247,0.3901600188325,0.603242864606958
8,"Baden-Württemberg",8226101,"Zuzenhausen",2180,1084,1096,0.497247706422018,2176,1078,1098,0.495404411764706,0.00659711656054247,0.3901600188325,0.603242864606958
8,"Baden-Württemberg",8226102,"Angelbachtal",4906,2354,2552,0.479820627802691,5014,2410,2604,0.48065416832868,0.00659711656054247,0.3901600188325,0.603242864606958
8,"Baden-Württemberg",8226103,"St. Leon-Rot",12633,6277,6356,0.496873268423969,12894,6434,6460,0.498991779122072,0.00659711656054247,0.3901600188325,0.603242864606958
8,"Baden-Württemberg",8226104,"Lobbach",2367,1172,1195,0.495141529362062,2397,1193,1204,0.497705465164789,0.00659711656054247,0.3901600188325,0.603242864606958
8,"Baden-Württemberg",8226105,"Edingen-Neckarhausen",13753,6547,7206,0.476041590925616,14493,6965,7528,0.480576830193887,0.00659711656054247,0.3901600188325,0.603242864606958
8,"Baden-Württemberg",8226106,"Helmstadt-Bargen",3713,1855,1858,0.499596014004848,3646,1812,1834,0.496982995063083,0.00659711656054247,0.3901600188325,0.603242864606958
8,"Baden-Württemberg",8226107,"Hirschberg an der Bergstraße",9124,4397,4727,0.481915826391933,9455,4560,4895,0.482284505552618,0.00659711656054247,0.3901600188325,0.603242864606958
8,"Baden-Württemberg",8231000,"Pforzheim, Stadt",115211,55781,59430,0.484163838522363,120709,58646,62063,0.485846125806692,0.00659711656054247,0.3901600188325,0.603242864606958
8,"Baden-Württemberg",8235006,"Altensteig, Stadt",10246,5053,5193,0.49316806558657,10806,5356,5450,0.495650564501203,0.00659711656054247,0.3901600188325,0.603242864606958
8,"Baden-Württemberg",8235007,"Althengstett",7804,3891,3913,0.498590466427473,7883,3943,3940,0.500190282887226,0.00659711656054247,0.3901600188325,0.603242864606958
8,"Baden-Württemberg",8235008,"Bad Liebenzell, Stadt",8681,4174,4507,0.480820182006681,9295,4463,4832,0.480150618612157,0.00659711656054247,0.3901600188325,0.603242864606958
8,"Baden-Württemberg",8235018,"Dobel",2177,1058,1119,0.485989894350023,2257,1129,1128,0.500221533008418,0.00659711656054247,0.3901600188325,0.603242864606958
8,"Baden-Württemberg",8235020,"Ebhausen",4713,2377,2336,0.504349671122427,4739,2408,2331,0.508124076809453,0.00659711656054247,0.3901600188325,0.603242864606958
8,"Baden-Württemberg",8235022,"Egenhausen",1926,964,962,0.500519210799585,1880,954,926,0.507446808510638,0.00659711656054247,0.3901600188325,0.603242864606958
8,"Baden-Württemberg",8235025,"Enzklösterle",1213,592,621,0.488046166529266,1216,575,641,0.472861842105263,0.00659711656054247,0.3901600188325,0.603242864606958
8,"Baden-Württemberg",8235029,"Gechingen",3624,1790,1834,0.4939293598234,3784,1872,1912,0.494714587737844,0.00659711656054247,0.3901600188325,0.603242864606958
8,"Baden-Württemberg",8235032,"Haiterbach, Stadt",5633,2774,2859,0.492455174862418,5690,2794,2896,0.49103690685413,0.00659711656054247,0.3901600188325,0.603242864606958
8,"Baden-Württemberg",8235033,"Bad Herrenalb, Stadt",7162,3461,3701,0.483244903658196,7389,3577,3812,0.48409798348897,0.00659711656054247,0.3901600188325,0.603242864606958
8,"Baden-Württemberg",8235035,"Höfen an der Enz",1611,818,793,0.507759155803849,1617,823,794,0.508967223252938,0.00659711656054247,0.3901600188325,0.603242864606958
8,"Baden-Württemberg",8235046,"Nagold, Stadt",21107,10283,10824,0.487184346425357,22492,10950,11542,0.486839765249867,0.00659711656054247,0.3901600188325,0.603242864606958
8,"Baden-Württemberg",8235047,"Neubulach, Stadt",5448,2693,2755,0.494309838472834,5469,2717,2752,0.496800146279027,0.00659711656054247,0.3901600188325,0.603242864606958
8,"Baden-Württemberg",8235050,"Neuweiler",3096,1610,1486,0.520025839793282,3091,1627,1464,0.526366871562601,0.00659711656054247,0.3901600188325,0.603242864606958
8,"Baden-Württemberg",8235055,"Oberreichenbach",2791,1387,1404,0.496954496596202,2818,1405,1413,0.498580553584102,0.00659711656054247,0.3901600188325,0.603242864606958
8,"Baden-Württemberg",8235057,"Ostelsheim",2414,1207,1207,0.5,2437,1240,1197,0.508822322527698,0.00659711656054247,0.3901600188325,0.603242864606958
8,"Baden-Württemberg",8235060,"Rohrdorf",1899,952,947,0.501316482359136,1920,972,948,0.50625,0.00659711656054247,0.3901600188325,0.603242864606958
8,"Baden-Württemberg",8235065,"Schömberg",7824,3803,4021,0.486068507157464,8459,4204,4255,0.496985459274146,0.00659711656054247,0.3901600188325,0.603242864606958
8,"Baden-Württemberg",8235066,"Simmersfeld",2067,1045,1022,0.505563618771166,2125,1077,1048,0.506823529411765,0.00659711656054247,0.3901600188325,0.603242864606958
8,"Baden-Württemberg",8235067,"Simmozheim",2911,1419,1492,0.487461353486774,2848,1400,1448,0.491573033707865,0.00659711656054247,0.3901600188325,0.603242864606958
8,"Baden-Württemberg",8235073,"Unterreichenbach",2249,1083,1166,0.481547354379724,2229,1085,1144,0.486765365634814,0.00659711656054247,0.3901600188325,0.603242864606958
8,"Baden-Württemberg",8235079,"Bad Wildbad, Stadt",9537,4662,4875,0.488832966341617,10393,5082,5311,0.488982969306264,0.00659711656054247,0.3901600188325,0.603242864606958
8,"Baden-Württemberg",8235080,"Wildberg, Stadt",9723,4814,4909,0.495114676540163,9858,4869,4989,0.493913572732806,0.00659711656054247,0.3901600188325,0.603242864606958
8,"Baden-Württemberg",8235084,"Bad Teinach-Zavelstein, Stadt",3008,1508,1500,0.501329787234043,3006,1499,1507,0.498669328010645,0.00659711656054247,0.3901600188325,0.603242864606958
8,"Baden-Württemberg",8235085,"Calw, Stadt",22126,11035,11091,0.498734520473651,23218,11659,11559,0.502153501593591,0.00659711656054247,0.3901600188325,0.603242864606958
8,"Baden-Württemberg",8236004,"Birkenfeld",10110,4935,5175,0.48813056379822,10499,5165,5334,0.49195161443947,0.00659711656054247,0.3901600188325,0.603242864606958
8,"Baden-Württemberg",8236011,"Eisingen",4533,2167,2366,0.478049856607103,4517,2172,2345,0.480850121762232,0.00659711656054247,0.3901600188325,0.603242864606958
8,"Baden-Württemberg",8236013,"Engelsbrand",4282,2065,2217,0.48225128444652,4309,2073,2236,0.481086098862845,0.00659711656054247,0.3901600188325,0.603242864606958
8,"Baden-Württemberg",8236019,"Friolzheim",3728,1842,1886,0.494098712446352,3676,1817,1859,0.494287268770403,0.00659711656054247,0.3901600188325,0.603242864606958
8,"Baden-Württemberg",8236025,"Heimsheim, Stadt",4933,2617,2316,0.530508818163389,5451,3134,2317,0.57494037791231,0.00659711656054247,0.3901600188325,0.603242864606958
8,"Baden-Württemberg",8236028,"Illingen",7212,3560,3652,0.493621741541875,7146,3537,3609,0.494962216624685,0.00659711656054247,0.3901600188325,0.603242864606958
8,"Baden-Württemberg",8236030,"Ispringen",5971,2857,3114,0.478479316697371,5979,2867,3112,0.479511624017394,0.00659711656054247,0.3901600188325,0.603242864606958
8,"Baden-Württemberg",8236031,"Kieselbronn",2949,1422,1527,0.482197355035605,2948,1426,1522,0.483717774762551,0.00659711656054247,0.3901600188325,0.603242864606958
8,"Baden-Württemberg",8236033,"Knittlingen, Stadt",7822,3836,3986,0.490411659422143,7731,3753,3978,0.485448195576251,0.00659711656054247,0.3901600188325,0.603242864606958
8,"Baden-Württemberg",8236038,"Maulbronn, Stadt",6317,3059,3258,0.484248852303309,6449,3141,3308,0.487052256163746,0.00659711656054247,0.3901600188325,0.603242864606958
8,"Baden-Württemberg",8236039,"Mönsheim",2641,1331,1310,0.503975766755017,2671,1344,1327,0.503182328715837,0.00659711656054247,0.3901600188325,0.603242864606958
8,"Baden-Württemberg",8236040,"Mühlacker, Stadt",24720,12110,12610,0.489886731391586,25317,12613,12704,0.498202788640044,0.00659711656054247,0.3901600188325,0.603242864606958
8,"Baden-Württemberg",8236043,"Neuenbürg, Stadt",7382,3663,3719,0.496206989975616,7487,3708,3779,0.495258447976493,0.00659711656054247,0.3901600188325,0.603242864606958
8,"Baden-Württemberg",8236044,"Neuhausen",5191,2542,2649,0.489693700635716,5243,2578,2665,0.491703223345413,0.00659711656054247,0.3901600188325,0.603242864606958
8,"Baden-Württemberg",8236046,"Niefern-Öschelbronn",11760,5669,6091,0.482057823129252,11826,5628,6198,0.475900558092339,0.00659711656054247,0.3901600188325,0.603242864606958
8,"Baden-Württemberg",8236050,"Ötisheim",4694,2329,2365,0.496165317426502,4793,2382,2411,0.496974754850824,0.00659711656054247,0.3901600188325,0.603242864606958
8,"Baden-Württemberg",8236061,"Sternenfels",2770,1379,1391,0.497833935018051,2783,1395,1388,0.501257635644987,0.00659711656054247,0.3901600188325,0.603242864606958
8,"Baden-Württemberg",8236062,"Tiefenbronn",5065,2523,2542,0.49812438302073,5286,2656,2630,0.502459326522891,0.00659711656054247,0.3901600188325,0.603242864606958
8,"Baden-Württemberg",8236065,"Wiernsheim",6448,3234,3214,0.501550868486352,6552,3290,3262,0.502136752136752,0.00659711656054247,0.3901600188325,0.603242864606958
8,"Baden-Württemberg",8236067,"Wimsheim",2609,1286,1323,0.49290916059793,2673,1334,1339,0.499064721286944,0.00659711656054247,0.3901600188325,0.603242864606958
8,"Baden-Württemberg",8236068,"Wurmberg",2937,1426,1511,0.485529451821587,2989,1458,1531,0.487788558046169,0.00659711656054247,0.3901600188325,0.603242864606958
8,"Baden-Württemberg",8236070,"Keltern",9093,4389,4704,0.482678983833718,9022,4358,4664,0.48304145422301,0.00659711656054247,0.3901600188325,0.603242864606958
8,"Baden-Württemberg",8236071,"Remchingen",11659,5771,5888,0.494982417016897,11782,5856,5926,0.497029366830759,0.00659711656054247,0.3901600188325,0.603242864606958
8,"Baden-Württemberg",8236072,"Straubenhardt",10659,5280,5379,0.495356037151703,10802,5410,5392,0.500833179040918,0.00659711656054247,0.3901600188325,0.603242864606958
8,"Baden-Württemberg",8236073,"Neulingen",6594,3190,3404,0.483773127085229,6677,3239,3438,0.48509809794818,0.00659711656054247,0.3901600188325,0.603242864606958
8,"Baden-Württemberg",8236074,"Kämpfelbach",6309,3094,3215,0.490410524647329,6207,3065,3142,0.493797325600129,0.00659711656054247,0.3901600188325,0.603242864606958
8,"Baden-Württemberg",8236075,"Ölbronn-Dürrn",3340,1645,1695,0.49251497005988,3350,1671,1679,0.498805970149254,0.00659711656054247,0.3901600188325,0.603242864606958
8,"Baden-Württemberg",8236076,"Königsbach-Stein",9733,4783,4950,0.491420939073256,9753,4787,4966,0.49082333640931,0.00659711656054247,0.3901600188325,0.603242864606958
8,"Baden-Württemberg",8237002,"Alpirsbach, Stadt",6383,3155,3228,0.494281685727714,6485,3200,3285,0.493446414803392,0.00659711656054247,0.3901600188325,0.603242864606958
8,"Baden-Württemberg",8237004,"Baiersbronn",14464,7048,7416,0.487278761061947,15344,7457,7887,0.485988008342023,0.00659711656054247,0.3901600188325,0.603242864606958
8,"Baden-Württemberg",8237019,"Dornstetten, Stadt",7910,3875,4035,0.489886219974716,7959,3931,4028,0.493906269631863,0.00659711656054247,0.3901600188325,0.603242864606958
8,"Baden-Württemberg",8237024,"Empfingen",3907,1936,1971,0.495520859994881,4138,2078,2060,0.502174963750604,0.00659711656054247,0.3901600188325,0.603242864606958
8,"Baden-Württemberg",8237027,"Eutingen im Gäu",5509,2781,2728,0.504810310401162,5425,2741,2684,0.505253456221198,0.00659711656054247,0.3901600188325,0.603242864606958
8,"Baden-Württemberg",8237028,"Freudenstadt, Stadt",22137,10584,11553,0.478113565523784,23454,11199,12255,0.477487848554618,0.00659711656054247,0.3901600188325,0.603242864606958
8,"Baden-Württemberg",8237030,"Glatten",2406,1202,1204,0.499584372402328,2316,1155,1161,0.498704663212435,0.00659711656054247,0.3901600188325,0.603242864606958
8,"Baden-Württemberg",8237032,"Grömbach",651,334,317,0.513056835637481,666,341,325,0.512012012012012,0.00659711656054247,0.3901600188325,0.603242864606958
8,"Baden-Württemberg",8237040,"Horb am Neckar, Stadt",24402,12231,12171,0.501229407425621,25024,12603,12421,0.503636508951407,0.00659711656054247,0.3901600188325,0.603242864606958
8,"Baden-Württemberg",8237045,"Loßburg",7433,3666,3767,0.493205973362034,7546,3778,3768,0.500662602703419,0.00659711656054247,0.3901600188325,0.603242864606958
8,"Baden-Württemberg",8237054,"Pfalzgrafenweiler",7007,3461,3546,0.49393463679178,7152,3511,3641,0.49091163310962,0.00659711656054247,0.3901600188325,0.603242864606958
8,"Baden-Württemberg",8237061,"Schopfloch",2604,1289,1315,0.495007680491551,2604,1296,1308,0.497695852534562,0.00659711656054247,0.3901600188325,0.603242864606958
8,"Baden-Württemberg",8237072,"Wörnersberg",241,111,130,0.460580912863071,248,121,127,0.487903225806452,0.00659711656054247,0.3901600188325,0.603242864606958
8,"Baden-Württemberg",8237073,"Seewald",2203,1060,1143,0.481162051747617,2320,1122,1198,0.483620689655172,0.00659711656054247,0.3901600188325,0.603242864606958
8,"Baden-Württemberg",8237074,"Waldachtal",5745,2851,2894,0.496257615317668,5773,2831,2942,0.490386280963104,0.00659711656054247,0.3901600188325,0.603242864606958
8,"Baden-Württemberg",8237075,"Bad Rippoldsau-Schapbach",2218,1121,1097,0.505410279531109,2225,1126,1099,0.506067415730337,0.00659711656054247,0.3901600188325,0.603242864606958
8,"Baden-Württemberg",8311000,"Freiburg im Breisgau, Stadt",214234,101090,113144,0.471867210620163,229144,109357,119787,0.477241385329749,0.00659711656054247,0.3901600188325,0.603242864606958
8,"Baden-Württemberg",8315003,"Au",1397,697,700,0.498926270579814,1446,727,719,0.502766251728907,0.00659711656054247,0.3901600188325,0.603242864606958
8,"Baden-Württemberg",8315004,"Auggen",2528,1252,1276,0.495253164556962,2516,1253,1263,0.498012718600954,0.00659711656054247,0.3901600188325,0.603242864606958
8,"Baden-Württemberg",8315006,"Bad Krozingen, Stadt",16757,7916,8841,0.472399594199439,17453,8226,9227,0.47132298172234,0.00659711656054247,0.3901600188325,0.603242864606958
8,"Baden-Württemberg",8315007,"Badenweiler",3844,1814,2030,0.471904266389178,3971,1892,2079,0.476454293628809,0.00659711656054247,0.3901600188325,0.603242864606958
8,"Baden-Württemberg",8315008,"Ballrechten-Dottingen",2299,1131,1168,0.491953023053502,2300,1122,1178,0.487826086956522,0.00659711656054247,0.3901600188325,0.603242864606958
8,"Baden-Württemberg",8315013,"Bötzingen",5312,2610,2702,0.491340361445783,5315,2639,2676,0.496519285042333,0.00659711656054247,0.3901600188325,0.603242864606958
8,"Baden-Württemberg",8315014,"Bollschweil",2240,1093,1147,0.487946428571429,2283,1118,1165,0.489706526500219,0.00659711656054247,0.3901600188325,0.603242864606958
8,"Baden-Württemberg",8315015,"Breisach am Rhein, Stadt",14067,6931,7136,0.492713442809412,14641,7331,7310,0.500717164128133,0.00659711656054247,0.3901600188325,0.603242864606958
8,"Baden-Württemberg",8315016,"Breitnau",1676,823,853,0.491050119331742,1959,1009,950,0.515058703420112,0.00659711656054247,0.3901600188325,0.603242864606958
8,"Baden-Württemberg",8315020,"Buchenbach",3163,1538,1625,0.48624723363895,3193,1536,1657,0.481052301910429,0.00659711656054247,0.3901600188325,0.603242864606958
8,"Baden-Württemberg",8315022,"Buggingen",3874,1936,1938,0.499741868869386,3934,1996,1938,0.507371631926792,0.00659711656054247,0.3901600188325,0.603242864606958
8,"Baden-Württemberg",8315028,"Ebringen",2743,1361,1382,0.496172074371126,2777,1383,1394,0.498019445444725,0.00659711656054247,0.3901600188325,0.603242864606958
8,"Baden-Württemberg",8315030,"Eichstetten am Kaiserstuhl",3300,1613,1687,0.488787878787879,3368,1654,1714,0.491092636579572,0.00659711656054247,0.3901600188325,0.603242864606958
8,"Baden-Württemberg",8315031,"Eisenbach (Hochschwarzwald)",2115,1066,1049,0.504018912529551,2153,1087,1066,0.504876915931259,0.00659711656054247,0.3901600188325,0.603242864606958
8,"Baden-Württemberg",8315033,"Eschbach",2326,1163,1163,0.5,2411,1228,1183,0.50933222729158,0.00659711656054247,0.3901600188325,0.603242864606958
8,"Baden-Württemberg",8315037,"Feldberg (Schwarzwald)",1750,865,885,0.494285714285714,1862,922,940,0.495166487647691,0.00659711656054247,0.3901600188325,0.603242864606958
8,"Baden-Württemberg",8315039,"Friedenweiler",1936,972,964,0.502066115702479,1923,960,963,0.499219968798752,0.00659711656054247,0.3901600188325,0.603242864606958
8,"Baden-Württemberg",8315041,"Glottertal",3058,1511,1547,0.494113799869196,3025,1499,1526,0.495537190082645,0.00659711656054247,0.3901600188325,0.603242864606958
8,"Baden-Württemberg",8315043,"Gottenheim",2669,1308,1361,0.490071187710753,2670,1311,1359,0.491011235955056,0.00659711656054247,0.3901600188325,0.603242864606958
8,"Baden-Württemberg",8315047,"Gundelfingen",11051,5245,5806,0.474617681657769,11588,5560,6028,0.479806696582672,0.00659711656054247,0.3901600188325,0.603242864606958
8,"Baden-Württemberg",8315048,"Hartheim",4298,2178,2120,0.506747324336901,4651,2359,2292,0.507202752096323,0.00659711656054247,0.3901600188325,0.603242864606958
8,"Baden-Württemberg",8315050,"Heitersheim, Stadt",5880,2862,3018,0.486734693877551,6092,2968,3124,0.487196323046619,0.00659711656054247,0.3901600188325,0.603242864606958
8,"Baden-Württemberg",8315051,"Heuweiler",1093,533,560,0.487648673376029,1115,541,574,0.485201793721973,0.00659711656054247,0.3901600188325,0.603242864606958
8,"Baden-Württemberg",8315052,"Hinterzarten",2457,1208,1249,0.491656491656492,2607,1199,1408,0.459915611814346,0.00659711656054247,0.3901600188325,0.603242864606958
8,"Baden-Württemberg",8315056,"Horben",1013,500,513,0.493583415597236,1101,551,550,0.500454132606721,0.00659711656054247,0.3901600188325,0.603242864606958
8,"Baden-Württemberg",8315059,"Ihringen",5829,2835,2994,0.486361296963459,5908,2887,3021,0.488659444820582,0.00659711656054247,0.3901600188325,0.603242864606958
8,"Baden-Württemberg",8315064,"Kirchzarten",9646,4564,5082,0.473149492017417,9818,4642,5176,0.472805051945406,0.00659711656054247,0.3901600188325,0.603242864606958
8,"Baden-Württemberg",8315068,"Lenzkirch",4864,2387,2477,0.490748355263158,5024,2452,2572,0.488057324840764,0.00659711656054247,0.3901600188325,0.603242864606958
8,"Baden-Württemberg",8315070,"Löffingen, Stadt",7548,3742,3806,0.495760466348702,7609,3797,3812,0.49901432514128,0.00659711656054247,0.3901600188325,0.603242864606958
8,"Baden-Württemberg",8315072,"Merdingen",2545,1220,1325,0.479371316306483,2555,1229,1326,0.481017612524462,0.00659711656054247,0.3901600188325,0.603242864606958
8,"Baden-Württemberg",8315073,"Merzhausen",4891,2322,2569,0.474749539971376,4898,2311,2587,0.47182523478971,0.00659711656054247,0.3901600188325,0.603242864606958
8,"Baden-Württemberg",8315074,"Müllheim, Stadt",18045,8595,9450,0.476309226932668,18434,8869,9565,0.481121840078117,0.00659711656054247,0.3901600188325,0.603242864606958
8,"Baden-Württemberg",8315076,"Neuenburg am Rhein, Stadt",11705,5826,5879,0.497736010252029,12172,6123,6049,0.50303976339139,0.00659711656054247,0.3901600188325,0.603242864606958
8,"Baden-Württemberg",8315084,"Oberried",2823,1430,1393,0.506553312079348,2784,1410,1374,0.506465517241379,0.00659711656054247,0.3901600188325,0.603242864606958
8,"Baden-Württemberg",8315089,"Pfaffenweiler",2515,1221,1294,0.485487077534791,2511,1212,1299,0.482676224611709,0.00659711656054247,0.3901600188325,0.603242864606958
8,"Baden-Württemberg",8315094,"St. Märgen",1822,930,892,0.510428100987925,1864,947,917,0.508047210300429,0.00659711656054247,0.3901600188325,0.603242864606958
8,"Baden-Württemberg",8315095,"St. Peter",2579,1298,1281,0.503295851105079,2564,1307,1257,0.509750390015601,0.00659711656054247,0.3901600188325,0.603242864606958
8,"Baden-Württemberg",8315098,"Schallstadt",5947,2900,3047,0.487640827307886,5992,2912,3080,0.485981308411215,0.00659711656054247,0.3901600188325,0.603242864606958
8,"Baden-Württemberg",8315102,"Schluchsee",2385,1179,1206,0.494339622641509,2562,1261,1301,0.492193598750976,0.00659711656054247,0.3901600188325,0.603242864606958
8,"Baden-Württemberg",8315107,"Sölden",1190,557,633,0.468067226890756,1165,558,607,0.478969957081545,0.00659711656054247,0.3901600188325,0.603242864606958
8,"Baden-Württemberg",8315108,"Staufen im Breisgau, Stadt",7381,3413,3968,0.46240346836472,7627,3546,4081,0.46492723220139,0.00659711656054247,0.3901600188325,0.603242864606958
8,"Baden-Württemberg",8315109,"Stegen",4497,2217,2280,0.492995330220147,4349,2101,2248,0.483099563117958,0.00659711656054247,0.3901600188325,0.603242864606958
8,"Baden-Württemberg",8315111,"Sulzburg, Stadt",2637,1231,1406,0.466818354190368,2726,1291,1435,0.473587674247982,0.00659711656054247,0.3901600188325,0.603242864606958
8,"Baden-Württemberg",8315113,"Titisee-Neustadt, Stadt",11583,5676,5907,0.49002849002849,11935,5916,6019,0.495684960201089,0.00659711656054247,0.3901600188325,0.603242864606958
8,"Baden-Württemberg",8315115,"Umkirch",5210,2570,2640,0.493282149712092,5208,2611,2597,0.501344086021505,0.00659711656054247,0.3901600188325,0.603242864606958
8,"Baden-Württemberg",8315125,"Wittnau",1394,688,706,0.493543758967001,1433,709,724,0.494766224703419,0.00659711656054247,0.3901600188325,0.603242864606958
8,"Baden-Württemberg",8315130,"Münstertal/Schwarzwald",5036,2504,2532,0.497220015885624,5157,2554,2603,0.495249175877448,0.00659711656054247,0.3901600188325,0.603242864606958
8,"Baden-Württemberg",8315131,"Ehrenkirchen",7129,3510,3619,0.492355169027914,7208,3581,3627,0.49680910099889,0.00659711656054247,0.3901600188325,0.603242864606958
8,"Baden-Württemberg",8315132,"March",8657,4297,4360,0.49636132609449,8768,4381,4387,0.499657846715328,0.00659711656054247,0.3901600188325,0.603242864606958
8,"Baden-Württemberg",8315133,"Vogtsburg im Kaiserstuhl, Stadt",5733,2869,2864,0.500436071864643,5702,2888,2814,0.506488951245177,0.00659711656054247,0.3901600188325,0.603242864606958
8,"Baden-Württemberg",8316002,"Bahlingen am Kaiserstuhl",3941,1948,1993,0.494290789139812,4000,1998,2002,0.4995,0.00659711656054247,0.3901600188325,0.603242864606958
8,"Baden-Württemberg",8316003,"Biederbach",1732,894,838,0.516166281755196,1748,899,849,0.514302059496567,0.00659711656054247,0.3901600188325,0.603242864606958
8,"Baden-Württemberg",8316009,"Denzlingen",13278,6343,6935,0.477707486067179,13732,6610,7122,0.481357413341101,0.00659711656054247,0.3901600188325,0.603242864606958
8,"Baden-Württemberg",8316010,"Elzach, Stadt",7055,3469,3586,0.491708008504607,6866,3396,3470,0.494611127293912,0.00659711656054247,0.3901600188325,0.603242864606958
8,"Baden-Württemberg",8316011,"Emmendingen, Stadt",25937,12477,13460,0.481050237113005,27011,13171,13840,0.487616156380734,0.00659711656054247,0.3901600188325,0.603242864606958
8,"Baden-Württemberg",8316012,"Endingen am Kaiserstuhl, Stadt",9073,4497,4576,0.495646423454205,9070,4464,4606,0.492171995589857,0.00659711656054247,0.3901600188325,0.603242864606958
8,"Baden-Württemberg",8316013,"Forchheim",1349,690,659,0.511489992587102,1238,619,619,0.5,0.00659711656054247,0.3901600188325,0.603242864606958
8,"Baden-Württemberg",8316014,"Gutach im Breisgau",4308,2143,2165,0.49744661095636,4485,2222,2263,0.495429208472687,0.00659711656054247,0.3901600188325,0.603242864606958
8,"Baden-Württemberg",8316017,"Herbolzheim, Stadt",10010,4967,5043,0.496203796203796,9954,4958,4996,0.498091219610207,0.00659711656054247,0.3901600188325,0.603242864606958
8,"Baden-Württemberg",8316020,"Kenzingen, Stadt",9323,4607,4716,0.494154242196718,9247,4537,4710,0.490645614793987,0.00659711656054247,0.3901600188325,0.603242864606958
8,"Baden-Württemberg",8316024,"Malterdingen",3000,1492,1508,0.497333333333333,3066,1547,1519,0.504566210045662,0.00659711656054247,0.3901600188325,0.603242864606958
8,"Baden-Württemberg",8316036,"Reute",2968,1469,1499,0.494946091644205,3005,1478,1527,0.491846921797005,0.00659711656054247,0.3901600188325,0.603242864606958
8,"Baden-Württemberg",8316037,"Riegel am Kaiserstuhl",3728,1823,1905,0.489002145922747,3734,1827,1907,0.489287627209427,0.00659711656054247,0.3901600188325,0.603242864606958
8,"Baden-Württemberg",8316038,"Sasbach am Kaiserstuhl",3296,1641,1655,0.497876213592233,3379,1689,1690,0.49985202722699,0.00659711656054247,0.3901600188325,0.603242864606958
8,"Baden-Württemberg",8316039,"Sexau",3225,1576,1649,0.488682170542636,3261,1593,1668,0.488500459981601,0.00659711656054247,0.3901600188325,0.603242864606958
8,"Baden-Württemberg",8316042,"Simonswald",3010,1519,1491,0.504651162790698,3022,1536,1486,0.508272667107876,0.00659711656054247,0.3901600188325,0.603242864606958
8,"Baden-Württemberg",8316043,"Teningen",11514,5681,5833,0.493399339933993,11737,5816,5921,0.495526966004942,0.00659711656054247,0.3901600188325,0.603242864606958
8,"Baden-Württemberg",8316045,"Vörstetten",2913,1439,1474,0.493992447648472,2978,1489,1489,0.5,0.00659711656054247,0.3901600188325,0.603242864606958
8,"Baden-Württemberg",8316049,"Weisweil",2089,1019,1070,0.487793202489229,2117,1029,1088,0.48606518658479,0.00659711656054247,0.3901600188325,0.603242864606958
8,"Baden-Württemberg",8316051,"Wyhl am Kaiserstuhl",3532,1764,1768,0.499433748584371,3604,1805,1799,0.500832408435072,0.00659711656054247,0.3901600188325,0.603242864606958
8,"Baden-Württemberg",8316053,"Rheinhausen",3546,1751,1795,0.493795826283136,3469,1720,1749,0.495820121072355,0.00659711656054247,0.3901600188325,0.603242864606958
8,"Baden-Württemberg",8316054,"Freiamt",4146,2055,2091,0.495658465991317,4179,2090,2089,0.500119645848289,0.00659711656054247,0.3901600188325,0.603242864606958
8,"Baden-Württemberg",8316055,"Winden im Elztal",2814,1413,1401,0.502132196162047,2817,1427,1390,0.506567270145545,0.00659711656054247,0.3901600188325,0.603242864606958
8,"Baden-Württemberg",8316056,"Waldkirch, Stadt",20936,10097,10839,0.482279327474207,21036,10123,10913,0.481222665906066,0.00659711656054247,0.3901600188325,0.603242864606958
8,"Baden-Württemberg",8317001,"Achern, Stadt",24485,11945,12540,0.487849703900347,24980,12242,12738,0.490072057646117,0.00659711656054247,0.3901600188325,0.603242864606958
8,"Baden-Württemberg",8317005,"Appenweier",9781,4838,4943,0.494632450669666,9803,4830,4973,0.492706314393553,0.00659711656054247,0.3901600188325,0.603242864606958
8,"Baden-Württemberg",8317008,"Bad Peterstal-Griesbach",2629,1343,1286,0.510840623811335,2680,1343,1337,0.501119402985075,0.00659711656054247,0.3901600188325,0.603242864606958
8,"Baden-Württemberg",8317009,"Berghaupten",2342,1165,1177,0.497438087105038,2393,1209,1184,0.505223568742165,0.00659711656054247,0.3901600188325,0.603242864606958
8,"Baden-Württemberg",8317011,"Biberach",3511,1728,1783,0.49216747365423,3410,1685,1725,0.494134897360704,0.00659711656054247,0.3901600188325,0.603242864606958
8,"Baden-Württemberg",8317021,"Durbach",3742,1841,1901,0.491982896846606,3782,1872,1910,0.49497620306716,0.00659711656054247,0.3901600188325,0.603242864606958
8,"Baden-Württemberg",8317026,"Ettenheim, Stadt",12161,5855,6306,0.481457117013403,12333,5974,6359,0.484391470039731,0.00659711656054247,0.3901600188325,0.603242864606958
8,"Baden-Württemberg",8317029,"Fischerbach",1683,870,813,0.516934046345811,1693,881,812,0.520378027170703,0.00659711656054247,0.3901600188325,0.603242864606958
8,"Baden-Württemberg",8317031,"Friesenheim",12504,6121,6383,0.489523352527191,12795,6318,6477,0.493786635404455,0.00659711656054247,0.3901600188325,0.603242864606958
8,"Baden-Württemberg",8317034,"Gengenbach, Stadt",10567,5114,5453,0.48395949654585,11025,5321,5704,0.482630385487528,0.00659711656054247,0.3901600188325,0.603242864606958
8,"Baden-Württemberg",8317039,"Gutach (Schwarzwaldbahn)",2212,1100,1112,0.497287522603978,2155,1079,1076,0.500696055684455,0.00659711656054247,0.3901600188325,0.603242864606958
8,"Baden-Württemberg",8317040,"Haslach im Kinzigtal, Stadt",6915,3403,3512,0.492118582791034,6932,3390,3542,0.489036353144836,0.00659711656054247,0.3901600188325,0.603242864606958
8,"Baden-Württemberg",8317041,"Hausach, Stadt",5815,2848,2967,0.489767841788478,5848,2866,2982,0.490082079343365,0.00659711656054247,0.3901600188325,0.603242864606958
8,"Baden-Württemberg",8317046,"Hofstetten",1698,874,824,0.51472320376914,1717,886,831,0.516016307513104,0.00659711656054247,0.3901600188325,0.603242864606958
8,"Baden-Württemberg",8317047,"Hohberg",7855,3869,3986,0.492552514322088,7779,3833,3946,0.492736855636971,0.00659711656054247,0.3901600188325,0.603242864606958
8,"Baden-Württemberg",8317051,"Hornberg, Stadt",4206,2075,2131,0.493342843556824,4240,2098,2142,0.494811320754717,0.00659711656054247,0.3901600188325,0.603242864606958
8,"Baden-Württemberg",8317056,"Kappelrodeck",5773,2863,2910,0.495929326173567,5829,2896,2933,0.496826213758792,0.00659711656054247,0.3901600188325,0.603242864606958
8,"Baden-Württemberg",8317057,"Kehl, Stadt",33737,16486,17251,0.48866229955242,34964,17114,17850,0.489474888456698,0.00659711656054247,0.3901600188325,0.603242864606958
8,"Baden-Württemberg",8317059,"Kippenheim",5248,2601,2647,0.49561737804878,5164,2556,2608,0.494965143299768,0.00659711656054247,0.3901600188325,0.603242864606958
8,"Baden-Württemberg",8317065,"Lahr/Schwarzwald, Stadt",42903,21129,21774,0.492483043143836,44174,21692,22482,0.49105808846833,0.00659711656054247,0.3901600188325,0.603242864606958
8,"Baden-Württemberg",8317067,"Lautenbach",1885,972,913,0.515649867374005,1882,981,901,0.52125398512221,0.00659711656054247,0.3901600188325,0.603242864606958
8,"Baden-Württemberg",8317068,"Lauf",3843,1901,1942,0.494665625813167,3836,1908,1928,0.497393117831074,0.00659711656054247,0.3901600188325,0.603242864606958
8,"Baden-Württemberg",8317073,"Mahlberg, Stadt",4714,2310,2404,0.490029698769622,4756,2338,2418,0.491589571068124,0.00659711656054247,0.3901600188325,0.603242864606958
8,"Baden-Württemberg",8317075,"Meißenheim",3756,1846,1910,0.491480298189563,3759,1882,1877,0.500665070497473,0.00659711656054247,0.3901600188325,0.603242864606958
8,"Baden-Württemberg",8317078,"Mühlenbach",1678,877,801,0.522646007151371,1662,861,801,0.518050541516246,0.00659711656054247,0.3901600188325,0.603242864606958
8,"Baden-Württemberg",8317085,"Nordrach",1925,990,935,0.514285714285714,1967,1019,948,0.518047788510422,0.00659711656054247,0.3901600188325,0.603242864606958
8,"Baden-Württemberg",8317088,"Oberharmersbach",2476,1270,1206,0.512924071082391,2475,1269,1206,0.512727272727273,0.00659711656054247,0.3901600188325,0.603242864606958
8,"Baden-Württemberg",8317089,"Oberkirch, Stadt",19763,9765,9998,0.494105145979861,19928,9883,10045,0.49593536732236,0.00659711656054247,0.3901600188325,0.603242864606958
8,"Baden-Württemberg",8317093,"Oberwolfach",2643,1340,1303,0.506999621642073,2673,1326,1347,0.496071829405163,0.00659711656054247,0.3901600188325,0.603242864606958
8,"Baden-Württemberg",8317096,"Offenburg, Stadt",57158,27604,29554,0.482942020364603,59283,28964,30319,0.488571765936272,0.00659711656054247,0.3901600188325,0.603242864606958
8,"Baden-Württemberg",8317097,"Ohlsbach",3176,1592,1584,0.501259445843829,3239,1621,1618,0.500463105896882,0.00659711656054247,0.3901600188325,0.603242864606958
8,"Baden-Württemberg",8317098,"Oppenau, Stadt",4705,2334,2371,0.496068012752391,4843,2415,2428,0.498657856700392,0.00659711656054247,0.3901600188325,0.603242864606958
8,"Baden-Württemberg",8317100,"Ortenberg",3340,1641,1699,0.491317365269461,3379,1683,1696,0.498076353950873,0.00659711656054247,0.3901600188325,0.603242864606958
8,"Baden-Württemberg",8317102,"Ottenhöfen im Schwarzwald",3158,1553,1605,0.491766941101963,3191,1571,1620,0.49232215606393,0.00659711656054247,0.3901600188325,0.603242864606958
8,"Baden-Württemberg",8317110,"Renchen, Stadt",7302,3655,3647,0.500547795124623,7349,3649,3700,0.496530140155123,0.00659711656054247,0.3901600188325,0.603242864606958
8,"Baden-Württemberg",8317113,"Ringsheim",2236,1131,1105,0.505813953488372,2272,1155,1117,0.508362676056338,0.00659711656054247,0.3901600188325,0.603242864606958
8,"Baden-Württemberg",8317114,"Rust",3741,1866,1875,0.498797113071371,3799,1897,1902,0.499341932087391,0.00659711656054247,0.3901600188325,0.603242864606958
8,"Baden-Württemberg",8317116,"Sasbach",5294,2563,2731,0.484132980732905,5481,2731,2750,0.49826673964605,0.00659711656054247,0.3901600188325,0.603242864606958
8,"Baden-Württemberg",8317118,"Sasbachwalden",2321,1146,1175,0.493752692804826,2475,1233,1242,0.498181818181818,0.00659711656054247,0.3901600188325,0.603242864606958
8,"Baden-Württemberg",8317121,"Schuttertal",3218,1617,1601,0.502486016159105,3216,1630,1586,0.506840796019901,0.00659711656054247,0.3901600188325,0.603242864606958
8,"Baden-Württemberg",8317122,"Schutterwald",7125,3585,3540,0.503157894736842,7155,3657,3498,0.511111111111111,0.00659711656054247,0.3901600188325,0.603242864606958
8,"Baden-Württemberg",8317126,"Seebach",1416,727,689,0.513418079096045,1430,733,697,0.512587412587413,0.00659711656054247,0.3901600188325,0.603242864606958
8,"Baden-Württemberg",8317127,"Seelbach",4919,2388,2531,0.485464525310022,4954,2438,2516,0.492127573677836,0.00659711656054247,0.3901600188325,0.603242864606958
8,"Baden-Württemberg",8317129,"Steinach",4025,2008,2017,0.49888198757764,3973,2007,1966,0.505159828844702,0.00659711656054247,0.3901600188325,0.603242864606958
8,"Baden-Württemberg",8317141,"Willstätt",9098,4519,4579,0.496702571993845,9133,4543,4590,0.497426913391,0.00659711656054247,0.3901600188325,0.603242864606958
8,"Baden-Württemberg",8317145,"Wolfach, Stadt",5807,2892,2915,0.498019631479249,5807,2931,2876,0.504735663853969,0.00659711656054247,0.3901600188325,0.603242864606958
8,"Baden-Württemberg",8317146,"Zell am Harmersbach, Stadt",7980,3938,4042,0.493483709273183,8076,4005,4071,0.49591381872214,0.00659711656054247,0.3901600188325,0.603242864606958
8,"Baden-Württemberg",8317150,"Schwanau",6805,3415,3390,0.501836884643644,6894,3358,3536,0.487090223382652,0.00659711656054247,0.3901600188325,0.603242864606958
8,"Baden-Württemberg",8317151,"Neuried",9316,4574,4742,0.490983254615715,9351,4576,4775,0.489359426799273,0.00659711656054247,0.3901600188325,0.603242864606958
8,"Baden-Württemberg",8317152,"Kappel-Grafenhausen",4732,2347,2385,0.495984784446323,4746,2363,2383,0.497892962494732,0.00659711656054247,0.3901600188325,0.603242864606958
8,"Baden-Württemberg",8317153,"Rheinau, Stadt",11086,5497,5589,0.495850622406639,11195,5553,5642,0.496025011165699,0.00659711656054247,0.3901600188325,0.603242864606958
8,"Baden-Württemberg",8325001,"Aichhalden",4028,1994,2034,0.495034756703078,4048,2027,2021,0.500741106719368,0.00659711656054247,0.3901600188325,0.603242864606958
8,"Baden-Württemberg",8325009,"Bösingen",3376,1693,1683,0.501481042654028,3461,1740,1721,0.502744871424444,0.00659711656054247,0.3901600188325,0.603242864606958
8,"Baden-Württemberg",8325011,"Dietingen",3910,1926,1984,0.492583120204604,3951,1940,2011,0.491014932928373,0.00659711656054247,0.3901600188325,0.603242864606958
8,"Baden-Württemberg",8325012,"Dornhan, Stadt",6062,3008,3054,0.496205872649291,6022,3001,3021,0.498339422118897,0.00659711656054247,0.3901600188325,0.603242864606958
8,"Baden-Württemberg",8325014,"Dunningen",5947,2993,2954,0.503278964183622,6010,3034,2976,0.504825291181364,0.00659711656054247,0.3901600188325,0.603242864606958
8,"Baden-Württemberg",8325015,"Epfendorf",3296,1649,1647,0.500303398058252,3314,1630,1684,0.491852745926373,0.00659711656054247,0.3901600188325,0.603242864606958
8,"Baden-Württemberg",8325024,"Hardt",2517,1245,1272,0.494636471990465,2534,1250,1284,0.493291239147593,0.00659711656054247,0.3901600188325,0.603242864606958
8,"Baden-Württemberg",8325036,"Lauterbach",2963,1462,1501,0.493418832264597,3007,1475,1532,0.490522115064849,0.00659711656054247,0.3901600188325,0.603242864606958
8,"Baden-Württemberg",8325045,"Oberndorf am Neckar, Stadt",13724,6770,6954,0.493296415039347,14341,7135,7206,0.49752457987588,0.00659711656054247,0.3901600188325,0.603242864606958
8,"Baden-Württemberg",8325049,"Rottweil, Stadt",24372,11795,12577,0.483956999835877,25622,12434,13188,0.485286082273047,0.00659711656054247,0.3901600188325,0.603242864606958
8,"Baden-Württemberg",8325050,"Schenkenzell",1823,918,905,0.503565551289084,1770,898,872,0.507344632768362,0.00659711656054247,0.3901600188325,0.603242864606958
8,"Baden-Württemberg",8325051,"Schiltach, Stadt",3903,1880,2023,0.481680758390981,3850,1843,2007,0.478701298701299,0.00659711656054247,0.3901600188325,0.603242864606958
8,"Baden-Württemberg",8325053,"Schramberg, Stadt",20921,10340,10581,0.494240237082357,21000,10379,10621,0.494238095238095,0.00659711656054247,0.3901600188325,0.603242864606958
8,"Baden-Württemberg",8325057,"Sulz am Neckar, Stadt",11786,5772,6014,0.489733582216189,12130,5980,6150,0.492992580379225,0.00659711656054247,0.3901600188325,0.603242864606958
8,"Baden-Württemberg",8325060,"Villingendorf",3245,1588,1657,0.489368258859784,3313,1601,1712,0.483247811651072,0.00659711656054247,0.3901600188325,0.603242864606958
8,"Baden-Württemberg",8325061,"Vöhringen",4211,2107,2104,0.500356209926383,4114,2065,2049,0.501944579484686,0.00659711656054247,0.3901600188325,0.603242864606958
8,"Baden-Württemberg",8325064,"Wellendingen",3012,1512,1500,0.50199203187251,3087,1558,1529,0.504697116942015,0.00659711656054247,0.3901600188325,0.603242864606958
8,"Baden-Württemberg",8325069,"Zimmern ob Rottweil",5781,2875,2906,0.497318802975264,5878,2897,2981,0.492854712487241,0.00659711656054247,0.3901600188325,0.603242864606958
8,"Baden-Württemberg",8325070,"Fluorn-Winzeln",3145,1605,1540,0.51033386327504,3204,1640,1564,0.511860174781523,0.00659711656054247,0.3901600188325,0.603242864606958
8,"Baden-Württemberg",8325071,"Eschbronn",2068,1023,1045,0.49468085106383,2069,1043,1026,0.504108264862252,0.00659711656054247,0.3901600188325,0.603242864606958
8,"Baden-Württemberg",8325072,"Deißlingen",5959,2939,3020,0.4932035576439,5994,2950,3044,0.492158825492159,0.00659711656054247,0.3901600188325,0.603242864606958
8,"Baden-Württemberg",8326003,"Bad Dürrheim, Stadt",12420,5853,6567,0.471256038647343,13039,6083,6956,0.466523506403865,0.00659711656054247,0.3901600188325,0.603242864606958
8,"Baden-Württemberg",8326005,"Blumberg, Stadt",9937,4960,4977,0.499144611049613,10045,5012,5033,0.498954703832753,0.00659711656054247,0.3901600188325,0.603242864606958
8,"Baden-Württemberg",8326006,"Bräunlingen, Stadt",5826,2878,2948,0.493992447648472,5886,2905,2981,0.493544002718315,0.00659711656054247,0.3901600188325,0.603242864606958
8,"Baden-Württemberg",8326010,"Dauchingen",3640,1801,1839,0.49478021978022,3677,1816,1861,0.493880881153114,0.00659711656054247,0.3901600188325,0.603242864606958
8,"Baden-Württemberg",8326012,"Donaueschingen, Stadt",21087,10299,10788,0.488405178546024,21066,10369,10697,0.492214943510871,0.00659711656054247,0.3901600188325,0.603242864606958
8,"Baden-Württemberg",8326017,"Furtwangen im Schwarzwald, Stadt",9217,4746,4471,0.514918086145167,9250,4824,4426,0.521513513513513,0.00659711656054247,0.3901600188325,0.603242864606958
8,"Baden-Württemberg",8326020,"Gütenbach",1178,592,586,0.502546689303905,1187,598,589,0.503791069924179,0.00659711656054247,0.3901600188325,0.603242864606958
8,"Baden-Württemberg",8326027,"Hüfingen, Stadt",7558,3765,3793,0.498147658110611,7656,3839,3817,0.501436781609195,0.00659711656054247,0.3901600188325,0.603242864606958
8,"Baden-Württemberg",8326031,"Königsfeld im Schwarzwald",5826,2772,3054,0.475798146240989,5963,2843,3120,0.476773436189837,0.00659711656054247,0.3901600188325,0.603242864606958
8,"Baden-Württemberg",8326037,"Mönchweiler",3004,1479,1525,0.492343541944075,3043,1487,1556,0.488662504107788,0.00659711656054247,0.3901600188325,0.603242864606958
8,"Baden-Württemberg",8326041,"Niedereschach",5829,2917,2912,0.500428890032596,5928,2979,2949,0.50253036437247,0.00659711656054247,0.3901600188325,0.603242864606958
8,"Baden-Württemberg",8326052,"St. Georgen im Schwarzwald, Stadt",12842,6348,6494,0.494315527176452,12971,6404,6567,0.493716752756148,0.00659711656054247,0.3901600188325,0.603242864606958
8,"Baden-Württemberg",8326054,"Schönwald im Schwarzwald",2268,1138,1130,0.501763668430335,2353,1173,1180,0.49851253718657,0.00659711656054247,0.3901600188325,0.603242864606958
8,"Baden-Württemberg",8326055,"Schonach im Schwarzwald",4038,2017,2021,0.499504705299653,3845,1924,1921,0.50039011703511,0.00659711656054247,0.3901600188325,0.603242864606958
8,"Baden-Württemberg",8326060,"Triberg im Schwarzwald, Stadt",4783,2338,2445,0.488814551536692,4771,2320,2451,0.486271221966045,0.00659711656054247,0.3901600188325,0.603242864606958
8,"Baden-Württemberg",8326061,"Tuningen",2916,1438,1478,0.493141289437586,2920,1444,1476,0.494520547945206,0.00659711656054247,0.3901600188325,0.603242864606958
8,"Baden-Württemberg",8326065,"Unterkirnach",2436,1294,1142,0.5311986863711,2735,1468,1267,0.536745886654479,0.00659711656054247,0.3901600188325,0.603242864606958
8,"Baden-Württemberg",8326068,"Vöhrenbach, Stadt",3867,1970,1897,0.509438841479183,3779,1925,1854,0.5093940195819,0.00659711656054247,0.3901600188325,0.603242864606958
8,"Baden-Württemberg",8326074,"Villingen-Schwenningen, Stadt",80268,38664,41604,0.481686350725071,80990,39302,41688,0.485269786393382,0.00659711656054247,0.3901600188325,0.603242864606958
8,"Baden-Württemberg",8326075,"Brigachtal",5038,2449,2589,0.486105597459309,5110,2496,2614,0.488454011741683,0.00659711656054247,0.3901600188325,0.603242864606958
8,"Baden-Württemberg",8327002,"Aldingen",7357,3681,3676,0.500339812423542,7545,3788,3757,0.502054340622929,0.00659711656054247,0.3901600188325,0.603242864606958
8,"Baden-Württemberg",8327004,"Bärenthal",452,226,226,0.5,429,208,221,0.484848484848485,0.00659711656054247,0.3901600188325,0.603242864606958
8,"Baden-Württemberg",8327005,"Balgheim",1156,587,569,0.507785467128028,1151,590,561,0.5125977410947,0.00659711656054247,0.3901600188325,0.603242864606958
8,"Baden-Württemberg",8327006,"Böttingen",1459,733,726,0.502398903358465,1465,733,732,0.500341296928328,0.00659711656054247,0.3901600188325,0.603242864606958
8,"Baden-Württemberg",8327007,"Bubsheim",1149,608,541,0.529155787641427,1166,619,547,0.530874785591767,0.00659711656054247,0.3901600188325,0.603242864606958
8,"Baden-Württemberg",8327008,"Buchheim",665,331,334,0.497744360902256,614,313,301,0.509771986970684,0.00659711656054247,0.3901600188325,0.603242864606958
8,"Baden-Württemberg",8327009,"Deilingen",1738,861,877,0.495397008055236,1689,830,859,0.49141503848431,0.00659711656054247,0.3901600188325,0.603242864606958
8,"Baden-Württemberg",8327010,"Denkingen",2544,1261,1283,0.495676100628931,2567,1286,1281,0.500973899493572,0.00659711656054247,0.3901600188325,0.603242864606958
8,"Baden-Württemberg",8327011,"Dürbheim",1638,816,822,0.498168498168498,1689,846,843,0.50088809946714,0.00659711656054247,0.3901600188325,0.603242864606958
8,"Baden-Württemberg",8327012,"Durchhausen",912,468,444,0.513157894736842,898,472,426,0.525612472160356,0.00659711656054247,0.3901600188325,0.603242864606958
8,"Baden-Württemberg",8327013,"Egesheim",652,336,316,0.515337423312883,643,332,311,0.516329704510109,0.00659711656054247,0.3901600188325,0.603242864606958
8,"Baden-Württemberg",8327016,"Fridingen an der Donau, Stadt",3106,1526,1580,0.491307147456536,3117,1556,1561,0.499197946743664,0.00659711656054247,0.3901600188325,0.603242864606958
8,"Baden-Württemberg",8327017,"Frittlingen",2088,1054,1034,0.504789272030651,2146,1088,1058,0.506989748369059,0.00659711656054247,0.3901600188325,0.603242864606958
8,"Baden-Württemberg",8327018,"Geisingen, Stadt",6016,3043,2973,0.505817819148936,5981,3031,2950,0.506771442902525,0.00659711656054247,0.3901600188325,0.603242864606958
8,"Baden-Württemberg",8327019,"Gosheim",3827,1887,1940,0.493075516070029,3763,1852,1911,0.492160510231199,0.00659711656054247,0.3901600188325,0.603242864606958
8,"Baden-Württemberg",8327020,"Gunningen",703,356,347,0.506401137980085,716,363,353,0.506983240223464,0.00659711656054247,0.3901600188325,0.603242864606958
8,"Baden-Württemberg",8327023,"Hausen ob Verena",761,388,373,0.509855453350854,775,385,390,0.496774193548387,0.00659711656054247,0.3901600188325,0.603242864606958
8,"Baden-Württemberg",8327025,"Immendingen",5639,2923,2716,0.518354318141514,6095,3279,2816,0.537981952420016,0.00659711656054247,0.3901600188325,0.603242864606958
8,"Baden-Württemberg",8327027,"Irndorf",730,345,385,0.472602739726027,766,364,402,0.475195822454308,0.00659711656054247,0.3901600188325,0.603242864606958
8,"Baden-Württemberg",8327029,"Königsheim",573,298,275,0.520069808027923,565,293,272,0.51858407079646,0.00659711656054247,0.3901600188325,0.603242864606958
8,"Baden-Württemberg",8327030,"Kolbingen",1235,605,630,0.489878542510121,1279,627,652,0.490226739640344,0.00659711656054247,0.3901600188325,0.603242864606958
8,"Baden-Württemberg",8327033,"Mahlstetten",745,383,362,0.514093959731544,736,379,357,0.514945652173913,0.00659711656054247,0.3901600188325,0.603242864606958
8,"Baden-Württemberg",8327036,"Mühlheim an der Donau, Stadt",3493,1722,1771,0.492985971943888,3487,1708,1779,0.489819328936048,0.00659711656054247,0.3901600188325,0.603242864606958
8,"Baden-Württemberg",8327038,"Neuhausen ob Eck",3819,1906,1913,0.499083529719822,3824,1915,1909,0.500784518828452,0.00659711656054247,0.3901600188325,0.603242864606958
8,"Baden-Württemberg",8327040,"Reichenbach am Heuberg",485,233,252,0.480412371134021,493,234,259,0.474645030425964,0.00659711656054247,0.3901600188325,0.603242864606958
8,"Baden-Württemberg",8327041,"Renquishausen",729,379,350,0.519890260631001,738,388,350,0.525745257452574,0.00659711656054247,0.3901600188325,0.603242864606958
8,"Baden-Württemberg",8327046,"Spaichingen, Stadt",12311,6052,6259,0.491592884412314,12347,6063,6284,0.491050457601037,0.00659711656054247,0.3901600188325,0.603242864606958
8,"Baden-Württemberg",8327048,"Talheim",1182,599,583,0.506768189509306,1190,595,595,0.5,0.00659711656054247,0.3901600188325,0.603242864606958
8,"Baden-Württemberg",8327049,"Trossingen, Stadt",15031,7337,7694,0.488124542611935,15316,7481,7835,0.488443457821886,0.00659711656054247,0.3901600188325,0.603242864606958
8,"Baden-Württemberg",8327050,"Tuttlingen, Stadt",33202,16257,16945,0.489639178362749,34236,16754,17482,0.489367916812712,0.00659711656054247,0.3901600188325,0.603242864606958
8,"Baden-Württemberg",8327051,"Wehingen",3562,1738,1824,0.487928130263897,3572,1756,1816,0.491601343784994,0.00659711656054247,0.3901600188325,0.603242864606958
8,"Baden-Württemberg",8327054,"Wurmlingen",3771,1838,1933,0.487403871652082,3756,1838,1918,0.489350372736954,0.00659711656054247,0.3901600188325,0.603242864606958
8,"Baden-Württemberg",8327055,"Seitingen-Oberflacht",2335,1171,1164,0.501498929336188,2334,1177,1157,0.504284490145673,0.00659711656054247,0.3901600188325,0.603242864606958
8,"Baden-Württemberg",8327056,"Rietheim-Weilheim",2625,1297,1328,0.494095238095238,2637,1292,1345,0.489950701554797,0.00659711656054247,0.3901600188325,0.603242864606958
8,"Baden-Württemberg",8327057,"Emmingen-Liptingen",4502,2242,2260,0.498000888494003,4479,2227,2252,0.497209198481804,0.00659711656054247,0.3901600188325,0.603242864606958
8,"Baden-Württemberg",8335001,"Aach, Stadt",2163,1083,1080,0.500693481276006,2141,1099,1042,0.51331153666511,0.00659711656054247,0.3901600188325,0.603242864606958
8,"Baden-Württemberg",8335002,"Allensbach",6885,3197,3688,0.464342774146696,7084,3275,3809,0.462309429700734,0.00659711656054247,0.3901600188325,0.603242864606958
8,"Baden-Württemberg",8335015,"Büsingen am Hochrhein",1328,646,682,0.48644578313253,1373,691,682,0.503277494537509,0.00659711656054247,0.3901600188325,0.603242864606958
8,"Baden-Württemberg",8335021,"Eigeltingen",3663,1807,1856,0.493311493311493,3619,1790,1829,0.494611771207516,0.00659711656054247,0.3901600188325,0.603242864606958
8,"Baden-Württemberg",8335022,"Engen, Stadt",9968,4843,5125,0.485854735152488,10219,4938,5281,0.483217535962423,0.00659711656054247,0.3901600188325,0.603242864606958
8,"Baden-Württemberg",8335025,"Gaienhofen",3180,1520,1660,0.477987421383648,3223,1547,1676,0.479987589202606,0.00659711656054247,0.3901600188325,0.603242864606958
8,"Baden-Württemberg",8335026,"Gailingen am Hochrhein",2794,1341,1453,0.479957050823193,3124,1571,1553,0.502880921895006,0.00659711656054247,0.3901600188325,0.603242864606958
8,"Baden-Württemberg",8335028,"Gottmadingen",10200,4941,5259,0.484411764705882,10318,5021,5297,0.486625314983524,0.00659711656054247,0.3901600188325,0.603242864606958
8,"Baden-Württemberg",8335035,"Hilzingen",8125,3991,4134,0.4912,8198,3998,4200,0.487679921932179,0.00659711656054247,0.3901600188325,0.603242864606958
8,"Baden-Württemberg",8335043,"Konstanz, Universitätsstadt",78539,37463,41076,0.476998688549638,85524,41528,43996,0.485571301622936,0.00659711656054247,0.3901600188325,0.603242864606958
8,"Baden-Württemberg",8335055,"Moos",3179,1547,1632,0.486631016042781,3292,1629,1663,0.494835965978129,0.00659711656054247,0.3901600188325,0.603242864606958
8,"Baden-Württemberg",8335057,"Mühlingen",2278,1134,1144,0.497805092186128,2303,1168,1135,0.507164567954842,0.00659711656054247,0.3901600188325,0.603242864606958
8,"Baden-Württemberg",8335061,"Öhningen",3518,1714,1804,0.487208641273451,3645,1807,1838,0.495747599451303,0.00659711656054247,0.3901600188325,0.603242864606958
8,"Baden-Württemberg",8335063,"Radolfzell am Bodensee, Stadt",29850,14226,15624,0.476582914572864,31024,15024,16000,0.484270242392986,0.00659711656054247,0.3901600188325,0.603242864606958
8,"Baden-Württemberg",8335066,"Reichenau",5066,2579,2487,0.509080142123964,5179,2579,2600,0.497972581579456,0.00659711656054247,0.3901600188325,0.603242864606958
8,"Baden-Württemberg",8335075,"Singen (Hohentwiel), Stadt",44945,21608,23337,0.480765379908777,46300,22548,23752,0.486997840172786,0.00659711656054247,0.3901600188325,0.603242864606958
8,"Baden-Württemberg",8335077,"Steißlingen",4531,2216,2315,0.489075259324652,4575,2253,2322,0.492459016393443,0.00659711656054247,0.3901600188325,0.603242864606958
8,"Baden-Württemberg",8335079,"Stockach, Stadt",15932,7798,8134,0.489455184534271,16545,8057,8488,0.486974916893321,0.00659711656054247,0.3901600188325,0.603242864606958
8,"Baden-Württemberg",8335080,"Tengen, Stadt",4530,2205,2325,0.486754966887417,4570,2236,2334,0.489277899343545,0.00659711656054247,0.3901600188325,0.603242864606958
8,"Baden-Württemberg",8335081,"Volkertshausen",2921,1449,1472,0.496062992125984,2968,1490,1478,0.502021563342318,0.00659711656054247,0.3901600188325,0.603242864606958
8,"Baden-Württemberg",8335096,"Hohenfels",1972,975,997,0.494421906693712,1990,1001,989,0.503015075376884,0.00659711656054247,0.3901600188325,0.603242864606958
8,"Baden-Württemberg",8335097,"Mühlhausen-Ehingen",3618,1805,1813,0.498894416804865,3660,1844,1816,0.503825136612022,0.00659711656054247,0.3901600188325,0.603242864606958
8,"Baden-Württemberg",8335098,"Bodman-Ludwigshafen",4295,2052,2243,0.477764842840512,4468,2147,2321,0.480528200537153,0.00659711656054247,0.3901600188325,0.603242864606958
8,"Baden-Württemberg",8335099,"Orsingen-Nenzingen",3213,1593,1620,0.495798319327731,3227,1608,1619,0.498295630616672,0.00659711656054247,0.3901600188325,0.603242864606958
8,"Baden-Württemberg",8335100,"Rielasingen-Worblingen",11570,5656,5914,0.488850475367329,11979,5851,6128,0.488438100008348,0.00659711656054247,0.3901600188325,0.603242864606958
8,"Baden-Württemberg",8336004,"Aitern",543,274,269,0.504604051565378,553,287,266,0.518987341772152,0.00659711656054247,0.3901600188325,0.603242864606958
8,"Baden-Württemberg",8336006,"Bad Bellingen",3907,1933,1974,0.494753007422575,4004,1996,2008,0.498501498501498,0.00659711656054247,0.3901600188325,0.603242864606958
8,"Baden-Württemberg",8336008,"Binzen",2901,1434,1467,0.494312306101344,2902,1427,1475,0.491729841488629,0.00659711656054247,0.3901600188325,0.603242864606958
8,"Baden-Württemberg",8336010,"Böllen",95,50,45,0.526315789473684,91,47,44,0.516483516483517,0.00659711656054247,0.3901600188325,0.603242864606958
8,"Baden-Württemberg",8336014,"Efringen-Kirchen",8293,4109,4184,0.495478114072109,8228,4076,4152,0.49538162372387,0.00659711656054247,0.3901600188325,0.603242864606958
8,"Baden-Württemberg",8336019,"Eimeldingen",2437,1214,1223,0.498153467377924,2439,1216,1223,0.498564985649857,0.00659711656054247,0.3901600188325,0.603242864606958
8,"Baden-Württemberg",8336024,"Fischingen",682,338,344,0.495601173020528,691,352,339,0.509406657018813,0.00659711656054247,0.3901600188325,0.603242864606958
8,"Baden-Württemberg",8336025,"Fröhnd",478,248,230,0.518828451882845,479,246,233,0.51356993736952,0.00659711656054247,0.3901600188325,0.603242864606958
8,"Baden-Württemberg",8336034,"Hasel",1134,553,581,0.487654320987654,1136,564,572,0.496478873239437,0.00659711656054247,0.3901600188325,0.603242864606958
8,"Baden-Württemberg",8336036,"Hausen im Wiesental",2305,1146,1159,0.497180043383948,2325,1179,1146,0.507096774193548,0.00659711656054247,0.3901600188325,0.603242864606958
8,"Baden-Württemberg",8336043,"Inzlingen",2458,1178,1280,0.479251423921888,2462,1176,1286,0.47766043866775,0.00659711656054247,0.3901600188325,0.603242864606958
8,"Baden-Württemberg",8336045,"Kandern, Stadt",8039,3913,4126,0.486752083592487,8137,3921,4216,0.481872926139855,0.00659711656054247,0.3901600188325,0.603242864606958
8,"Baden-Württemberg",8336050,"Lörrach, Stadt",47809,22941,24868,0.479846890752787,48626,23512,25114,0.483527331057459,0.00659711656054247,0.3901600188325,0.603242864606958
8,"Baden-Württemberg",8336057,"Maulburg",4158,2061,2097,0.495670995670996,4013,2019,1994,0.503114876650885,0.00659711656054247,0.3901600188325,0.603242864606958
8,"Baden-Württemberg",8336069,"Rheinfelden (Baden), Stadt",31814,15489,16325,0.486861130319985,32453,15850,16603,0.48839860721659,0.00659711656054247,0.3901600188325,0.603242864606958
8,"Baden-Württemberg",8336073,"Rümmingen",1662,819,843,0.492779783393502,1664,825,839,0.495793269230769,0.00659711656054247,0.3901600188325,0.603242864606958
8,"Baden-Württemberg",8336075,"Schallbach",744,367,377,0.493279569892473,719,357,362,0.496522948539638,0.00659711656054247,0.3901600188325,0.603242864606958
8,"Baden-Württemberg",8336078,"Schliengen",5302,2598,2704,0.490003772161449,5320,2616,2704,0.491729323308271,0.00659711656054247,0.3901600188325,0.603242864606958
8,"Baden-Württemberg",8336079,"Schönau im Schwarzwald, Stadt",2326,1132,1194,0.486672398968186,2395,1160,1235,0.484342379958246,0.00659711656054247,0.3901600188325,0.603242864606958
8,"Baden-Württemberg",8336080,"Schönenberg",355,183,172,0.515492957746479,333,170,163,0.510510510510511,0.00659711656054247,0.3901600188325,0.603242864606958
8,"Baden-Württemberg",8336081,"Schopfheim, Stadt",18603,8992,9611,0.483362898457238,18991,9259,9732,0.48754673266284,0.00659711656054247,0.3901600188325,0.603242864606958
8,"Baden-Württemberg",8336082,"Schwörstadt",2413,1196,1217,0.495648570244509,2411,1196,1215,0.496059726254666,0.00659711656054247,0.3901600188325,0.603242864606958
8,"Baden-Württemberg",8336084,"Steinen",9712,4713,4999,0.485275947281713,10186,4958,5228,0.486746514824269,0.00659711656054247,0.3901600188325,0.603242864606958
8,"Baden-Württemberg",8336087,"Todtnau, Stadt",4763,2354,2409,0.494226327944573,4843,2396,2447,0.494734668593847,0.00659711656054247,0.3901600188325,0.603242864606958
8,"Baden-Württemberg",8336089,"Tunau",187,96,91,0.513368983957219,188,97,91,0.515957446808511,0.00659711656054247,0.3901600188325,0.603242864606958
8,"Baden-Württemberg",8336090,"Utzenfeld",611,306,305,0.500818330605565,611,315,296,0.515548281505728,0.00659711656054247,0.3901600188325,0.603242864606958
8,"Baden-Württemberg",8336091,"Weil am Rhein, Stadt",28786,13931,14855,0.483950531508372,30011,14551,15460,0.484855552963913,0.00659711656054247,0.3901600188325,0.603242864606958
8,"Baden-Württemberg",8336094,"Wembach",338,174,164,0.514792899408284,333,173,160,0.519519519519519,0.00659711656054247,0.3901600188325,0.603242864606958
8,"Baden-Württemberg",8336096,"Wieden",574,298,276,0.519163763066202,566,292,274,0.515901060070671,0.00659711656054247,0.3901600188325,0.603242864606958
8,"Baden-Württemberg",8336100,"Wittlingen",973,482,491,0.495375128468654,973,488,485,0.501541623843782,0.00659711656054247,0.3901600188325,0.603242864606958
8,"Baden-Württemberg",8336103,"Zell im Wiesental, Stadt",5972,2928,3044,0.490288010716678,5892,2901,2991,0.492362525458248,0.00659711656054247,0.3901600188325,0.603242864606958
8,"Baden-Württemberg",8336104,"Malsburg-Marzell",1443,738,705,0.511434511434511,1433,724,709,0.505233775296581,0.00659711656054247,0.3901600188325,0.603242864606958
8,"Baden-Württemberg",8336105,"Grenzach-Wyhlen",13871,6743,7128,0.486122125297383,14122,6826,7296,0.483359297549922,0.00659711656054247,0.3901600188325,0.603242864606958
8,"Baden-Württemberg",8336106,"Häg-Ehrsberg",905,455,450,0.502762430939227,865,447,418,0.516763005780347,0.00659711656054247,0.3901600188325,0.603242864606958
8,"Baden-Württemberg",8336107,"Kleines Wiesental",2888,1445,1443,0.500346260387812,2891,1449,1442,0.501210653753027,0.00659711656054247,0.3901600188325,0.603242864606958
8,"Baden-Württemberg",8337002,"Albbruck",7184,3623,3561,0.504315144766147,7271,3654,3617,0.502544354284142,0.00659711656054247,0.3901600188325,0.603242864606958
8,"Baden-Württemberg",8337013,"Bernau im Schwarzwald",1896,951,945,0.501582278481013,1905,946,959,0.496587926509186,0.00659711656054247,0.3901600188325,0.603242864606958
8,"Baden-Württemberg",8337022,"Bonndorf im Schwarzwald, Stadt",6771,3412,3359,0.503913749815389,6817,3430,3387,0.503153880005868,0.00659711656054247,0.3901600188325,0.603242864606958
8,"Baden-Württemberg",8337027,"Dachsberg (Südschwarzwald)",1370,681,689,0.497080291970803,1400,696,704,0.497142857142857,0.00659711656054247,0.3901600188325,0.603242864606958
8,"Baden-Württemberg",8337030,"Dettighofen",1101,548,553,0.497729336966394,1092,541,551,0.495421245421245,0.00659711656054247,0.3901600188325,0.603242864606958
8,"Baden-Württemberg",8337032,"Dogern",2270,1102,1168,0.485462555066079,2257,1099,1158,0.486929552503323,0.00659711656054247,0.3901600188325,0.603242864606958
8,"Baden-Württemberg",8337038,"Görwihl",4289,2096,2193,0.488692002797855,4326,2112,2214,0.488210818307906,0.00659711656054247,0.3901600188325,0.603242864606958
8,"Baden-Württemberg",8337039,"Grafenhausen",2186,1087,1099,0.497255260750229,2222,1102,1120,0.495949594959496,0.00659711656054247,0.3901600188325,0.603242864606958
8,"Baden-Württemberg",8337045,"Häusern",1256,609,647,0.484872611464968,1269,606,663,0.477541371158392,0.00659711656054247,0.3901600188325,0.603242864606958
8,"Baden-Württemberg",8337049,"Herrischried",2629,1317,1312,0.500950931913275,2694,1362,1332,0.505567928730512,0.00659711656054247,0.3901600188325,0.603242864606958
8,"Baden-Württemberg",8337051,"Höchenschwand",2464,1204,1260,0.488636363636364,2557,1228,1329,0.480250293312476,0.00659711656054247,0.3901600188325,0.603242864606958
8,"Baden-Württemberg",8337053,"Hohentengen am Hochrhein",3707,1873,1834,0.505260318316698,3666,1849,1817,0.504364429896345,0.00659711656054247,0.3901600188325,0.603242864606958
8,"Baden-Württemberg",8337059,"Ibach",397,185,212,0.465994962216625,394,181,213,0.459390862944162,0.00659711656054247,0.3901600188325,0.603242864606958
8,"Baden-Württemberg",8337060,"Jestetten",4888,2353,2535,0.481382978723404,5120,2479,2641,0.4841796875,0.00659711656054247,0.3901600188325,0.603242864606958
8,"Baden-Württemberg",8337062,"Klettgau",7388,3667,3721,0.496345425013535,7412,3663,3749,0.494198596869941,0.00659711656054247,0.3901600188325,0.603242864606958
8,"Baden-Württemberg",8337065,"Lauchringen",7478,3663,3815,0.489836854774004,7541,3690,3851,0.489325023206471,0.00659711656054247,0.3901600188325,0.603242864606958
8,"Baden-Württemberg",8337066,"Laufenburg (Baden), Stadt",8565,4136,4429,0.482895504962055,8696,4211,4485,0.484245630174793,0.00659711656054247,0.3901600188325,0.603242864606958
8,"Baden-Württemberg",8337070,"Lottstetten",2114,1063,1051,0.502838221381268,2161,1101,1060,0.509486348912541,0.00659711656054247,0.3901600188325,0.603242864606958
8,"Baden-Württemberg",8337076,"Murg",6760,3321,3439,0.491272189349112,6750,3319,3431,0.491703703703704,0.00659711656054247,0.3901600188325,0.603242864606958
8,"Baden-Württemberg",8337090,"Rickenbach",3811,1941,1870,0.509315140383102,3842,1934,1908,0.503383654346694,0.00659711656054247,0.3901600188325,0.603242864606958
8,"Baden-Württemberg",8337096,"Bad Säckingen, Stadt",16109,7701,8408,0.478055745235583,16694,7998,8696,0.47909428537199,0.00659711656054247,0.3901600188325,0.603242864606958
8,"Baden-Württemberg",8337097,"St. Blasien, Stadt",3702,1765,1937,0.476769313884387,3899,1962,1937,0.503205950243652,0.00659711656054247,0.3901600188325,0.603242864606958
8,"Baden-Württemberg",8337106,"Stühlingen, Stadt",5077,2530,2547,0.498325782942683,5156,2585,2571,0.501357641582622,0.00659711656054247,0.3901600188325,0.603242864606958
8,"Baden-Württemberg",8337108,"Todtmoos",1863,910,953,0.48845947396672,1933,928,1005,0.480082772891878,0.00659711656054247,0.3901600188325,0.603242864606958
8,"Baden-Württemberg",8337116,"Wehr, Stadt",12637,6032,6605,0.477328479860726,12828,6158,6670,0.480043654505769,0.00659711656054247,0.3901600188325,0.603242864606958
8,"Baden-Württemberg",8337118,"Weilheim",3078,1546,1532,0.50227420402859,3036,1519,1517,0.500329380764163,0.00659711656054247,0.3901600188325,0.603242864606958
8,"Baden-Württemberg",8337123,"Wutöschingen",6467,3186,3281,0.492655017782589,6632,3308,3324,0.498793727382388,0.00659711656054247,0.3901600188325,0.603242864606958
8,"Baden-Württemberg",8337124,"Eggingen",1650,817,833,0.495151515151515,1655,825,830,0.498489425981873,0.00659711656054247,0.3901600188325,0.603242864606958
8,"Baden-Württemberg",8337125,"Küssaberg",5283,2577,2706,0.487791027825099,5460,2681,2779,0.491025641025641,0.00659711656054247,0.3901600188325,0.603242864606958
8,"Baden-Württemberg",8337126,"Waldshut-Tiengen, Stadt",22393,10870,11523,0.485419550752467,23066,11171,11895,0.484305904794936,0.00659711656054247,0.3901600188325,0.603242864606958
8,"Baden-Württemberg",8337127,"Wutach",1213,600,613,0.494641384995878,1208,607,601,0.502483443708609,0.00659711656054247,0.3901600188325,0.603242864606958
8,"Baden-Württemberg",8337128,"Ühlingen-Birkendorf",5145,2603,2542,0.505928085519922,5075,2594,2481,0.511133004926108,0.00659711656054247,0.3901600188325,0.603242864606958
8,"Baden-Württemberg",8415014,"Dettingen an der Erms",9133,4535,4598,0.496550969013468,9308,4661,4647,0.500752041254835,0.00659711656054247,0.3901600188325,0.603242864606958
8,"Baden-Württemberg",8415019,"Eningen unter Achalm",10569,5079,5490,0.480556344024979,11049,5363,5686,0.485383292605666,0.00659711656054247,0.3901600188325,0.603242864606958
8,"Baden-Württemberg",8415027,"Gomadingen",2232,1165,1067,0.521953405017921,2176,1108,1068,0.509191176470588,0.00659711656054247,0.3901600188325,0.603242864606958
8,"Baden-Württemberg",8415028,"Grabenstetten",1551,793,758,0.511283043197937,1537,790,747,0.513988288874431,0.00659711656054247,0.3901600188325,0.603242864606958
8,"Baden-Württemberg",8415029,"Grafenberg",2606,1311,1295,0.503069838833461,2609,1352,1257,0.518206209275584,0.00659711656054247,0.3901600188325,0.603242864606958
8,"Baden-Württemberg",8415034,"Hayingen, Stadt",2114,1086,1028,0.513718070009461,2129,1114,1015,0.523250352278065,0.00659711656054247,0.3901600188325,0.603242864606958
8,"Baden-Württemberg",8415039,"Hülben",2786,1352,1434,0.485283560660445,2790,1355,1435,0.485663082437276,0.00659711656054247,0.3901600188325,0.603242864606958
8,"Baden-Württemberg",8415048,"Mehrstetten",1335,683,652,0.511610486891386,1340,686,654,0.511940298507463,0.00659711656054247,0.3901600188325,0.603242864606958
8,"Baden-Württemberg",8415050,"Metzingen, Stadt",20965,10142,10823,0.483758645361316,22263,10681,11582,0.479764631900463,0.00659711656054247,0.3901600188325,0.603242864606958
8,"Baden-Württemberg",8415053,"Münsingen, Stadt",13963,6764,7199,0.484423118241066,14507,7129,7378,0.491417936168746,0.00659711656054247,0.3901600188325,0.603242864606958
8,"Baden-Württemberg",8415058,"Pfronstetten",1517,800,717,0.5273566249176,1518,796,722,0.52437417654809,0.00659711656054247,0.3901600188325,0.603242864606958
8,"Baden-Württemberg",8415059,"Pfullingen, Stadt",17394,8313,9081,0.47792342186961,18697,9056,9641,0.484355779001979,0.00659711656054247,0.3901600188325,0.603242864606958
8,"Baden-Württemberg",8415060,"Pliezhausen",9282,4579,4703,0.493320405085111,9300,4584,4716,0.492903225806452,0.00659711656054247,0.3901600188325,0.603242864606958
8,"Baden-Württemberg",8415061,"Reutlingen, Stadt",110084,53370,56714,0.484811598415755,112735,55071,57664,0.488499578657915,0.00659711656054247,0.3901600188325,0.603242864606958
8,"Baden-Württemberg",8415062,"Riederich",4189,2065,2124,0.492957746478873,4252,2109,2143,0.496001881467545,0.00659711656054247,0.3901600188325,0.603242864606958
8,"Baden-Württemberg",8415073,"Trochtelfingen, Stadt",6271,3121,3150,0.497687769095838,6365,3191,3174,0.501335428122545,0.00659711656054247,0.3901600188325,0.603242864606958
8,"Baden-Württemberg",8415078,"Bad Urach, Stadt",11717,5739,5978,0.48980114363745,12315,6077,6238,0.493463256191636,0.00659711656054247,0.3901600188325,0.603242864606958
8,"Baden-Württemberg",8415080,"Wannweil",5149,2512,2637,0.48786172072247,5213,2558,2655,0.49069633608287,0.00659711656054247,0.3901600188325,0.603242864606958
8,"Baden-Württemberg",8415085,"Zwiefalten",2164,1147,1017,0.53003696857671,2098,1118,980,0.532888465204957,0.00659711656054247,0.3901600188325,0.603242864606958
8,"Baden-Württemberg",8415087,"Walddorfhäslach",4810,2393,2417,0.497505197505198,4900,2435,2465,0.496938775510204,0.00659711656054247,0.3901600188325,0.603242864606958
8,"Baden-Württemberg",8415088,"Römerstein",3935,1955,1980,0.496823379923761,3896,1929,1967,0.495123203285421,0.00659711656054247,0.3901600188325,0.603242864606958
8,"Baden-Württemberg",8415089,"Engstingen",5147,2521,2626,0.489799883427239,5233,2600,2633,0.496846932925664,0.00659711656054247,0.3901600188325,0.603242864606958
8,"Baden-Württemberg",8415090,"Hohenstein",3664,1838,1826,0.501637554585153,3695,1843,1852,0.498782138024357,0.00659711656054247,0.3901600188325,0.603242864606958
8,"Baden-Württemberg",8415091,"Sonnenbühl",6991,3497,3494,0.500214561579173,6996,3515,3481,0.50242995997713,0.00659711656054247,0.3901600188325,0.603242864606958
8,"Baden-Württemberg",8415092,"Lichtenstein",9013,4457,4556,0.494507932985687,8990,4425,4565,0.492213570634038,0.00659711656054247,0.3901600188325,0.603242864606958
8,"Baden-Württemberg",8415093,"St. Johann",5065,2535,2530,0.500493583415597,5106,2563,2543,0.50195848021935,0.00659711656054247,0.3901600188325,0.603242864606958
8,"Baden-Württemberg",8416006,"Bodelshausen",5668,2823,2845,0.498059280169372,5769,2880,2889,0.499219968798752,0.00659711656054247,0.3901600188325,0.603242864606958
8,"Baden-Württemberg",8416009,"Dettenhausen",5384,2652,2732,0.492570579494799,5390,2678,2712,0.496846011131725,0.00659711656054247,0.3901600188325,0.603242864606958
8,"Baden-Württemberg",8416011,"Dußlingen",5598,2757,2841,0.492497320471597,5565,2768,2797,0.497394429469901,0.00659711656054247,0.3901600188325,0.603242864606958
8,"Baden-Württemberg",8416015,"Gomaringen",8644,4230,4414,0.489356779268857,8683,4254,4429,0.489922837728896,0.00659711656054247,0.3901600188325,0.603242864606958
8,"Baden-Württemberg",8416018,"Hirrlingen",2986,1492,1494,0.499665103817816,2939,1481,1458,0.503912895542702,0.00659711656054247,0.3901600188325,0.603242864606958
8,"Baden-Württemberg",8416022,"Kirchentellinsfurt",5506,2696,2810,0.489647657101344,5576,2753,2823,0.493723098995696,0.00659711656054247,0.3901600188325,0.603242864606958
8,"Baden-Württemberg",8416023,"Kusterdingen",8027,3966,4061,0.494082471658154,8187,4052,4135,0.494930988151948,0.00659711656054247,0.3901600188325,0.603242864606958
8,"Baden-Württemberg",8416025,"Mössingen, Stadt",19390,9357,10033,0.482568334192883,19983,9753,10230,0.488064855126858,0.00659711656054247,0.3901600188325,0.603242864606958
8,"Baden-Württemberg",8416026,"Nehren",4107,2004,2103,0.487947406866326,4243,2072,2171,0.488333726137167,0.00659711656054247,0.3901600188325,0.603242864606958
8,"Baden-Württemberg",8416031,"Ofterdingen",4448,2225,2223,0.500224820143885,4581,2286,2295,0.49901768172888,0.00659711656054247,0.3901600188325,0.603242864606958
8,"Baden-Württemberg",8416036,"Rottenburg am Neckar, Stadt",40938,20235,20703,0.49428403927891,42609,21452,21157,0.503461709967378,0.00659711656054247,0.3901600188325,0.603242864606958
8,"Baden-Württemberg",8416041,"Tübingen, Universitätsstadt",83248,39282,43966,0.471867192004613,89011,42986,46025,0.482929076181596,0.00659711656054247,0.3901600188325,0.603242864606958
8,"Baden-Württemberg",8416048,"Ammerbuch",11159,5541,5618,0.496549870060041,11580,5769,5811,0.498186528497409,0.00659711656054247,0.3901600188325,0.603242864606958
8,"Baden-Württemberg",8416049,"Neustetten",3396,1684,1712,0.495877502944641,3458,1720,1738,0.497397339502603,0.00659711656054247,0.3901600188325,0.603242864606958
8,"Baden-Württemberg",8416050,"Starzach",4301,2096,2205,0.487328528249244,4403,2165,2238,0.491710197592551,0.00659711656054247,0.3901600188325,0.603242864606958
8,"Baden-Württemberg",8417002,"Balingen, Stadt",33247,16216,17031,0.487743255030529,33900,16604,17296,0.489793510324484,0.00659711656054247,0.3901600188325,0.603242864606958
8,"Baden-Württemberg",8417008,"Bisingen",9152,4466,4686,0.487980769230769,9272,4587,4685,0.494715271786022,0.00659711656054247,0.3901600188325,0.603242864606958
8,"Baden-Württemberg",8417010,"Bitz",3648,1765,1883,0.483826754385965,3683,1775,1908,0.481944067336411,0.00659711656054247,0.3901600188325,0.603242864606958
8,"Baden-Württemberg",8417013,"Burladingen, Stadt",12184,5949,6235,0.488263296126067,12213,6004,6209,0.491607303692786,0.00659711656054247,0.3901600188325,0.603242864606958
8,"Baden-Württemberg",8417014,"Dautmergen",397,195,202,0.491183879093199,396,199,197,0.502525252525252,0.00659711656054247,0.3901600188325,0.603242864606958
8,"Baden-Württemberg",8417015,"Dormettingen",1047,529,518,0.505253104106972,1031,526,505,0.510184287099903,0.00659711656054247,0.3901600188325,0.603242864606958
8,"Baden-Württemberg",8417016,"Dotternhausen",1820,929,891,0.51043956043956,1840,927,913,0.503804347826087,0.00659711656054247,0.3901600188325,0.603242864606958
8,"Baden-Württemberg",8417022,"Geislingen, Stadt",5952,2978,2974,0.500336021505376,5964,3021,2943,0.506539235412475,0.00659711656054247,0.3901600188325,0.603242864606958
8,"Baden-Württemberg",8417023,"Grosselfingen",2080,1040,1040,0.5,2087,1039,1048,0.497843794920939,0.00659711656054247,0.3901600188325,0.603242864606958
8,"Baden-Württemberg",8417025,"Haigerloch, Stadt",10549,5200,5349,0.492937719215091,10721,5342,5379,0.498274414700121,0.00659711656054247,0.3901600188325,0.603242864606958
8,"Baden-Württemberg",8417029,"Hausen am Tann",480,233,247,0.485416666666667,505,250,255,0.495049504950495,0.00659711656054247,0.3901600188325,0.603242864606958
8,"Baden-Württemberg",8417031,"Hechingen, Stadt",18623,9089,9534,0.488052408312302,19200,9485,9715,0.494010416666667,0.00659711656054247,0.3901600188325,0.603242864606958
8,"Baden-Württemberg",8417036,"Jungingen",1381,670,711,0.485155684286749,1365,662,703,0.484981684981685,0.00659711656054247,0.3901600188325,0.603242864606958
8,"Baden-Württemberg",8417044,"Meßstetten, Stadt",10084,5000,5084,0.49583498611662,10449,5268,5181,0.504163077806489,0.00659711656054247,0.3901600188325,0.603242864606958
8,"Baden-Württemberg",8417045,"Nusplingen",1813,896,917,0.494208494208494,1787,892,895,0.499160604364857,0.00659711656054247,0.3901600188325,0.603242864606958
8,"Baden-Württemberg",8417047,"Obernheim",1452,716,736,0.493112947658402,1434,705,729,0.49163179916318,0.00659711656054247,0.3901600188325,0.603242864606958
8,"Baden-Württemberg",8417051,"Rangendingen",5082,2497,2585,0.491341991341991,5148,2526,2622,0.490675990675991,0.00659711656054247,0.3901600188325,0.603242864606958
8,"Baden-Württemberg",8417052,"Ratshausen",762,363,399,0.476377952755905,771,366,405,0.474708171206226,0.00659711656054247,0.3901600188325,0.603242864606958
8,"Baden-Württemberg",8417054,"Rosenfeld, Stadt",6417,3210,3207,0.500233754090697,6451,3243,3208,0.502712757711983,0.00659711656054247,0.3901600188325,0.603242864606958
8,"Baden-Württemberg",8417057,"Schömberg, Stadt",4646,2363,2283,0.508609556607835,4620,2387,2233,0.516666666666667,0.00659711656054247,0.3901600188325,0.603242864606958
8,"Baden-Württemberg",8417063,"Straßberg",2501,1249,1252,0.499400239904038,2532,1248,1284,0.492890995260663,0.00659711656054247,0.3901600188325,0.603242864606958
8,"Baden-Württemberg",8417071,"Weilen unter den Rinnen",607,303,304,0.499176276771005,620,305,315,0.491935483870968,0.00659711656054247,0.3901600188325,0.603242864606958
8,"Baden-Württemberg",8417075,"Winterlingen",6460,3151,3309,0.487770897832817,6437,3205,3232,0.497902749728134,0.00659711656054247,0.3901600188325,0.603242864606958
8,"Baden-Württemberg",8417078,"Zimmern unter der Burg",472,245,227,0.519067796610169,466,239,227,0.512875536480687,0.00659711656054247,0.3901600188325,0.603242864606958
8,"Baden-Württemberg",8417079,"Albstadt, Stadt",44273,21620,22653,0.488333747430714,44806,21938,22868,0.48962192563496,0.00659711656054247,0.3901600188325,0.603242864606958
8,"Baden-Württemberg",8421000,"Ulm, Universitätsstadt",117541,57279,60262,0.487310810695842,123672,60965,62707,0.492957177048968,0.00659711656054247,0.3901600188325,0.603242864606958
8,"Baden-Württemberg",8425002,"Allmendingen",4304,2116,2188,0.491635687732342,4395,2195,2200,0.499431171786121,0.00659711656054247,0.3901600188325,0.603242864606958
8,"Baden-Württemberg",8425004,"Altheim",594,305,289,0.513468013468014,585,308,277,0.526495726495727,0.00659711656054247,0.3901600188325,0.603242864606958
8,"Baden-Württemberg",8425005,"Altheim (Alb)",1729,887,842,0.513013302486987,1754,911,843,0.519384264538198,0.00659711656054247,0.3901600188325,0.603242864606958
8,"Baden-Württemberg",8425008,"Amstetten",3903,1966,1937,0.503715090955675,3947,1992,1955,0.504687104129719,0.00659711656054247,0.3901600188325,0.603242864606958
8,"Baden-Württemberg",8425011,"Asselfingen",1009,519,490,0.514370664023786,1015,529,486,0.521182266009852,0.00659711656054247,0.3901600188325,0.603242864606958
8,"Baden-Württemberg",8425013,"Ballendorf",661,317,344,0.479576399394856,669,324,345,0.484304932735426,0.00659711656054247,0.3901600188325,0.603242864606958
8,"Baden-Württemberg",8425014,"Beimerstetten",2520,1238,1282,0.491269841269841,2506,1239,1267,0.494413407821229,0.00659711656054247,0.3901600188325,0.603242864606958
8,"Baden-Württemberg",8425017,"Berghülen",1928,979,949,0.507780082987552,1908,976,932,0.511530398322851,0.00659711656054247,0.3901600188325,0.603242864606958
8,"Baden-Württemberg",8425019,"Bernstadt",2097,1065,1032,0.507868383404864,2089,1051,1038,0.503111536620393,0.00659711656054247,0.3901600188325,0.603242864606958
8,"Baden-Württemberg",8425020,"Blaubeuren, Stadt",11552,5726,5826,0.495671745152355,11824,5868,5956,0.496278755074425,0.00659711656054247,0.3901600188325,0.603242864606958
8,"Baden-Württemberg",8425022,"Börslingen",172,86,86,0.5,174,90,84,0.517241379310345,0.00659711656054247,0.3901600188325,0.603242864606958
8,"Baden-Württemberg",8425024,"Breitingen",266,125,141,0.469924812030075,264,131,133,0.496212121212121,0.00659711656054247,0.3901600188325,0.603242864606958
8,"Baden-Württemberg",8425028,"Dietenheim, Stadt",6572,3216,3356,0.48934875228241,6586,3228,3358,0.49013058001822,0.00659711656054247,0.3901600188325,0.603242864606958
8,"Baden-Württemberg",8425031,"Dornstadt",8471,4263,4208,0.503246369968127,8443,4226,4217,0.500532985905484,0.00659711656054247,0.3901600188325,0.603242864606958
8,"Baden-Württemberg",8425033,"Ehingen (Donau), Stadt",24559,12198,12361,0.496681460971538,25764,12790,12974,0.496429125912125,0.00659711656054247,0.3901600188325,0.603242864606958
8,"Baden-Württemberg",8425035,"Emeringen",135,67,68,0.496296296296296,131,64,67,0.488549618320611,0.00659711656054247,0.3901600188325,0.603242864606958
8,"Baden-Württemberg",8425036,"Emerkingen",830,424,406,0.510843373493976,844,435,409,0.515402843601896,0.00659711656054247,0.3901600188325,0.603242864606958
8,"Baden-Württemberg",8425039,"Erbach, Stadt",12964,6475,6489,0.499460043196544,13181,6619,6562,0.502162203171231,0.00659711656054247,0.3901600188325,0.603242864606958
8,"Baden-Württemberg",8425050,"Griesingen",1023,513,510,0.501466275659824,1054,531,523,0.503795066413662,0.00659711656054247,0.3901600188325,0.603242864606958
8,"Baden-Württemberg",8425052,"Grundsheim",207,96,111,0.463768115942029,195,90,105,0.461538461538462,0.00659711656054247,0.3901600188325,0.603242864606958
8,"Baden-Württemberg",8425055,"Hausen am Bussen",254,128,126,0.503937007874016,268,136,132,0.507462686567164,0.00659711656054247,0.3901600188325,0.603242864606958
8,"Baden-Württemberg",8425062,"Holzkirch",269,135,134,0.50185873605948,266,131,135,0.492481203007519,0.00659711656054247,0.3901600188325,0.603242864606958
8,"Baden-Württemberg",8425064,"Hüttisheim",1359,665,694,0.489330389992642,1352,665,687,0.491863905325444,0.00659711656054247,0.3901600188325,0.603242864606958
8,"Baden-Württemberg",8425066,"Illerrieden",3309,1660,1649,0.501662133575098,3377,1691,1686,0.500740302043234,0.00659711656054247,0.3901600188325,0.603242864606958
8,"Baden-Württemberg",8425071,"Laichingen, Stadt",10876,5420,5456,0.498344979771975,10891,5448,5443,0.50022954733266,0.00659711656054247,0.3901600188325,0.603242864606958
8,"Baden-Württemberg",8425072,"Langenau, Stadt",14046,7011,7035,0.499145664246049,14592,7396,7196,0.506853070175439,0.00659711656054247,0.3901600188325,0.603242864606958
8,"Baden-Württemberg",8425073,"Lauterach",563,287,276,0.509769094138544,574,316,258,0.550522648083624,0.00659711656054247,0.3901600188325,0.603242864606958
8,"Baden-Württemberg",8425075,"Lonsee",4764,2411,2353,0.506087321578505,4720,2402,2318,0.508898305084746,0.00659711656054247,0.3901600188325,0.603242864606958
8,"Baden-Württemberg",8425079,"Merklingen",1901,936,965,0.492372435560231,1874,916,958,0.488794023479189,0.00659711656054247,0.3901600188325,0.603242864606958
8,"Baden-Württemberg",8425081,"Munderkingen, Stadt",5016,2455,2561,0.489433811802233,4917,2413,2504,0.490746390075249,0.00659711656054247,0.3901600188325,0.603242864606958
8,"Baden-Württemberg",8425083,"Neenstetten",819,403,416,0.492063492063492,827,405,422,0.489721886336155,0.00659711656054247,0.3901600188325,0.603242864606958
8,"Baden-Württemberg",8425084,"Nellingen",1847,942,905,0.510016242555495,1892,974,918,0.514799154334038,0.00659711656054247,0.3901600188325,0.603242864606958
8,"Baden-Württemberg",8425085,"Nerenstetten",330,161,169,0.487878787878788,348,171,177,0.491379310344828,0.00659711656054247,0.3901600188325,0.603242864606958
8,"Baden-Württemberg",8425088,"Oberdischingen",2028,991,1037,0.488658777120316,1998,977,1021,0.488988988988989,0.00659711656054247,0.3901600188325,0.603242864606958
8,"Baden-Württemberg",8425090,"Obermarchtal",1256,638,618,0.50796178343949,1261,652,609,0.517049960348929,0.00659711656054247,0.3901600188325,0.603242864606958
8,"Baden-Württemberg",8425091,"Oberstadion",1542,810,732,0.525291828793774,1560,838,722,0.537179487179487,0.00659711656054247,0.3901600188325,0.603242864606958
8,"Baden-Württemberg",8425092,"Öllingen",515,266,249,0.516504854368932,515,268,247,0.520388349514563,0.00659711656054247,0.3901600188325,0.603242864606958
8,"Baden-Württemberg",8425093,"Öpfingen",2244,1119,1125,0.498663101604278,2279,1142,1137,0.501096972356297,0.00659711656054247,0.3901600188325,0.603242864606958
8,"Baden-Württemberg",8425097,"Rammingen",1249,647,602,0.518014411529223,1255,658,597,0.524302788844622,0.00659711656054247,0.3901600188325,0.603242864606958
8,"Baden-Württemberg",8425098,"Rechtenstein",289,151,138,0.522491349480969,279,146,133,0.523297491039427,0.00659711656054247,0.3901600188325,0.603242864606958
8,"Baden-Württemberg",8425104,"Rottenacker",2065,1064,1001,0.515254237288136,2113,1082,1031,0.512068149550402,0.00659711656054247,0.3901600188325,0.603242864606958
8,"Baden-Württemberg",8425108,"Schelklingen, Stadt",6816,3380,3436,0.495892018779343,7029,3570,3459,0.507895860008536,0.00659711656054247,0.3901600188325,0.603242864606958
8,"Baden-Württemberg",8425110,"Schnürpflingen",1328,656,672,0.493975903614458,1331,660,671,0.495867768595041,0.00659711656054247,0.3901600188325,0.603242864606958
8,"Baden-Württemberg",8425112,"Setzingen",634,325,309,0.512618296529968,626,317,309,0.506389776357827,0.00659711656054247,0.3901600188325,0.603242864606958
8,"Baden-Württemberg",8425123,"Untermarchtal",898,331,567,0.368596881959911,923,335,588,0.362946912242687,0.00659711656054247,0.3901600188325,0.603242864606958
8,"Baden-Württemberg",8425124,"Unterstadion",755,379,376,0.501986754966887,726,366,360,0.504132231404959,0.00659711656054247,0.3901600188325,0.603242864606958
8,"Baden-Württemberg",8425125,"Unterwachingen",194,106,88,0.54639175257732,202,107,95,0.52970297029703,0.00659711656054247,0.3901600188325,0.603242864606958
8,"Baden-Württemberg",8425130,"Weidenstetten",1295,651,644,0.502702702702703,1278,660,618,0.516431924882629,0.00659711656054247,0.3901600188325,0.603242864606958
8,"Baden-Württemberg",8425134,"Westerheim",2858,1433,1425,0.501399580125962,2837,1415,1422,0.498766302432147,0.00659711656054247,0.3901600188325,0.603242864606958
8,"Baden-Württemberg",8425135,"Westerstetten",2207,1102,1105,0.499320344358858,2199,1085,1114,0.493406093678945,0.00659711656054247,0.3901600188325,0.603242864606958
8,"Baden-Württemberg",8425137,"Illerkirchberg",4680,2332,2348,0.498290598290598,4754,2380,2374,0.500631047538915,0.00659711656054247,0.3901600188325,0.603242864606958
8,"Baden-Württemberg",8425138,"Staig",3114,1582,1532,0.508028259473346,3152,1585,1567,0.502855329949239,0.00659711656054247,0.3901600188325,0.603242864606958
8,"Baden-Württemberg",8425139,"Heroldstatt",2738,1361,1377,0.497078159240321,2790,1391,1399,0.498566308243728,0.00659711656054247,0.3901600188325,0.603242864606958
8,"Baden-Württemberg",8425140,"Balzheim",1987,1013,974,0.509813789632612,2001,1048,953,0.523738130934533,0.00659711656054247,0.3901600188325,0.603242864606958
8,"Baden-Württemberg",8425141,"Blaustein",14903,7339,7564,0.492451184325304,15491,7701,7790,0.497127364276031,0.00659711656054247,0.3901600188325,0.603242864606958
8,"Baden-Württemberg",8426001,"Achstetten",4195,2111,2084,0.503218116805721,4210,2103,2107,0.499524940617577,0.00659711656054247,0.3901600188325,0.603242864606958
8,"Baden-Württemberg",8426005,"Alleshausen",479,249,230,0.519832985386221,471,246,225,0.522292993630573,0.00659711656054247,0.3901600188325,0.603242864606958
8,"Baden-Württemberg",8426006,"Allmannsweiler",302,155,147,0.513245033112583,301,154,147,0.511627906976744,0.00659711656054247,0.3901600188325,0.603242864606958
8,"Baden-Württemberg",8426008,"Altheim",2148,1063,1085,0.49487895716946,2248,1123,1125,0.499555160142349,0.00659711656054247,0.3901600188325,0.603242864606958
8,"Baden-Württemberg",8426011,"Attenweiler",1762,928,834,0.526674233825199,1720,925,795,0.537790697674419,0.00659711656054247,0.3901600188325,0.603242864606958
8,"Baden-Württemberg",8426013,"Bad Buchau, Stadt",4007,1958,2049,0.488644871474919,3982,1975,2007,0.495981918633852,0.00659711656054247,0.3901600188325,0.603242864606958
8,"Baden-Württemberg",8426014,"Bad Schussenried, Stadt",8333,4152,4181,0.498259930397216,8463,4211,4252,0.497577691126078,0.00659711656054247,0.3901600188325,0.603242864606958
8,"Baden-Württemberg",8426019,"Berkheim",2674,1360,1314,0.508601346297681,2695,1351,1344,0.501298701298701,0.00659711656054247,0.3901600188325,0.603242864606958
8,"Baden-Württemberg",8426020,"Betzenweiler",713,358,355,0.502103786816269,692,350,342,0.505780346820809,0.00659711656054247,0.3901600188325,0.603242864606958
8,"Baden-Württemberg",8426021,"Biberach an der Riß, Stadt",31023,14919,16104,0.48090126680205,32360,15735,16625,0.486248454882571,0.00659711656054247,0.3901600188325,0.603242864606958
8,"Baden-Württemberg",8426028,"Burgrieden",3619,1824,1795,0.504006631666206,3609,1825,1784,0.505680243834857,0.00659711656054247,0.3901600188325,0.603242864606958
8,"Baden-Württemberg",8426031,"Dettingen an der Iller",2293,1147,1146,0.500218054949847,2314,1163,1151,0.502592912705272,0.00659711656054247,0.3901600188325,0.603242864606958
8,"Baden-Württemberg",8426035,"Dürmentingen",2594,1301,1293,0.501542020046261,2592,1311,1281,0.505787037037037,0.00659711656054247,0.3901600188325,0.603242864606958
8,"Baden-Württemberg",8426036,"Dürnau",436,223,213,0.511467889908257,454,230,224,0.506607929515419,0.00659711656054247,0.3901600188325,0.603242864606958
8,"Baden-Württemberg",8426038,"Eberhardzell",4198,2154,2044,0.513101476893759,4162,2139,2023,0.513935607880826,0.00659711656054247,0.3901600188325,0.603242864606958
8,"Baden-Württemberg",8426043,"Erlenmoos",1671,859,812,0.514063435068821,1671,867,804,0.518850987432675,0.00659711656054247,0.3901600188325,0.603242864606958
8,"Baden-Württemberg",8426044,"Erolzheim",3138,1539,1599,0.490439770554493,3147,1545,1602,0.490943755958055,0.00659711656054247,0.3901600188325,0.603242864606958
8,"Baden-Württemberg",8426045,"Ertingen",5415,2732,2683,0.504524469067405,5385,2717,2668,0.504549675023213,0.00659711656054247,0.3901600188325,0.603242864606958
8,"Baden-Württemberg",8426058,"Hochdorf",2114,1030,1084,0.487228003784295,2146,1059,1087,0.493476234855545,0.00659711656054247,0.3901600188325,0.603242864606958
8,"Baden-Württemberg",8426062,"Ingoldingen",2720,1396,1324,0.513235294117647,2648,1357,1291,0.512462235649547,0.00659711656054247,0.3901600188325,0.603242864606958
8,"Baden-Württemberg",8426064,"Kanzach",495,245,250,0.494949494949495,472,232,240,0.491525423728814,0.00659711656054247,0.3901600188325,0.603242864606958
8,"Baden-Württemberg",8426065,"Kirchberg an der Iller",1950,974,976,0.499487179487179,1950,978,972,0.501538461538461,0.00659711656054247,0.3901600188325,0.603242864606958
8,"Baden-Württemberg",8426066,"Kirchdorf an der Iller",3395,1723,1672,0.507511045655376,3419,1731,1688,0.506288388417666,0.00659711656054247,0.3901600188325,0.603242864606958
8,"Baden-Württemberg",8426067,"Langenenslingen",3439,1727,1712,0.502180866530968,3481,1734,1747,0.49813272048262,0.00659711656054247,0.3901600188325,0.603242864606958
8,"Baden-Württemberg",8426070,"Laupheim, Stadt",19700,9723,9977,0.493553299492386,19992,9977,10015,0.499049619847939,0.00659711656054247,0.3901600188325,0.603242864606958
8,"Baden-Württemberg",8426071,"Maselheim",4420,2219,2201,0.502036199095023,4440,2231,2209,0.502477477477478,0.00659711656054247,0.3901600188325,0.603242864606958
8,"Baden-Württemberg",8426073,"Mietingen",4101,2105,1996,0.51328944159961,4103,2146,1957,0.523031927857665,0.00659711656054247,0.3901600188325,0.603242864606958
8,"Baden-Württemberg",8426074,"Mittelbiberach",4127,2033,2094,0.492609643809062,4095,2015,2080,0.492063492063492,0.00659711656054247,0.3901600188325,0.603242864606958
8,"Baden-Württemberg",8426078,"Moosburg",228,118,110,0.517543859649123,168,80,88,0.476190476190476,0.00659711656054247,0.3901600188325,0.603242864606958
8,"Baden-Württemberg",8426087,"Ochsenhausen, Stadt",8638,4322,4316,0.500347302616346,8749,4347,4402,0.496856783632415,0.00659711656054247,0.3901600188325,0.603242864606958
8,"Baden-Württemberg",8426090,"Oggelshausen",908,452,456,0.497797356828194,896,446,450,0.497767857142857,0.00659711656054247,0.3901600188325,0.603242864606958
8,"Baden-Württemberg",8426097,"Riedlingen, Stadt",10051,4910,5141,0.488508606108845,10192,4940,5252,0.48469387755102,0.00659711656054247,0.3901600188325,0.603242864606958
8,"Baden-Württemberg",8426100,"Rot an der Rot",4383,2245,2138,0.512206251425964,4400,2276,2124,0.517272727272727,0.00659711656054247,0.3901600188325,0.603242864606958
8,"Baden-Württemberg",8426108,"Schwendi",6213,3131,3082,0.503943344600032,6235,3152,3083,0.505533279871692,0.00659711656054247,0.3901600188325,0.603242864606958
8,"Baden-Württemberg",8426109,"Seekirch",288,143,145,0.496527777777778,286,136,150,0.475524475524476,0.00659711656054247,0.3901600188325,0.603242864606958
8,"Baden-Württemberg",8426113,"Steinhausen an der Rottum",1976,990,986,0.501012145748988,1953,987,966,0.505376344086022,0.00659711656054247,0.3901600188325,0.603242864606958
8,"Baden-Württemberg",8426117,"Tannheim",2336,1153,1183,0.493578767123288,2321,1154,1167,0.497199482981473,0.00659711656054247,0.3901600188325,0.603242864606958
8,"Baden-Württemberg",8426118,"Tiefenbach",500,247,253,0.494,505,256,249,0.506930693069307,0.00659711656054247,0.3901600188325,0.603242864606958
8,"Baden-Württemberg",8426120,"Ummendorf",4358,2184,2174,0.50114731528224,4375,2194,2181,0.501485714285714,0.00659711656054247,0.3901600188325,0.603242864606958
8,"Baden-Württemberg",8426121,"Unlingen",2406,1193,1213,0.495843724023275,2430,1213,1217,0.49917695473251,0.00659711656054247,0.3901600188325,0.603242864606958
8,"Baden-Württemberg",8426124,"Uttenweiler",3538,1795,1743,0.507348784624081,3579,1824,1755,0.509639564124057,0.00659711656054247,0.3901600188325,0.603242864606958
8,"Baden-Württemberg",8426125,"Wain",1556,791,765,0.508354755784062,1556,805,751,0.517352185089974,0.00659711656054247,0.3901600188325,0.603242864606958
8,"Baden-Württemberg",8426128,"Warthausen",5021,2463,2558,0.490539733120892,5016,2489,2527,0.496212121212121,0.00659711656054247,0.3901600188325,0.603242864606958
8,"Baden-Württemberg",8426134,"Schemmerhofen",7784,3896,3888,0.500513874614594,7834,3906,3928,0.498595864181772,0.00659711656054247,0.3901600188325,0.603242864606958
8,"Baden-Württemberg",8426135,"Gutenzell-Hürbel",1863,939,924,0.50402576489533,1806,935,871,0.517718715393134,0.00659711656054247,0.3901600188325,0.603242864606958
8,"Baden-Württemberg",8435005,"Bermatingen",3816,1902,1914,0.498427672955975,3866,1922,1944,0.497154681841697,0.00659711656054247,0.3901600188325,0.603242864606958
8,"Baden-Württemberg",8435010,"Daisendorf",1538,756,782,0.491547464239272,1589,784,805,0.493392070484582,0.00659711656054247,0.3901600188325,0.603242864606958
8,"Baden-Württemberg",8435013,"Eriskirch",4583,2288,2295,0.499236308095134,4610,2327,2283,0.504772234273319,0.00659711656054247,0.3901600188325,0.603242864606958
8,"Baden-Württemberg",8435015,"Frickingen",2871,1435,1436,0.499825844653431,2749,1381,1368,0.502364496180429,0.00659711656054247,0.3901600188325,0.603242864606958
8,"Baden-Württemberg",8435016,"Friedrichshafen, Stadt",57153,27939,29214,0.488845729882946,59286,29242,30044,0.49323617717505,0.00659711656054247,0.3901600188325,0.603242864606958
8,"Baden-Württemberg",8435018,"Hagnau am Bodensee",1389,647,742,0.465802735781138,1451,679,772,0.467953135768436,0.00659711656054247,0.3901600188325,0.603242864606958
8,"Baden-Württemberg",8435020,"Heiligenberg",2946,1458,1488,0.494908350305499,2843,1413,1430,0.497010200492438,0.00659711656054247,0.3901600188325,0.603242864606958
8,"Baden-Württemberg",8435024,"Immenstaad am Bodensee",6182,3032,3150,0.490456163054028,6122,3011,3111,0.491832734400523,0.00659711656054247,0.3901600188325,0.603242864606958
8,"Baden-Württemberg",8435029,"Kressbronn am Bodensee",8275,4078,4197,0.492809667673716,8248,4047,4201,0.490664403491756,0.00659711656054247,0.3901600188325,0.603242864606958
8,"Baden-Württemberg",8435030,"Langenargen",7571,3697,3874,0.488310659093911,7848,3851,3997,0.490698267074414,0.00659711656054247,0.3901600188325,0.603242864606958
8,"Baden-Württemberg",8435034,"Markdorf, Stadt",12866,6278,6588,0.487952743665475,13172,6416,6756,0.487093835408442,0.00659711656054247,0.3901600188325,0.603242864606958
8,"Baden-Württemberg",8435035,"Meckenbeuren",13037,6488,6549,0.497660504717343,13504,6851,6653,0.507331161137441,0.00659711656054247,0.3901600188325,0.603242864606958
8,"Baden-Württemberg",8435036,"Meersburg, Stadt",5428,2591,2837,0.477339719970523,5658,2718,2940,0.480381760339343,0.00659711656054247,0.3901600188325,0.603242864606958
8,"Baden-Württemberg",8435042,"Neukirch",2622,1359,1263,0.518306636155606,2655,1372,1283,0.516760828625235,0.00659711656054247,0.3901600188325,0.603242864606958
8,"Baden-Württemberg",8435045,"Oberteuringen",4461,2243,2218,0.502802062317866,4497,2264,2233,0.503446742272626,0.00659711656054247,0.3901600188325,0.603242864606958
8,"Baden-Württemberg",8435047,"Owingen",4210,2127,2083,0.505225653206651,4271,2153,2118,0.504097401077031,0.00659711656054247,0.3901600188325,0.603242864606958
8,"Baden-Württemberg",8435052,"Salem",10946,5304,5642,0.484560570071259,11236,5597,5639,0.49813100747597,0.00659711656054247,0.3901600188325,0.603242864606958
8,"Baden-Württemberg",8435053,"Sipplingen",2073,1016,1057,0.490110950313555,2085,1040,1045,0.498800959232614,0.00659711656054247,0.3901600188325,0.603242864606958
8,"Baden-Württemberg",8435054,"Stetten",964,457,507,0.474066390041494,970,439,531,0.452577319587629,0.00659711656054247,0.3901600188325,0.603242864606958
8,"Baden-Württemberg",8435057,"Tettnang, Stadt",18076,8997,9079,0.497731799070591,18765,9456,9309,0.503916866506795,0.00659711656054247,0.3901600188325,0.603242864606958
8,"Baden-Württemberg",8435059,"Überlingen, Stadt",21589,9914,11675,0.459215341145954,22086,10209,11877,0.462238522140723,0.00659711656054247,0.3901600188325,0.603242864606958
8,"Baden-Württemberg",8435066,"Uhldingen-Mühlhofen",7802,3813,3989,0.488720840810049,7924,3874,4050,0.48889449772842,0.00659711656054247,0.3901600188325,0.603242864606958
8,"Baden-Württemberg",8435067,"Deggenhausertal",4085,2054,2031,0.50281517747858,4298,2157,2141,0.501861330851559,0.00659711656054247,0.3901600188325,0.603242864606958
8,"Baden-Württemberg",8436001,"Achberg",1701,829,872,0.487360376249265,1666,823,843,0.493997599039616,0.00659711656054247,0.3901600188325,0.603242864606958
8,"Baden-Württemberg",8436003,"Aichstetten",2675,1368,1307,0.511401869158879,2711,1402,1309,0.517152342309111,0.00659711656054247,0.3901600188325,0.603242864606958
8,"Baden-Württemberg",8436004,"Aitrach",2482,1262,1220,0.508460918614021,2509,1275,1234,0.508170585890793,0.00659711656054247,0.3901600188325,0.603242864606958
8,"Baden-Württemberg",8436005,"Altshausen",4053,2055,1998,0.507031828275352,4655,2594,2061,0.557250268528464,0.00659711656054247,0.3901600188325,0.603242864606958
8,"Baden-Württemberg",8436006,"Amtzell",3947,1934,2013,0.4899923992906,3933,1929,2004,0.490465293668955,0.00659711656054247,0.3901600188325,0.603242864606958
8,"Baden-Württemberg",8436008,"Aulendorf, Stadt",9575,4727,4848,0.493681462140992,9825,4846,4979,0.49323155216285,0.00659711656054247,0.3901600188325,0.603242864606958
8,"Baden-Württemberg",8436009,"Bad Waldsee, Stadt",19427,9339,10088,0.480722705512946,19887,9555,10332,0.480464625131996,0.00659711656054247,0.3901600188325,0.603242864606958
8,"Baden-Württemberg",8436010,"Bad Wurzach, Stadt",14148,7158,6990,0.505937234944869,14403,7349,7054,0.510240922030133,0.00659711656054247,0.3901600188325,0.603242864606958
8,"Baden-Württemberg",8436011,"Baienfurt",7091,3488,3603,0.491891129600903,7184,3562,3622,0.495824053452116,0.00659711656054247,0.3901600188325,0.603242864606958
8,"Baden-Württemberg",8436012,"Baindt",4951,2457,2494,0.496263381135124,4926,2440,2486,0.49533089727974,0.00659711656054247,0.3901600188325,0.603242864606958
8,"Baden-Württemberg",8436013,"Berg",4072,2028,2044,0.49803536345776,3929,1970,1959,0.501399847289387,0.00659711656054247,0.3901600188325,0.603242864606958
8,"Baden-Württemberg",8436014,"Bergatreute",3159,1602,1557,0.507122507122507,3149,1611,1538,0.511590981263893,0.00659711656054247,0.3901600188325,0.603242864606958
8,"Baden-Württemberg",8436018,"Bodnegg",3115,1570,1545,0.504012841091493,3128,1591,1537,0.508631713554987,0.00659711656054247,0.3901600188325,0.603242864606958
8,"Baden-Württemberg",8436019,"Boms",614,319,295,0.519543973941368,624,331,293,0.530448717948718,0.00659711656054247,0.3901600188325,0.603242864606958
8,"Baden-Württemberg",8436024,"Ebenweiler",1196,622,574,0.520066889632107,1180,606,574,0.513559322033898,0.00659711656054247,0.3901600188325,0.603242864606958
8,"Baden-Württemberg",8436027,"Eichstegen",483,235,248,0.486542443064182,495,245,250,0.494949494949495,0.00659711656054247,0.3901600188325,0.603242864606958
8,"Baden-Württemberg",8436032,"Fleischwangen",656,351,305,0.535060975609756,646,348,298,0.538699690402477,0.00659711656054247,0.3901600188325,0.603242864606958
8,"Baden-Württemberg",8436039,"Grünkraut",2997,1502,1495,0.501167834501168,3128,1584,1544,0.506393861892583,0.00659711656054247,0.3901600188325,0.603242864606958
8,"Baden-Württemberg",8436040,"Guggenhausen",164,76,88,0.463414634146341,179,94,85,0.525139664804469,0.00659711656054247,0.3901600188325,0.603242864606958
8,"Baden-Württemberg",8436047,"Hoßkirch",758,390,368,0.514511873350924,741,388,353,0.52361673414305,0.00659711656054247,0.3901600188325,0.603242864606958
8,"Baden-Württemberg",8436049,"Isny im Allgäu, Stadt",13065,6391,6674,0.489169536930731,14496,6972,7524,0.480960264900662,0.00659711656054247,0.3901600188325,0.603242864606958
8,"Baden-Württemberg",8436052,"Kißlegg",8554,4226,4328,0.4940378770166,8531,4204,4327,0.492790997538389,0.00659711656054247,0.3901600188325,0.603242864606958
8,"Baden-Württemberg",8436053,"Königseggwald",670,336,334,0.501492537313433,684,347,337,0.507309941520468,0.00659711656054247,0.3901600188325,0.603242864606958
8,"Baden-Württemberg",8436055,"Leutkirch im Allgäu, Stadt",21670,10692,10978,0.493401015228426,21909,10918,10991,0.498334017983477,0.00659711656054247,0.3901600188325,0.603242864606958
8,"Baden-Württemberg",8436064,"Ravensburg, Stadt",48466,23449,25017,0.483823711467833,49929,24143,25786,0.483546636223437,0.00659711656054247,0.3901600188325,0.603242864606958
8,"Baden-Württemberg",8436067,"Riedhausen",640,318,322,0.496875,639,316,323,0.49452269170579,0.00659711656054247,0.3901600188325,0.603242864606958
8,"Baden-Württemberg",8436069,"Schlier",3648,1808,1840,0.495614035087719,3730,1849,1881,0.495710455764075,0.00659711656054247,0.3901600188325,0.603242864606958
8,"Baden-Württemberg",8436077,"Unterwaldhausen",277,136,141,0.490974729241877,283,142,141,0.501766784452297,0.00659711656054247,0.3901600188325,0.603242864606958
8,"Baden-Württemberg",8436078,"Vogt",4473,2245,2228,0.501900290632685,4509,2287,2222,0.507207806609004,0.00659711656054247,0.3901600188325,0.603242864606958
8,"Baden-Württemberg",8436079,"Waldburg",3073,1517,1556,0.493654409371949,3054,1507,1547,0.493451211525868,0.00659711656054247,0.3901600188325,0.603242864606958
8,"Baden-Württemberg",8436081,"Wangen im Allgäu, Stadt",26208,12542,13666,0.478556166056166,27463,13354,14109,0.486254232967993,0.00659711656054247,0.3901600188325,0.603242864606958
8,"Baden-Württemberg",8436082,"Weingarten, Stadt",22907,10880,12027,0.474963984808137,24233,11899,12334,0.491024635827178,0.00659711656054247,0.3901600188325,0.603242864606958
8,"Baden-Württemberg",8436083,"Wilhelmsdorf",4718,2358,2360,0.499788045782111,4809,2425,2384,0.504262840507382,0.00659711656054247,0.3901600188325,0.603242864606958
8,"Baden-Württemberg",8436085,"Wolfegg",3495,1724,1771,0.493276108726752,3484,1735,1749,0.497990815154994,0.00659711656054247,0.3901600188325,0.603242864606958
8,"Baden-Württemberg",8436087,"Wolpertswende",4030,2039,1991,0.505955334987593,4021,2045,1976,0.508579955235016,0.00659711656054247,0.3901600188325,0.603242864606958
8,"Baden-Württemberg",8436093,"Ebersbach-Musbach",1651,848,803,0.513628104179285,1725,914,811,0.529855072463768,0.00659711656054247,0.3901600188325,0.603242864606958
8,"Baden-Württemberg",8436094,"Argenbühl",6024,3046,2978,0.505644090305445,6069,3066,3003,0.505190311418685,0.00659711656054247,0.3901600188325,0.603242864606958
8,"Baden-Württemberg",8436095,"Horgenzell",4881,2496,2385,0.511370620774432,4931,2531,2400,0.513283309673494,0.00659711656054247,0.3901600188325,0.603242864606958
8,"Baden-Württemberg",8436096,"Fronreute",4415,2221,2194,0.503057757644394,4512,2303,2209,0.510416666666667,0.00659711656054247,0.3901600188325,0.603242864606958
8,"Baden-Württemberg",8437005,"Beuron",689,384,305,0.55732946298984,680,382,298,0.561764705882353,0.00659711656054247,0.3901600188325,0.603242864606958
8,"Baden-Württemberg",8437008,"Bingen",2737,1376,1361,0.502740226525393,2747,1373,1374,0.499817983254459,0.00659711656054247,0.3901600188325,0.603242864606958
8,"Baden-Württemberg",8437031,"Gammertingen, Stadt",6308,3136,3172,0.49714648065948,6438,3151,3287,0.489437713575645,0.00659711656054247,0.3901600188325,0.603242864606958
8,"Baden-Württemberg",8437044,"Herbertingen",4833,2455,2378,0.507966066625285,4865,2450,2415,0.503597122302158,0.00659711656054247,0.3901600188325,0.603242864606958
8,"Baden-Württemberg",8437047,"Hettingen, Stadt",1818,891,927,0.49009900990099,1852,927,925,0.500539956803456,0.00659711656054247,0.3901600188325,0.603242864606958
8,"Baden-Württemberg",8437053,"Hohentengen",4127,2081,2046,0.504240368306276,4333,2300,2033,0.530810062312486,0.00659711656054247,0.3901600188325,0.603242864606958
8,"Baden-Württemberg",8437056,"Illmensee",1962,976,986,0.497451580020387,1973,992,981,0.502787633046123,0.00659711656054247,0.3901600188325,0.603242864606958
8,"Baden-Württemberg",8437059,"Inzigkofen",2780,1362,1418,0.489928057553957,2887,1414,1473,0.489781780394874,0.00659711656054247,0.3901600188325,0.603242864606958
8,"Baden-Württemberg",8437065,"Krauchenwies",5021,2513,2508,0.500497908783111,5009,2470,2539,0.493112397684168,0.00659711656054247,0.3901600188325,0.603242864606958
8,"Baden-Württemberg",8437072,"Leibertingen",2158,1086,1072,0.5032437442076,2213,1130,1083,0.510619069136918,0.00659711656054247,0.3901600188325,0.603242864606958
8,"Baden-Württemberg",8437076,"Mengen, Stadt",9866,4881,4985,0.494729373606325,9896,4874,5022,0.492522231204527,0.00659711656054247,0.3901600188325,0.603242864606958
8,"Baden-Württemberg",8437078,"Meßkirch, Stadt",8128,4024,4104,0.49507874015748,8186,4058,4128,0.495724407525043,0.00659711656054247,0.3901600188325,0.603242864606958
8,"Baden-Württemberg",8437082,"Neufra",1849,914,935,0.494321254732288,1875,910,965,0.485333333333333,0.00659711656054247,0.3901600188325,0.603242864606958
8,"Baden-Württemberg",8437086,"Ostrach",6719,3356,3363,0.499479089150171,6676,3310,3366,0.495805871779509,0.00659711656054247,0.3901600188325,0.603242864606958
8,"Baden-Württemberg",8437088,"Pfullendorf, Stadt",12925,6427,6498,0.497253384912959,13010,6622,6388,0.508993082244427,0.00659711656054247,0.3901600188325,0.603242864606958
8,"Baden-Württemberg",8437100,"Bad Saulgau, Stadt",17013,8207,8806,0.482395814965027,17351,8254,9097,0.475707452020056,0.00659711656054247,0.3901600188325,0.603242864606958
8,"Baden-Württemberg",8437101,"Scheer, Stadt",2497,1255,1242,0.502603123748498,2531,1271,1260,0.502173054128803,0.00659711656054247,0.3901600188325,0.603242864606958
8,"Baden-Württemberg",8437102,"Schwenningen",1616,821,795,0.508044554455445,1469,737,732,0.501701837985024,0.00659711656054247,0.3901600188325,0.603242864606958
8,"Baden-Württemberg",8437104,"Sigmaringen, Stadt",15379,7386,7993,0.480265296833344,16449,8239,8210,0.500881512553955,0.00659711656054247,0.3901600188325,0.603242864606958
8,"Baden-Württemberg",8437105,"Sigmaringendorf",3595,1776,1819,0.494019471488178,3628,1801,1827,0.496416758544653,0.00659711656054247,0.3901600188325,0.603242864606958
8,"Baden-Württemberg",8437107,"Stetten am kalten Markt",4870,2417,2453,0.496303901437372,5038,2563,2475,0.508733624454148,0.00659711656054247,0.3901600188325,0.603242864606958
8,"Baden-Württemberg",8437114,"Veringenstadt, Stadt",2226,1126,1100,0.505840071877808,2197,1105,1092,0.502958579881657,0.00659711656054247,0.3901600188325,0.603242864606958
8,"Baden-Württemberg",8437118,"Wald",2608,1226,1382,0.470092024539877,2693,1223,1470,0.454140363906424,0.00659711656054247,0.3901600188325,0.603242864606958
8,"Baden-Württemberg",8437123,"Sauldorf",2507,1274,1233,0.508177104108496,2499,1253,1246,0.50140056022409,0.00659711656054247,0.3901600188325,0.603242864606958
8,"Baden-Württemberg",8437124,"Herdwangen-Schönach",3178,1578,1600,0.496538703587162,3353,1671,1682,0.498359677900388,0.00659711656054247,0.3901600188325,0.603242864606958
9,"Bayern",9161000,"Ingolstadt",126076,62647,63429,0.49689869602462,126732,63519,63213,0.501207272038633,0.0111070810043453,0.338686702969655,0.650206216026
9,"Bayern",9162000,"München, Landeshauptstadt",1364920,659993,704927,0.483539694634118,1378176,670940,707236,0.486831870530324,0.0111070810043453,0.338686702969655,0.650206216026
9,"Bayern",9163000,"Rosenheim",59543,28959,30584,0.486354399341652,61512,30089,31423,0.489156587332553,0.0111070810043453,0.338686702969655,0.650206216026
9,"Bayern",9171111,"Altötting, St",12438,5717,6721,0.459639813474835,12612,5901,6711,0.467887725975262,0.0111070810043453,0.338686702969655,0.650206216026
9,"Bayern",9171112,"Burghausen, St",17544,8447,9097,0.481475148198814,18222,8914,9308,0.48918889254747,0.0111070810043453,0.338686702969655,0.650206216026
9,"Bayern",9171113,"Burgkirchen a.d.Alz",10058,4931,5127,0.490256512229071,10467,5175,5292,0.494411006018917,0.0111070810043453,0.338686702969655,0.650206216026
9,"Bayern",9171114,"Emmerting",4081,2029,2052,0.497182063219799,4136,2079,2057,0.502659574468085,0.0111070810043453,0.338686702969655,0.650206216026
9,"Bayern",9171115,"Erlbach",1165,575,590,0.493562231759657,1174,580,594,0.494037478705281,0.0111070810043453,0.338686702969655,0.650206216026
9,"Bayern",9171116,"Feichten a.d.Alz",1189,608,581,0.511354079058032,1187,609,578,0.513058129738837,0.0111070810043453,0.338686702969655,0.650206216026
9,"Bayern",9171117,"Garching a.d.Alz",8512,4143,4369,0.48672462406015,8403,4088,4315,0.486492919195525,0.0111070810043453,0.338686702969655,0.650206216026
9,"Bayern",9171118,"Haiming",2438,1187,1251,0.48687448728466,2466,1181,1285,0.478913219789132,0.0111070810043453,0.338686702969655,0.650206216026
9,"Bayern",9171119,"Halsbach",953,517,436,0.542497376705142,953,529,424,0.555089192025184,0.0111070810043453,0.338686702969655,0.650206216026
9,"Bayern",9171121,"Kastl",2650,1301,1349,0.490943396226415,2645,1328,1317,0.502079395085066,0.0111070810043453,0.338686702969655,0.650206216026
9,"Bayern",9171122,"Kirchweidach",2279,1179,1100,0.517332163229487,2293,1192,1101,0.51984300043611,0.0111070810043453,0.338686702969655,0.650206216026
9,"Bayern",9171123,"Marktl, M",2642,1326,1316,0.501892505677517,2653,1351,1302,0.509234828496042,0.0111070810043453,0.338686702969655,0.650206216026
9,"Bayern",9171124,"Mehring",2226,1129,1097,0.507187780772686,2244,1135,1109,0.505793226381462,0.0111070810043453,0.338686702969655,0.650206216026
9,"Bayern",9171125,"Neuötting, St",8379,4080,4299,0.486931614751164,8527,4104,4423,0.48129471091826,0.0111070810043453,0.338686702969655,0.650206216026
9,"Bayern",9171126,"Perach",1195,575,620,0.481171548117155,1209,587,622,0.485525227460711,0.0111070810043453,0.338686702969655,0.650206216026
9,"Bayern",9171127,"Pleiskirchen",2373,1213,1160,0.511167298777918,2374,1219,1155,0.513479359730413,0.0111070810043453,0.338686702969655,0.650206216026
9,"Bayern",9171129,"Reischach",2586,1289,1297,0.498453209590101,2619,1309,1310,0.499809087437953,0.0111070810043453,0.338686702969655,0.650206216026
9,"Bayern",9171130,"Stammham",1018,526,492,0.516699410609037,1047,547,500,0.522445081184336,0.0111070810043453,0.338686702969655,0.650206216026
9,"Bayern",9171131,"Teising",1854,911,943,0.491370010787486,1873,927,946,0.494927923117993,0.0111070810043453,0.338686702969655,0.650206216026
9,"Bayern",9171132,"Töging a.Inn, St",9119,4400,4719,0.482509047044632,9089,4360,4729,0.479700737154802,0.0111070810043453,0.338686702969655,0.650206216026
9,"Bayern",9171133,"Tüßling, M",3211,1591,1620,0.495484272812208,3229,1588,1641,0.491793124806442,0.0111070810043453,0.338686702969655,0.650206216026
9,"Bayern",9171134,"Tyrlaching",950,481,469,0.506315789473684,972,492,480,0.506172839506173,0.0111070810043453,0.338686702969655,0.650206216026
9,"Bayern",9171135,"Unterneukirchen",2873,1449,1424,0.504350852767142,2928,1479,1449,0.505122950819672,0.0111070810043453,0.338686702969655,0.650206216026
9,"Bayern",9171137,"Winhöring",4609,2266,2343,0.491646778042959,4679,2295,2384,0.490489420816414,0.0111070810043453,0.338686702969655,0.650206216026
9,"Bayern",9172111,"Ainring",9563,4658,4905,0.48708564258078,9871,4836,5035,0.489919967581805,0.0111070810043453,0.338686702969655,0.650206216026
9,"Bayern",9172112,"Anger",4324,2217,2107,0.512719703977798,4352,2235,2117,0.513556985294118,0.0111070810043453,0.338686702969655,0.650206216026
9,"Bayern",9172114,"Bad Reichenhall, GKSt",16907,7852,9055,0.464423020050866,17513,8008,9505,0.457260320904471,0.0111070810043453,0.338686702969655,0.650206216026
9,"Bayern",9172115,"Bayerisch Gmain",2980,1458,1522,0.489261744966443,3102,1525,1577,0.491618310767247,0.0111070810043453,0.338686702969655,0.650206216026
9,"Bayern",9172116,"Berchtesgaden, M",7630,3676,3954,0.48178243774574,7713,3742,3971,0.485154933229612,0.0111070810043453,0.338686702969655,0.650206216026
9,"Bayern",9172117,"Bischofswiesen",7439,3540,3899,0.475870412689878,7596,3611,3985,0.47538177988415,0.0111070810043453,0.338686702969655,0.650206216026
9,"Bayern",9172118,"Freilassing, St",15838,7586,8252,0.478974618007324,16087,7816,8271,0.485858146329334,0.0111070810043453,0.338686702969655,0.650206216026
9,"Bayern",9172122,"Laufen, St",6820,3425,3395,0.502199413489736,6629,3344,3285,0.5044501433097,0.0111070810043453,0.338686702969655,0.650206216026
9,"Bayern",9172124,"Marktschellenberg, M",1751,899,852,0.513420902341519,1803,933,870,0.517470881863561,0.0111070810043453,0.338686702969655,0.650206216026
9,"Bayern",9172128,"Piding",5133,2497,2636,0.486460159750633,5260,2586,2674,0.491634980988593,0.0111070810043453,0.338686702969655,0.650206216026
9,"Bayern",9172129,"Ramsau b.Berchtesgaden",1741,859,882,0.493394600804136,1816,902,914,0.496696035242291,0.0111070810043453,0.338686702969655,0.650206216026
9,"Bayern",9172130,"Saaldorf-Surheim",5260,2620,2640,0.498098859315589,5265,2629,2636,0.499335232668566,0.0111070810043453,0.338686702969655,0.650206216026
9,"Bayern",9172131,"Schneizlreuth",1338,676,662,0.505231689088191,1432,727,705,0.50768156424581,0.0111070810043453,0.338686702969655,0.650206216026
9,"Bayern",9172132,"Schönau a.Königssee",5356,2593,2763,0.484129947722181,5339,2624,2715,0.491477804832366,0.0111070810043453,0.338686702969655,0.650206216026
9,"Bayern",9172134,"Teisendorf, M",9183,4605,4578,0.501470107807906,9216,4612,4604,0.500434027777778,0.0111070810043453,0.338686702969655,0.650206216026
9,"Bayern",9173111,"Bad Heilbrunn",3660,1820,1840,0.497267759562842,3773,1863,1910,0.493771534587861,0.0111070810043453,0.338686702969655,0.650206216026
9,"Bayern",9173112,"Bad Tölz, St",17748,8323,9425,0.468954248366013,18094,8531,9563,0.471482259312479,0.0111070810043453,0.338686702969655,0.650206216026
9,"Bayern",9173113,"Benediktbeuern",3538,1681,1857,0.475127190503109,3587,1705,1882,0.475327571787009,0.0111070810043453,0.338686702969655,0.650206216026
9,"Bayern",9173115,"Bichl",2079,1026,1053,0.493506493506494,2137,1056,1081,0.494150678521292,0.0111070810043453,0.338686702969655,0.650206216026
9,"Bayern",9173118,"Dietramszell",5300,2696,2604,0.508679245283019,5304,2701,2603,0.509238310708899,0.0111070810043453,0.338686702969655,0.650206216026
9,"Bayern",9173120,"Egling",5333,2720,2613,0.510031876992312,5394,2766,2628,0.512791991101224,0.0111070810043453,0.338686702969655,0.650206216026
9,"Bayern",9173123,"Eurasburg",4247,2115,2132,0.49799858723805,4349,2192,2157,0.504023913543343,0.0111070810043453,0.338686702969655,0.650206216026
9,"Bayern",9173124,"Gaißach",2975,1513,1462,0.508571428571429,2955,1506,1449,0.509644670050761,0.0111070810043453,0.338686702969655,0.650206216026
9,"Bayern",9173126,"Geretsried, St",23070,11301,11769,0.489856957087126,23384,11480,11904,0.49093397194663,0.0111070810043453,0.338686702969655,0.650206216026
9,"Bayern",9173127,"Greiling",1391,684,707,0.491732566498922,1385,673,712,0.485920577617329,0.0111070810043453,0.338686702969655,0.650206216026
9,"Bayern",9173130,"Icking",3640,1829,1811,0.502472527472527,3776,1904,1872,0.504237288135593,0.0111070810043453,0.338686702969655,0.650206216026
9,"Bayern",9173131,"Jachenau",841,416,425,0.494649227110583,886,439,447,0.49548532731377,0.0111070810043453,0.338686702969655,0.650206216026
9,"Bayern",9173133,"Kochel a.See",3980,1917,2063,0.481658291457286,4098,1997,2101,0.487310883357735,0.0111070810043453,0.338686702969655,0.650206216026
9,"Bayern",9173134,"Königsdorf",2967,1473,1494,0.496461071789687,2948,1441,1507,0.488805970149254,0.0111070810043453,0.338686702969655,0.650206216026
9,"Bayern",9173135,"Lenggries",9548,4573,4975,0.478948470883955,9798,4719,5079,0.48162890385793,0.0111070810043453,0.338686702969655,0.650206216026
9,"Bayern",9173137,"Münsing",4132,2010,2122,0.486447241045499,4187,2043,2144,0.487938858371149,0.0111070810043453,0.338686702969655,0.650206216026
9,"Bayern",9173140,"Reichersbeuern",2246,1112,1134,0.495102404274265,2226,1052,1174,0.472596585804133,0.0111070810043453,0.338686702969655,0.650206216026
9,"Bayern",9173141,"Sachsenkam",1270,635,635,0.5,1284,628,656,0.489096573208723,0.0111070810043453,0.338686702969655,0.650206216026
9,"Bayern",9173142,"Schlehdorf",1224,560,664,0.457516339869281,1230,567,663,0.460975609756098,0.0111070810043453,0.338686702969655,0.650206216026
9,"Bayern",9173145,"Wackersberg",3354,1658,1696,0.494335122242099,3591,1791,1800,0.49874686716792,0.0111070810043453,0.338686702969655,0.650206216026
9,"Bayern",9173147,"Wolfratshausen, St",17190,8273,8917,0.481268179173938,17956,8708,9248,0.484963243484072,0.0111070810043453,0.338686702969655,0.650206216026
9,"Bayern",9174111,"Altomünster, M",7404,3717,3687,0.502025931928687,7521,3789,3732,0.503789389708815,0.0111070810043453,0.338686702969655,0.650206216026
9,"Bayern",9174113,"Bergkirchen",7235,3642,3593,0.503386316516932,7273,3649,3624,0.501718685549292,0.0111070810043453,0.338686702969655,0.650206216026
9,"Bayern",9174115,"Dachau, GKSt",43941,21266,22675,0.483967137752896,43255,21054,22201,0.486741417177205,0.0111070810043453,0.338686702969655,0.650206216026
9,"Bayern",9174118,"Erdweg",5586,2783,2803,0.498209810239885,5657,2864,2793,0.506275410995227,0.0111070810043453,0.338686702969655,0.650206216026
9,"Bayern",9174121,"Haimhausen",4979,2454,2525,0.492870054227757,4924,2431,2493,0.493704305442729,0.0111070810043453,0.338686702969655,0.650206216026
9,"Bayern",9174122,"Hebertshausen",5287,2613,2674,0.494231132967657,5354,2664,2690,0.497571908853194,0.0111070810043453,0.338686702969655,0.650206216026
9,"Bayern",9174126,"Karlsfeld",18398,9061,9337,0.492499184693988,18686,9322,9364,0.498876163973028,0.0111070810043453,0.338686702969655,0.650206216026
9,"Bayern",9174131,"Markt Indersdorf, M",9465,4702,4763,0.496777601690438,9428,4702,4726,0.498727195587611,0.0111070810043453,0.338686702969655,0.650206216026
9,"Bayern",9174135,"Odelzhausen",4487,2220,2267,0.494762647648763,4349,2179,2170,0.501034720625431,0.0111070810043453,0.338686702969655,0.650206216026
9,"Bayern",9174136,"Petershausen",6064,2978,3086,0.491094986807388,6128,3002,3126,0.489882506527415,0.0111070810043453,0.338686702969655,0.650206216026
9,"Bayern",9174137,"Pfaffenhofen a.d.Glonn",1783,915,868,0.51318003365115,1805,933,872,0.516897506925208,0.0111070810043453,0.338686702969655,0.650206216026
9,"Bayern",9174141,"Röhrmoos",6103,2983,3120,0.488776011797477,6343,3174,3169,0.500394135267224,0.0111070810043453,0.338686702969655,0.650206216026
9,"Bayern",9174143,"Schwabhausen",6075,3044,3031,0.501069958847737,6179,3091,3088,0.500242757727788,0.0111070810043453,0.338686702969655,0.650206216026
9,"Bayern",9174146,"Sulzemoos",2572,1314,1258,0.510886469673406,2707,1387,1320,0.512375323236055,0.0111070810043453,0.338686702969655,0.650206216026
9,"Bayern",9174147,"Hilgertshausen-Tandern",3146,1587,1559,0.504450095359186,3154,1593,1561,0.505072923272035,0.0111070810043453,0.338686702969655,0.650206216026
9,"Bayern",9174150,"Vierkirchen",4257,2132,2125,0.50082217524078,4310,2152,2158,0.499303944315545,0.0111070810043453,0.338686702969655,0.650206216026
9,"Bayern",9174151,"Weichs",3139,1550,1589,0.493787830519274,3146,1587,1559,0.504450095359186,0.0111070810043453,0.338686702969655,0.650206216026
9,"Bayern",9175111,"Anzing",3694,1857,1837,0.502707092582566,3637,1851,1786,0.508935936211163,0.0111070810043453,0.338686702969655,0.650206216026
9,"Bayern",9175112,"Aßling",4252,2105,2147,0.495061147695202,4293,2096,2197,0.488236664337293,0.0111070810043453,0.338686702969655,0.650206216026
9,"Bayern",9175113,"Baiern",1407,697,710,0.495380241648898,1475,739,736,0.501016949152542,0.0111070810043453,0.338686702969655,0.650206216026
9,"Bayern",9175114,"Bruck",1145,566,579,0.494323144104803,1164,577,587,0.495704467353952,0.0111070810043453,0.338686702969655,0.650206216026
9,"Bayern",9175115,"Ebersberg, St",11081,5369,5712,0.484523057485787,11458,5565,5893,0.485686856344912,0.0111070810043453,0.338686702969655,0.650206216026
9,"Bayern",9175116,"Egmating",2183,1106,1077,0.506642235455795,2142,1083,1059,0.505602240896359,0.0111070810043453,0.338686702969655,0.650206216026
9,"Bayern",9175118,"Forstinning",3548,1760,1788,0.496054114994363,3526,1760,1766,0.499149177538287,0.0111070810043453,0.338686702969655,0.650206216026
9,"Bayern",9175119,"Frauenneuharting",1452,760,692,0.523415977961432,1483,782,701,0.527309507754552,0.0111070810043453,0.338686702969655,0.650206216026
9,"Bayern",9175121,"Glonn, M",4657,2268,2389,0.487008803951041,4455,2155,2300,0.483726150392817,0.0111070810043453,0.338686702969655,0.650206216026
9,"Bayern",9175122,"Grafing b.München, St",12844,6190,6654,0.481937091248832,12940,6269,6671,0.484466769706337,0.0111070810043453,0.338686702969655,0.650206216026
9,"Bayern",9175123,"Hohenlinden",2913,1481,1432,0.508410573292139,2883,1465,1418,0.508151231356226,0.0111070810043453,0.338686702969655,0.650206216026
9,"Bayern",9175124,"Kirchseeon, M",9760,4879,4881,0.499897540983607,9833,4949,4884,0.503305196786332,0.0111070810043453,0.338686702969655,0.650206216026
9,"Bayern",9175127,"Markt Schwaben, M",12225,5970,6255,0.488343558282209,12122,5981,6141,0.493400428972117,0.0111070810043453,0.338686702969655,0.650206216026
9,"Bayern",9175128,"Moosach",1455,717,738,0.492783505154639,1470,723,747,0.491836734693878,0.0111070810043453,0.338686702969655,0.650206216026
9,"Bayern",9175131,"Oberpframmern",2213,1158,1055,0.523271577044736,2223,1156,1067,0.520017993702204,0.0111070810043453,0.338686702969655,0.650206216026
9,"Bayern",9175132,"Vaterstetten",21286,10356,10930,0.486516959503899,22292,10970,11322,0.492104790956397,0.0111070810043453,0.338686702969655,0.650206216026
9,"Bayern",9175133,"Pliening",5151,2571,2580,0.499126383226558,5211,2627,2584,0.504125887545577,0.0111070810043453,0.338686702969655,0.650206216026
9,"Bayern",9175135,"Poing",13502,6669,6833,0.493926825655458,13905,6905,7000,0.49658396260338,0.0111070810043453,0.338686702969655,0.650206216026
9,"Bayern",9175136,"Emmering",1451,729,722,0.502412129565817,1432,727,705,0.50768156424581,0.0111070810043453,0.338686702969655,0.650206216026
9,"Bayern",9175137,"Steinhöring",3854,1924,1930,0.49922158796056,3877,1947,1930,0.502192416817127,0.0111070810043453,0.338686702969655,0.650206216026
9,"Bayern",9175139,"Zorneding",8797,4302,4495,0.48903035125611,8997,4438,4559,0.493275536289874,0.0111070810043453,0.338686702969655,0.650206216026
9,"Bayern",9176111,"Adelschlag",2788,1398,1390,0.501434720229555,2776,1386,1390,0.499279538904899,0.0111070810043453,0.338686702969655,0.650206216026
9,"Bayern",9176112,"Altmannstein, M",6773,3410,3363,0.503469658939908,6750,3390,3360,0.502222222222222,0.0111070810043453,0.338686702969655,0.650206216026
9,"Bayern",9176114,"Beilngries, St",8765,4458,4307,0.508613804905876,8783,4471,4312,0.50905157690994,0.0111070810043453,0.338686702969655,0.650206216026
9,"Bayern",9176116,"Böhmfeld",1606,811,795,0.504981320049813,1619,811,808,0.500926497838172,0.0111070810043453,0.338686702969655,0.650206216026
9,"Bayern",9176118,"Buxheim",3444,1729,1715,0.502032520325203,3526,1797,1729,0.509642654566081,0.0111070810043453,0.338686702969655,0.650206216026
9,"Bayern",9176120,"Denkendorf",4460,2270,2190,0.508968609865471,4490,2299,2191,0.512026726057906,0.0111070810043453,0.338686702969655,0.650206216026
9,"Bayern",9176121,"Dollnstein, M",2729,1421,1308,0.520703554415537,2738,1412,1326,0.515704894083272,0.0111070810043453,0.338686702969655,0.650206216026
9,"Bayern",9176122,"Egweil",1110,559,551,0.503603603603604,1118,555,563,0.496422182468694,0.0111070810043453,0.338686702969655,0.650206216026
9,"Bayern",9176123,"Eichstätt, GKSt",13189,6196,6993,0.469785427249981,13723,6562,7161,0.478175326094877,0.0111070810043453,0.338686702969655,0.650206216026
9,"Bayern",9176124,"Eitensheim",2850,1431,1419,0.502105263157895,2850,1432,1418,0.502456140350877,0.0111070810043453,0.338686702969655,0.650206216026
9,"Bayern",9176126,"Gaimersheim, M",11217,5514,5703,0.491575287510029,11483,5716,5767,0.497779325960115,0.0111070810043453,0.338686702969655,0.650206216026
9,"Bayern",9176129,"Großmehring",6379,3236,3143,0.507289543815645,6421,3255,3166,0.506930384675284,0.0111070810043453,0.338686702969655,0.650206216026
9,"Bayern",9176131,"Hepberg",2465,1245,1220,0.505070993914807,2470,1258,1212,0.509311740890688,0.0111070810043453,0.338686702969655,0.650206216026
9,"Bayern",9176132,"Hitzhofen",2808,1450,1358,0.516381766381766,2873,1495,1378,0.520361990950226,0.0111070810043453,0.338686702969655,0.650206216026
9,"Bayern",9176137,"Kinding, M",2553,1307,1246,0.511946729338034,2523,1279,1244,0.506936187078874,0.0111070810043453,0.338686702969655,0.650206216026
9,"Bayern",9176138,"Kipfenberg, M",5512,2799,2713,0.507801161103048,5678,2856,2822,0.502994011976048,0.0111070810043453,0.338686702969655,0.650206216026
9,"Bayern",9176139,"Kösching, M",8962,4453,4509,0.496875697388976,9019,4506,4513,0.499611930369221,0.0111070810043453,0.338686702969655,0.650206216026
9,"Bayern",9176143,"Lenting",4709,2366,2343,0.502442132087492,4749,2401,2348,0.505580122130975,0.0111070810043453,0.338686702969655,0.650206216026
9,"Bayern",9176147,"Mindelstetten",1619,813,806,0.502161828289067,1659,836,823,0.503918022905365,0.0111070810043453,0.338686702969655,0.650206216026
9,"Bayern",9176148,"Mörnsheim, M",1529,784,745,0.512753433616743,1574,821,753,0.521601016518424,0.0111070810043453,0.338686702969655,0.650206216026
9,"Bayern",9176149,"Nassenfels, M",1970,1007,963,0.511167512690355,1928,982,946,0.509336099585062,0.0111070810043453,0.338686702969655,0.650206216026
9,"Bayern",9176150,"Oberdolling",1196,576,620,0.481605351170569,1187,567,620,0.477674810446504,0.0111070810043453,0.338686702969655,0.650206216026
9,"Bayern",9176153,"Pförring, M",3521,1781,1740,0.505822209599546,3502,1784,1718,0.509423186750428,0.0111070810043453,0.338686702969655,0.650206216026
9,"Bayern",9176155,"Pollenfeld",2783,1412,1371,0.507366151634926,2852,1467,1385,0.51437587657784,0.0111070810043453,0.338686702969655,0.650206216026
9,"Bayern",9176160,"Schernfeld",3039,1544,1495,0.508061862454755,3051,1550,1501,0.508030154047853,0.0111070810043453,0.338686702969655,0.650206216026
9,"Bayern",9176161,"Stammham",3694,1849,1845,0.500541418516513,3741,1879,1862,0.502272119754076,0.0111070810043453,0.338686702969655,0.650206216026
9,"Bayern",9176164,"Titting, M",2662,1379,1283,0.518031555221638,2640,1387,1253,0.525378787878788,0.0111070810043453,0.338686702969655,0.650206216026
9,"Bayern",9176165,"Walting",2290,1177,1113,0.513973799126638,2357,1222,1135,0.518455663979635,0.0111070810043453,0.338686702969655,0.650206216026
9,"Bayern",9176166,"Wellheim, M",2647,1311,1336,0.495277672837174,2652,1298,1354,0.489441930618401,0.0111070810043453,0.338686702969655,0.650206216026
9,"Bayern",9176167,"Wettstetten",4692,2376,2316,0.506393861892583,4795,2447,2348,0.510323253388947,0.0111070810043453,0.338686702969655,0.650206216026
9,"Bayern",9177112,"Berglern",2562,1297,1265,0.506245120999219,2579,1322,1257,0.512601783637069,0.0111070810043453,0.338686702969655,0.650206216026
9,"Bayern",9177113,"Bockhorn",3576,1799,1777,0.503076062639821,3579,1788,1791,0.499580888516345,0.0111070810043453,0.338686702969655,0.650206216026
9,"Bayern",9177114,"Buch a.Buchrain",1436,731,705,0.509052924791086,1433,731,702,0.510118632240056,0.0111070810043453,0.338686702969655,0.650206216026
9,"Bayern",9177115,"Dorfen, St",13943,6960,6983,0.499175213368716,13851,6991,6860,0.504728900440401,0.0111070810043453,0.338686702969655,0.650206216026
9,"Bayern",9177116,"Eitting",2415,1258,1157,0.520910973084886,2468,1295,1173,0.524716369529984,0.0111070810043453,0.338686702969655,0.650206216026
9,"Bayern",9177117,"Erding, St",33825,16246,17579,0.48029563932003,34795,16752,18043,0.481448483977583,0.0111070810043453,0.338686702969655,0.650206216026
9,"Bayern",9177118,"Finsing",4183,2096,2087,0.501075782930911,4348,2211,2137,0.508509659613615,0.0111070810043453,0.338686702969655,0.650206216026
9,"Bayern",9177119,"Forstern",3213,1621,1592,0.504512916277622,3272,1669,1603,0.510085574572127,0.0111070810043453,0.338686702969655,0.650206216026
9,"Bayern",9177120,"Fraunberg",3386,1683,1703,0.497046662728884,3392,1708,1684,0.503537735849057,0.0111070810043453,0.338686702969655,0.650206216026
9,"Bayern",9177121,"Hohenpolding",1433,731,702,0.510118632240056,1471,762,709,0.518014955812373,0.0111070810043453,0.338686702969655,0.650206216026
9,"Bayern",9177122,"Inning a.Holz",1436,711,725,0.495125348189415,1443,716,727,0.496188496188496,0.0111070810043453,0.338686702969655,0.650206216026
9,"Bayern",9177123,"Isen, M",5422,2739,2683,0.50516414607156,5311,2686,2625,0.505742797966485,0.0111070810043453,0.338686702969655,0.650206216026
9,"Bayern",9177124,"Kirchberg",944,490,454,0.519067796610169,922,485,437,0.526030368763557,0.0111070810043453,0.338686702969655,0.650206216026
9,"Bayern",9177126,"Langenpreising",2627,1384,1243,0.52683669585078,2671,1426,1245,0.533882441033321,0.0111070810043453,0.338686702969655,0.650206216026
9,"Bayern",9177127,"Lengdorf",2713,1376,1337,0.507187615186141,2747,1389,1358,0.505642519111758,0.0111070810043453,0.338686702969655,0.650206216026
9,"Bayern",9177130,"Moosinning",5407,2700,2707,0.499352690956168,5595,2839,2756,0.507417336907954,0.0111070810043453,0.338686702969655,0.650206216026
9,"Bayern",9177131,"Neuching",2429,1220,1209,0.502264306298888,2485,1273,1212,0.512273641851107,0.0111070810043453,0.338686702969655,0.650206216026
9,"Bayern",9177133,"Oberding",5492,2754,2738,0.501456664238893,5566,2826,2740,0.507725476104923,0.0111070810043453,0.338686702969655,0.650206216026
9,"Bayern",9177134,"Ottenhofen",1860,954,906,0.512903225806452,1834,940,894,0.512540894220283,0.0111070810043453,0.338686702969655,0.650206216026
9,"Bayern",9177135,"Pastetten",2546,1333,1213,0.52356637863315,2505,1317,1188,0.525748502994012,0.0111070810043453,0.338686702969655,0.650206216026
9,"Bayern",9177137,"Sankt Wolfgang",4254,2166,2088,0.50916784203103,4279,2164,2115,0.505725636831035,0.0111070810043453,0.338686702969655,0.650206216026
9,"Bayern",9177138,"Steinkirchen",1180,587,593,0.497457627118644,1139,566,573,0.496927129060579,0.0111070810043453,0.338686702969655,0.650206216026
9,"Bayern",9177139,"Taufkirchen (Vils)",9163,4597,4566,0.501691585725199,9149,4617,4532,0.504645316428025,0.0111070810043453,0.338686702969655,0.650206216026
9,"Bayern",9177142,"Walpertskirchen",2028,1021,1007,0.5034516765286,2060,1040,1020,0.504854368932039,0.0111070810043453,0.338686702969655,0.650206216026
9,"Bayern",9177143,"Wartenberg, M",4865,2457,2408,0.505035971223022,4879,2470,2409,0.506251281000205,0.0111070810043453,0.338686702969655,0.650206216026
9,"Bayern",9177144,"Wörth",4338,2176,2162,0.501613646841863,4439,2235,2204,0.503491777427349,0.0111070810043453,0.338686702969655,0.650206216026
9,"Bayern",9178113,"Allershausen",5168,2641,2527,0.511029411764706,5148,2645,2503,0.513791763791764,0.0111070810043453,0.338686702969655,0.650206216026
9,"Bayern",9178115,"Attenkirchen",2549,1290,1259,0.506080816006277,2676,1378,1298,0.514947683109118,0.0111070810043453,0.338686702969655,0.650206216026
9,"Bayern",9178116,"Au i.d.Hallertau, M",5591,2840,2751,0.507959220175282,5607,2886,2721,0.514713750668807,0.0111070810043453,0.338686702969655,0.650206216026
9,"Bayern",9178120,"Eching",12932,6412,6520,0.49582431178472,13469,6827,6642,0.506867621946692,0.0111070810043453,0.338686702969655,0.650206216026
9,"Bayern",9178122,"Rudelzhausen",3227,1638,1589,0.507592190889371,3207,1622,1585,0.505768631119426,0.0111070810043453,0.338686702969655,0.650206216026
9,"Bayern",9178123,"Fahrenzhausen",4543,2310,2233,0.508474576271186,4720,2429,2291,0.514618644067797,0.0111070810043453,0.338686702969655,0.650206216026
9,"Bayern",9178124,"Freising, GKSt",44736,22098,22638,0.493964592274678,45368,22416,22952,0.494092752600952,0.0111070810043453,0.338686702969655,0.650206216026
9,"Bayern",9178125,"Gammelsdorf",1383,717,666,0.518438177874187,1580,897,683,0.567721518987342,0.0111070810043453,0.338686702969655,0.650206216026
9,"Bayern",9178129,"Haag a.d.Amper",2742,1416,1326,0.516411378555799,2842,1476,1366,0.519352568613652,0.0111070810043453,0.338686702969655,0.650206216026
9,"Bayern",9178130,"Hallbergmoos",9403,4821,4582,0.512708709986175,9554,4977,4577,0.520933640360059,0.0111070810043453,0.338686702969655,0.650206216026
9,"Bayern",9178132,"Hörgertshausen",1823,919,904,0.504114097641251,1884,949,935,0.503715498938429,0.0111070810043453,0.338686702969655,0.650206216026
9,"Bayern",9178133,"Hohenkammer",2326,1178,1148,0.506448839208942,2324,1182,1142,0.508605851979346,0.0111070810043453,0.338686702969655,0.650206216026
9,"Bayern",9178136,"Kirchdorf a.d.Amper",2793,1462,1331,0.523451485857501,2813,1466,1347,0.521151795236402,0.0111070810043453,0.338686702969655,0.650206216026
9,"Bayern",9178137,"Kranzberg",3990,2011,1979,0.504010025062657,4005,2033,1972,0.507615480649188,0.0111070810043453,0.338686702969655,0.650206216026
9,"Bayern",9178138,"Langenbach",3867,1941,1926,0.501939487975175,3912,1946,1966,0.497443762781186,0.0111070810043453,0.338686702969655,0.650206216026
9,"Bayern",9178140,"Marzling",3000,1526,1474,0.508666666666667,3168,1629,1539,0.514204545454545,0.0111070810043453,0.338686702969655,0.650206216026
9,"Bayern",9178142,"Mauern",2836,1413,1423,0.498236953455571,2811,1386,1425,0.493062966915688,0.0111070810043453,0.338686702969655,0.650206216026
9,"Bayern",9178143,"Moosburg a.d.Isar, St",16852,8305,8547,0.492819843342037,17696,8776,8920,0.495931283905967,0.0111070810043453,0.338686702969655,0.650206216026
9,"Bayern",9178144,"Nandlstadt, M",4905,2467,2438,0.502956167176351,5026,2542,2484,0.505769996020692,0.0111070810043453,0.338686702969655,0.650206216026
9,"Bayern",9178145,"Neufahrn b.Freising",18760,9566,9194,0.509914712153518,19601,10195,9406,0.520126524156931,0.0111070810043453,0.338686702969655,0.650206216026
9,"Bayern",9178150,"Paunzhausen",1520,783,737,0.515131578947368,1556,813,743,0.522493573264782,0.0111070810043453,0.338686702969655,0.650206216026
9,"Bayern",9178155,"Wang",2453,1241,1212,0.505911129229515,2478,1268,1210,0.511702986279257,0.0111070810043453,0.338686702969655,0.650206216026
9,"Bayern",9178156,"Wolfersdorf",2380,1228,1152,0.515966386554622,2448,1247,1201,0.509395424836601,0.0111070810043453,0.338686702969655,0.650206216026
9,"Bayern",9178157,"Zolling",4453,2223,2230,0.499214013024927,4287,2091,2196,0.487753673897831,0.0111070810043453,0.338686702969655,0.650206216026
9,"Bayern",9179111,"Adelshofen",1577,790,787,0.500951173113507,1584,786,798,0.496212121212121,0.0111070810043453,0.338686702969655,0.650206216026
9,"Bayern",9179113,"Alling",3542,1804,1738,0.509316770186335,3546,1822,1724,0.513818386914834,0.0111070810043453,0.338686702969655,0.650206216026
9,"Bayern",9179114,"Althegnenberg",1804,877,927,0.486141906873614,1879,934,945,0.497072911122938,0.0111070810043453,0.338686702969655,0.650206216026
9,"Bayern",9179117,"Egenhofen",3221,1612,1609,0.500465693883887,3231,1628,1603,0.503868771278242,0.0111070810043453,0.338686702969655,0.650206216026
9,"Bayern",9179118,"Eichenau",11621,5611,6010,0.482832802684795,12036,5821,6215,0.483632436025258,0.0111070810043453,0.338686702969655,0.650206216026
9,"Bayern",9179119,"Emmering",6195,3079,3116,0.497013720742534,6405,3195,3210,0.498829039812646,0.0111070810043453,0.338686702969655,0.650206216026
9,"Bayern",9179121,"Fürstenfeldbruck, GKSt",33698,16141,17557,0.478989851029735,34479,16922,17557,0.490791496273094,0.0111070810043453,0.338686702969655,0.650206216026
9,"Bayern",9179123,"Germering, GKSt",37972,18053,19919,0.475429263667966,38195,18312,19883,0.479434480953004,0.0111070810043453,0.338686702969655,0.650206216026
9,"Bayern",9179125,"Grafrath",3611,1718,1893,0.47576848518416,3602,1697,1905,0.471127151582454,0.0111070810043453,0.338686702969655,0.650206216026
9,"Bayern",9179126,"Gröbenzell",19165,9241,9924,0.482181059222541,19673,9619,10054,0.488944238296142,0.0111070810043453,0.338686702969655,0.650206216026
9,"Bayern",9179128,"Hattenhofen",1387,666,721,0.480173035328046,1403,673,730,0.479686386315039,0.0111070810043453,0.338686702969655,0.650206216026
9,"Bayern",9179130,"Jesenwang",1482,685,797,0.46221322537112,1516,719,797,0.474274406332454,0.0111070810043453,0.338686702969655,0.650206216026
9,"Bayern",9179131,"Kottgeisering",1575,771,804,0.48952380952381,1606,782,824,0.48692403486924,0.0111070810043453,0.338686702969655,0.650206216026
9,"Bayern",9179132,"Landsberied",1426,725,701,0.508415147265077,1499,769,730,0.513008672448299,0.0111070810043453,0.338686702969655,0.650206216026
9,"Bayern",9179134,"Maisach",12722,6188,6534,0.486401509196667,13012,6409,6603,0.492545342760529,0.0111070810043453,0.338686702969655,0.650206216026
9,"Bayern",9179136,"Mammendorf",4566,2292,2274,0.501971090670171,4564,2319,2245,0.508106923751096,0.0111070810043453,0.338686702969655,0.650206216026
9,"Bayern",9179137,"Mittelstetten",1636,804,832,0.491442542787286,1696,832,864,0.490566037735849,0.0111070810043453,0.338686702969655,0.650206216026
9,"Bayern",9179138,"Moorenweis",3827,1951,1876,0.50979879801411,3880,2022,1858,0.521134020618557,0.0111070810043453,0.338686702969655,0.650206216026
9,"Bayern",9179140,"Oberschweinbach",1608,774,834,0.48134328358209,1640,792,848,0.482926829268293,0.0111070810043453,0.338686702969655,0.650206216026
9,"Bayern",9179142,"Olching, St",25071,12101,12970,0.482669219416856,25522,12424,13098,0.4867957056657,0.0111070810043453,0.338686702969655,0.650206216026
9,"Bayern",9179145,"Puchheim, St",19884,9597,10287,0.482649366324683,20215,9786,10429,0.484095968340341,0.0111070810043453,0.338686702969655,0.650206216026
9,"Bayern",9179147,"Schöngeising",1837,933,904,0.50789330430049,1882,963,919,0.511689691817216,0.0111070810043453,0.338686702969655,0.650206216026
9,"Bayern",9179149,"Türkenfeld",3602,1798,1804,0.499167129372571,3668,1831,1837,0.499182115594329,0.0111070810043453,0.338686702969655,0.650206216026
9,"Bayern",9180112,"Bad Kohlgrub",2371,1158,1213,0.488401518346689,2551,1249,1302,0.489611916895335,0.0111070810043453,0.338686702969655,0.650206216026
9,"Bayern",9180113,"Bad Bayersoien",1108,555,553,0.500902527075812,1153,588,565,0.509973980919341,0.0111070810043453,0.338686702969655,0.650206216026
9,"Bayern",9180114,"Eschenlohe",1547,742,805,0.479638009049774,1591,749,842,0.470773098680075,0.0111070810043453,0.338686702969655,0.650206216026
9,"Bayern",9180115,"Ettal",755,423,332,0.560264900662252,794,464,330,0.584382871536524,0.0111070810043453,0.338686702969655,0.650206216026
9,"Bayern",9180116,"Farchant",3641,1790,1851,0.491623180444933,3729,1829,1900,0.490480021453473,0.0111070810043453,0.338686702969655,0.650206216026
9,"Bayern",9180117,"Garmisch-Partenkirchen, M",25668,11939,13729,0.465131681471092,26178,12193,13985,0.465772786309115,0.0111070810043453,0.338686702969655,0.650206216026
9,"Bayern",9180118,"Grainau",3449,1668,1781,0.483618440127573,3544,1726,1818,0.487020316027088,0.0111070810043453,0.338686702969655,0.650206216026
9,"Bayern",9180119,"Großweil",1440,704,736,0.488888888888889,1463,714,749,0.488038277511962,0.0111070810043453,0.338686702969655,0.650206216026
9,"Bayern",9180122,"Krün",1928,984,944,0.510373443983402,1950,987,963,0.506153846153846,0.0111070810043453,0.338686702969655,0.650206216026
9,"Bayern",9180123,"Mittenwald, M",7304,3606,3698,0.493702081051479,7428,3738,3690,0.503231017770598,0.0111070810043453,0.338686702969655,0.650206216026
9,"Bayern",9180124,"Murnau a.Staffelsee, M",11379,5339,6040,0.469197644784252,12395,5933,6462,0.478660750302541,0.0111070810043453,0.338686702969655,0.650206216026
9,"Bayern",9180125,"Oberammergau",5108,2430,2678,0.475724353954581,5125,2480,2645,0.48390243902439,0.0111070810043453,0.338686702969655,0.650206216026
9,"Bayern",9180126,"Oberau",3040,1471,1569,0.483881578947368,3004,1487,1517,0.495006657789614,0.0111070810043453,0.338686702969655,0.650206216026
9,"Bayern",9180127,"Ohlstadt",3150,1510,1640,0.479365079365079,3188,1513,1675,0.474592220828105,0.0111070810043453,0.338686702969655,0.650206216026
9,"Bayern",9180128,"Riegsee",1183,580,603,0.490278951817413,1163,578,585,0.496990541702494,0.0111070810043453,0.338686702969655,0.650206216026
9,"Bayern",9180129,"Saulgrub",1604,803,801,0.500623441396509,1630,819,811,0.502453987730061,0.0111070810043453,0.338686702969655,0.650206216026
9,"Bayern",9180131,"Schwaigen",602,302,300,0.501661129568106,603,305,298,0.505804311774461,0.0111070810043453,0.338686702969655,0.650206216026
9,"Bayern",9180132,"Seehausen a.Staffelsee",2389,1169,1220,0.489326077856844,2491,1245,1246,0.499799277398635,0.0111070810043453,0.338686702969655,0.650206216026
9,"Bayern",9180133,"Spatzenhausen",724,369,355,0.509668508287293,752,366,386,0.486702127659574,0.0111070810043453,0.338686702969655,0.650206216026
9,"Bayern",9180134,"Uffing a.Staffelsee",2953,1432,1521,0.48493057907213,2985,1468,1517,0.49179229480737,0.0111070810043453,0.338686702969655,0.650206216026
9,"Bayern",9180135,"Unterammergau",1501,749,752,0.499000666222518,1471,724,747,0.492182188987084,0.0111070810043453,0.338686702969655,0.650206216026
9,"Bayern",9180136,"Wallgau",1390,698,692,0.502158273381295,1400,714,686,0.51,0.0111070810043453,0.338686702969655,0.650206216026
9,"Bayern",9181111,"Apfeldorf",1072,536,536,0.5,1088,540,548,0.496323529411765,0.0111070810043453,0.338686702969655,0.650206216026
9,"Bayern",9181113,"Denklingen",2525,1262,1263,0.49980198019802,2548,1287,1261,0.505102040816326,0.0111070810043453,0.338686702969655,0.650206216026
9,"Bayern",9181114,"Dießen am Ammersee, M",10087,4716,5371,0.467532467532468,10266,4830,5436,0.470485096434833,0.0111070810043453,0.338686702969655,0.650206216026
9,"Bayern",9181115,"Eching am Ammersee",1681,837,844,0.497917906008328,1681,825,856,0.490779298036883,0.0111070810043453,0.338686702969655,0.650206216026
9,"Bayern",9181116,"Egling a.d.Paar",2199,1096,1103,0.498408367439745,2272,1119,1153,0.492517605633803,0.0111070810043453,0.338686702969655,0.650206216026
9,"Bayern",9181118,"Eresing",1742,911,831,0.522962112514351,1841,994,847,0.539923954372624,0.0111070810043453,0.338686702969655,0.650206216026
9,"Bayern",9181120,"Finning",1630,817,813,0.501226993865031,1661,829,832,0.499096929560506,0.0111070810043453,0.338686702969655,0.650206216026
9,"Bayern",9181121,"Fuchstal",3553,1776,1777,0.499859273853082,3502,1754,1748,0.500856653340948,0.0111070810043453,0.338686702969655,0.650206216026
9,"Bayern",9181122,"Geltendorf",5450,2739,2711,0.50256880733945,5586,2794,2792,0.500179018976011,0.0111070810043453,0.338686702969655,0.650206216026
9,"Bayern",9181123,"Greifenberg",2122,1056,1066,0.497643732327992,2154,1071,1083,0.497214484679666,0.0111070810043453,0.338686702969655,0.650206216026
9,"Bayern",9181124,"Hofstetten",1774,894,880,0.503945885005637,1805,918,887,0.508587257617728,0.0111070810043453,0.338686702969655,0.650206216026
9,"Bayern",9181126,"Hurlach",1645,812,833,0.493617021276596,1663,816,847,0.490679494888755,0.0111070810043453,0.338686702969655,0.650206216026
9,"Bayern",9181127,"Igling",2429,1194,1235,0.491560312885961,2370,1170,1200,0.493670886075949,0.0111070810043453,0.338686702969655,0.650206216026
9,"Bayern",9181128,"Kaufering, M",10045,4909,5136,0.488700846192135,9897,4831,5066,0.488127715469334,0.0111070810043453,0.338686702969655,0.650206216026
9,"Bayern",9181129,"Kinsau",1014,517,497,0.509861932938856,1034,537,497,0.519342359767892,0.0111070810043453,0.338686702969655,0.650206216026
9,"Bayern",9181130,"Landsberg am Lech, GKSt",27538,13637,13901,0.495206623574697,28408,14441,13967,0.508342720360462,0.0111070810043453,0.338686702969655,0.650206216026
9,"Bayern",9181131,"Obermeitingen",1489,756,733,0.507723304231028,1601,903,698,0.564022485946284,0.0111070810043453,0.338686702969655,0.650206216026
9,"Bayern",9181132,"Penzing",3581,1821,1760,0.50851717397375,3609,1871,1738,0.518426156830147,0.0111070810043453,0.338686702969655,0.650206216026
9,"Bayern",9181133,"Vilgertshofen",2500,1252,1248,0.5008,2531,1277,1254,0.504543658632951,0.0111070810043453,0.338686702969655,0.650206216026
9,"Bayern",9181134,"Prittriching",2425,1209,1216,0.498556701030928,2409,1209,1200,0.50186799501868,0.0111070810043453,0.338686702969655,0.650206216026
9,"Bayern",9181135,"Reichling",1597,805,792,0.504070131496556,1569,790,779,0.503505417463352,0.0111070810043453,0.338686702969655,0.650206216026
9,"Bayern",9181137,"Rott",1481,732,749,0.49426063470628,1499,740,759,0.493662441627752,0.0111070810043453,0.338686702969655,0.650206216026
9,"Bayern",9181138,"Scheuring",1859,930,929,0.500268961807423,1855,934,921,0.503504043126685,0.0111070810043453,0.338686702969655,0.650206216026
9,"Bayern",9181139,"Schondorf am Ammersee",3766,1838,1928,0.488050982474774,3983,1957,2026,0.491338187296008,0.0111070810043453,0.338686702969655,0.650206216026
9,"Bayern",9181140,"Schwifting",897,449,448,0.500557413600892,895,449,446,0.501675977653631,0.0111070810043453,0.338686702969655,0.650206216026
9,"Bayern",9181141,"Pürgen",3374,1715,1659,0.508298755186722,3340,1706,1634,0.510778443113772,0.0111070810043453,0.338686702969655,0.650206216026
9,"Bayern",9181142,"Thaining",918,459,459,0.5,919,453,466,0.492927094668118,0.0111070810043453,0.338686702969655,0.650206216026
9,"Bayern",9181143,"Unterdießen",1330,671,659,0.504511278195489,1358,686,672,0.505154639175258,0.0111070810043453,0.338686702969655,0.650206216026
9,"Bayern",9181144,"Utting am Ammersee",4342,2122,2220,0.488714877936435,4365,2150,2215,0.492554410080183,0.0111070810043453,0.338686702969655,0.650206216026
9,"Bayern",9181145,"Weil",3747,1905,1842,0.508406725380304,3792,1917,1875,0.505537974683544,0.0111070810043453,0.338686702969655,0.650206216026
9,"Bayern",9181146,"Windach",3727,1859,1868,0.498792594580091,3714,1839,1875,0.495153473344103,0.0111070810043453,0.338686702969655,0.650206216026
9,"Bayern",9182111,"Bad Wiessee",4607,2149,2458,0.46646407640547,4794,2183,2611,0.455360867751356,0.0111070810043453,0.338686702969655,0.650206216026
9,"Bayern",9182112,"Bayrischzell",1485,717,768,0.482828282828283,1589,762,827,0.479546884833228,0.0111070810043453,0.338686702969655,0.650206216026
9,"Bayern",9182114,"Fischbachau",5531,2750,2781,0.497197613451455,5465,2726,2739,0.498810612991766,0.0111070810043453,0.338686702969655,0.650206216026
9,"Bayern",9182116,"Gmund a.Tegernsee",5798,2764,3034,0.476716109003105,5999,2866,3133,0.477746291048508,0.0111070810043453,0.338686702969655,0.650206216026
9,"Bayern",9182119,"Hausham",8019,3880,4139,0.483850854221225,8007,3850,4157,0.480829274384913,0.0111070810043453,0.338686702969655,0.650206216026
9,"Bayern",9182120,"Holzkirchen, M",15445,7429,8016,0.48099708643574,15588,7639,7949,0.49005645368232,0.0111070810043453,0.338686702969655,0.650206216026
9,"Bayern",9182123,"Irschenberg",3050,1507,1543,0.494098360655738,3114,1547,1567,0.496788696210662,0.0111070810043453,0.338686702969655,0.650206216026
9,"Bayern",9182124,"Kreuth",3401,1595,1806,0.468979711849456,3776,1702,2074,0.450741525423729,0.0111070810043453,0.338686702969655,0.650206216026
9,"Bayern",9182125,"Miesbach, St",11012,5279,5733,0.479386124228115,11169,5370,5799,0.480795057749127,0.0111070810043453,0.338686702969655,0.650206216026
9,"Bayern",9182127,"Otterfing",4467,2247,2220,0.503022162525185,4591,2324,2267,0.506207797865389,0.0111070810043453,0.338686702969655,0.650206216026
9,"Bayern",9182129,"Rottach-Egern",5582,2452,3130,0.439269079183088,5617,2468,3149,0.439380452198683,0.0111070810043453,0.338686702969655,0.650206216026
9,"Bayern",9182131,"Schliersee, M",6616,3141,3475,0.474758162031439,6619,3183,3436,0.480888351714761,0.0111070810043453,0.338686702969655,0.650206216026
9,"Bayern",9182132,"Tegernsee, St",3576,1623,1953,0.453859060402685,3908,1681,2227,0.43014329580348,0.0111070810043453,0.338686702969655,0.650206216026
9,"Bayern",9182133,"Valley",2960,1515,1445,0.511824324324324,3009,1532,1477,0.509139248919907,0.0111070810043453,0.338686702969655,0.650206216026
9,"Bayern",9182134,"Waakirchen",5447,2685,2762,0.492931889113273,5528,2714,2814,0.49095513748191,0.0111070810043453,0.338686702969655,0.650206216026
9,"Bayern",9182136,"Warngau",3663,1833,1830,0.5004095004095,3769,1900,1869,0.50411249668347,0.0111070810043453,0.338686702969655,0.650206216026
9,"Bayern",9182137,"Weyarn",3312,1663,1649,0.502113526570048,3429,1754,1675,0.511519393409157,0.0111070810043453,0.338686702969655,0.650206216026
9,"Bayern",9183112,"Ampfing",6114,3049,3065,0.498691527641479,6077,3038,3039,0.499917722560474,0.0111070810043453,0.338686702969655,0.650206216026
9,"Bayern",9183113,"Aschau a.Inn",3010,1530,1480,0.508305647840532,2813,1387,1426,0.493067899040171,0.0111070810043453,0.338686702969655,0.650206216026
9,"Bayern",9183114,"Buchbach, M",3034,1527,1507,0.503295978905735,3121,1595,1526,0.511054149311118,0.0111070810043453,0.338686702969655,0.650206216026
9,"Bayern",9183115,"Egglkofen",1204,599,605,0.497508305647841,1206,596,610,0.494195688225539,0.0111070810043453,0.338686702969655,0.650206216026
9,"Bayern",9183116,"Erharting",904,456,448,0.504424778761062,905,464,441,0.512707182320442,0.0111070810043453,0.338686702969655,0.650206216026
9,"Bayern",9183118,"Gars a.Inn, M",3706,1859,1847,0.501618996222342,3750,1919,1831,0.511733333333333,0.0111070810043453,0.338686702969655,0.650206216026
9,"Bayern",9183119,"Haag i.OB, M",6304,3092,3212,0.490482233502538,6429,3160,3269,0.491522787369731,0.0111070810043453,0.338686702969655,0.650206216026
9,"Bayern",9183120,"Heldenstein",2452,1214,1238,0.49510603588907,2442,1209,1233,0.495085995085995,0.0111070810043453,0.338686702969655,0.650206216026
9,"Bayern",9183122,"Jettenbach",688,345,343,0.501453488372093,700,353,347,0.504285714285714,0.0111070810043453,0.338686702969655,0.650206216026
9,"Bayern",9183123,"Kirchdorf",1335,679,656,0.508614232209738,1347,692,655,0.51373422420193,0.0111070810043453,0.338686702969655,0.650206216026
9,"Bayern",9183124,"Kraiburg a.Inn, M",3919,1984,1935,0.50625159479459,3997,2049,1948,0.512634475856893,0.0111070810043453,0.338686702969655,0.650206216026
9,"Bayern",9183125,"Lohkirchen",691,355,336,0.513748191027496,704,358,346,0.508522727272727,0.0111070810043453,0.338686702969655,0.650206216026
9,"Bayern",9183126,"Maitenbeth",1909,973,936,0.509690937663698,1924,990,934,0.514553014553014,0.0111070810043453,0.338686702969655,0.650206216026
9,"Bayern",9183127,"Mettenheim",3398,1694,1704,0.498528546203649,3457,1728,1729,0.499855365924212,0.0111070810043453,0.338686702969655,0.650206216026
9,"Bayern",9183128,"Mühldorf a.Inn, St",17043,8295,8748,0.48671008625242,18235,8894,9341,0.487743350699205,0.0111070810043453,0.338686702969655,0.650206216026
9,"Bayern",9183129,"Neumarkt-Sankt Veit, St",6030,2989,3041,0.495688225538972,6008,2997,3011,0.498834886817577,0.0111070810043453,0.338686702969655,0.650206216026
9,"Bayern",9183130,"Niederbergkirchen",1214,597,617,0.491762767710049,1229,616,613,0.501220504475183,0.0111070810043453,0.338686702969655,0.650206216026
9,"Bayern",9183131,"Niedertaufkirchen",1285,705,580,0.54863813229572,1317,728,589,0.552771450265755,0.0111070810043453,0.338686702969655,0.650206216026
9,"Bayern",9183132,"Oberbergkirchen",1589,812,777,0.511013215859031,1591,811,780,0.509742300439975,0.0111070810043453,0.338686702969655,0.650206216026
9,"Bayern",9183134,"Oberneukirchen",834,443,391,0.531175059952038,822,434,388,0.527980535279805,0.0111070810043453,0.338686702969655,0.650206216026
9,"Bayern",9183135,"Obertaufkirchen",2405,1226,1179,0.50977130977131,2441,1240,1201,0.507988529291274,0.0111070810043453,0.338686702969655,0.650206216026
9,"Bayern",9183136,"Polling",3301,1635,1666,0.495304453196001,3362,1693,1669,0.503569303985723,0.0111070810043453,0.338686702969655,0.650206216026
9,"Bayern",9183138,"Rattenkirchen",957,487,470,0.508881922675026,962,481,481,0.5,0.0111070810043453,0.338686702969655,0.650206216026
9,"Bayern",9183139,"Rechtmehring",1842,934,908,0.507057546145494,1872,945,927,0.504807692307692,0.0111070810043453,0.338686702969655,0.650206216026
9,"Bayern",9183140,"Reichertsheim",1631,815,816,0.499693439607603,1658,823,835,0.496381182147165,0.0111070810043453,0.338686702969655,0.650206216026
9,"Bayern",9183143,"Schönberg",967,501,466,0.518097207859359,946,499,447,0.527484143763214,0.0111070810043453,0.338686702969655,0.650206216026
9,"Bayern",9183144,"Schwindegg",3419,1698,1721,0.496636443404504,3405,1691,1714,0.496622613803231,0.0111070810043453,0.338686702969655,0.650206216026
9,"Bayern",9183145,"Taufkirchen",1356,683,673,0.503687315634218,1359,701,658,0.515820456217807,0.0111070810043453,0.338686702969655,0.650206216026
9,"Bayern",9183147,"Unterreit",1691,867,824,0.512714370195151,1720,880,840,0.511627906976744,0.0111070810043453,0.338686702969655,0.650206216026
9,"Bayern",9183148,"Waldkraiburg, St",21488,10396,11092,0.483804914370812,23789,11760,12029,0.494346126360923,0.0111070810043453,0.338686702969655,0.650206216026
9,"Bayern",9183151,"Zangberg",1083,526,557,0.485687903970452,1092,531,561,0.486263736263736,0.0111070810043453,0.338686702969655,0.650206216026
9,"Bayern",9184112,"Aschheim",7675,3782,3893,0.492768729641694,7798,3877,3921,0.497178763785586,0.0111070810043453,0.338686702969655,0.650206216026
9,"Bayern",9184113,"Baierbrunn",2881,1428,1453,0.495661228740021,2973,1483,1490,0.498822737975109,0.0111070810043453,0.338686702969655,0.650206216026
9,"Bayern",9184114,"Brunnthal",4827,2449,2378,0.507354464470686,4879,2481,2398,0.508505841360935,0.0111070810043453,0.338686702969655,0.650206216026
9,"Bayern",9184118,"Feldkirchen",6554,3262,3292,0.497711321330485,6728,3400,3328,0.505350772889417,0.0111070810043453,0.338686702969655,0.650206216026
9,"Bayern",9184119,"Garching b.München, St",15950,8206,7744,0.51448275862069,16258,8444,7814,0.519375076885226,0.0111070810043453,0.338686702969655,0.650206216026
9,"Bayern",9184120,"Gräfelfing",12815,6073,6742,0.473897776043699,12928,6222,6706,0.481280940594059,0.0111070810043453,0.338686702969655,0.650206216026
9,"Bayern",9184121,"Grasbrunn",6372,3150,3222,0.494350282485876,6507,3244,3263,0.498540033809743,0.0111070810043453,0.338686702969655,0.650206216026
9,"Bayern",9184122,"Grünwald",10819,5031,5788,0.465015250947407,11109,5150,5959,0.46358808173553,0.0111070810043453,0.338686702969655,0.650206216026
9,"Bayern",9184123,"Haar",19377,9340,10037,0.482014759766734,19609,9394,10215,0.479065735121628,0.0111070810043453,0.338686702969655,0.650206216026
9,"Bayern",9184127,"Höhenkirchen-Siegertsbrunn",9963,4880,5083,0.489812305530463,10049,4988,5061,0.496367797790825,0.0111070810043453,0.338686702969655,0.650206216026
9,"Bayern",9184129,"Hohenbrunn",8459,4141,4318,0.489537770422036,9074,4454,4620,0.490852986554992,0.0111070810043453,0.338686702969655,0.650206216026
9,"Bayern",9184130,"Ismaning",15675,7668,8007,0.489186602870813,15711,7661,8050,0.487620138756285,0.0111070810043453,0.338686702969655,0.650206216026
9,"Bayern",9184131,"Kirchheim b.München",12454,6191,6263,0.49710936245383,12607,6335,6272,0.502498611882288,0.0111070810043453,0.338686702969655,0.650206216026
9,"Bayern",9184132,"Neuried",8324,4064,4260,0.488226814031716,8526,4180,4346,0.49026507154586,0.0111070810043453,0.338686702969655,0.650206216026
9,"Bayern",9184134,"Oberhaching",12508,6079,6429,0.486008954269268,13061,6408,6653,0.490620932547278,0.0111070810043453,0.338686702969655,0.650206216026
9,"Bayern",9184135,"Oberschleißheim",10830,5403,5427,0.498891966759003,11442,5735,5707,0.501223562314281,0.0111070810043453,0.338686702969655,0.650206216026
9,"Bayern",9184136,"Ottobrunn",20250,9670,10580,0.477530864197531,20404,9882,10522,0.484316800627328,0.0111070810043453,0.338686702969655,0.650206216026
9,"Bayern",9184137,"Aying",4680,2348,2332,0.501709401709402,4652,2335,2317,0.501934651762683,0.0111070810043453,0.338686702969655,0.650206216026
9,"Bayern",9184138,"Planegg",10304,4933,5371,0.478746118012422,10627,5148,5479,0.484426460901477,0.0111070810043453,0.338686702969655,0.650206216026
9,"Bayern",9184139,"Pullach i.Isartal",8751,4190,4561,0.478802422580277,8761,4173,4588,0.476315489099418,0.0111070810043453,0.338686702969655,0.650206216026
9,"Bayern",9184140,"Putzbrunn",6166,3031,3135,0.491566655854687,6276,3063,3213,0.488049713193117,0.0111070810043453,0.338686702969655,0.650206216026
9,"Bayern",9184141,"Sauerlach",7263,3686,3577,0.507503786314195,7293,3725,3568,0.510763746057864,0.0111070810043453,0.338686702969655,0.650206216026
9,"Bayern",9184142,"Schäftlarn",5274,2501,2773,0.4742131209708,5585,2755,2830,0.493285586392122,0.0111070810043453,0.338686702969655,0.650206216026
9,"Bayern",9184144,"Straßlach-Dingharting",2965,1424,1541,0.48026981450253,2976,1424,1552,0.478494623655914,0.0111070810043453,0.338686702969655,0.650206216026
9,"Bayern",9184145,"Taufkirchen",17573,8443,9130,0.480452967620782,18076,8716,9360,0.482186324408055,0.0111070810043453,0.338686702969655,0.650206216026
9,"Bayern",9184146,"Neubiberg",13426,7380,6046,0.549679725904961,13829,7779,6050,0.562513558464097,0.0111070810043453,0.338686702969655,0.650206216026
9,"Bayern",9184147,"Unterföhring",10264,5109,5155,0.497759158222915,10500,5204,5296,0.495619047619048,0.0111070810043453,0.338686702969655,0.650206216026
9,"Bayern",9184148,"Unterhaching",22519,10678,11841,0.474177361339313,23134,11029,12105,0.476744186046512,0.0111070810043453,0.338686702969655,0.650206216026
9,"Bayern",9184149,"Unterschleißheim, St",25937,12755,13182,0.491768516019586,26590,13280,13310,0.49943587814968,0.0111070810043453,0.338686702969655,0.650206216026
9,"Bayern",9185113,"Aresing",2718,1372,1346,0.504782928623988,2733,1366,1367,0.499817050859861,0.0111070810043453,0.338686702969655,0.650206216026
9,"Bayern",9185116,"Berg im Gau",1210,627,583,0.518181818181818,1212,626,586,0.516501650165016,0.0111070810043453,0.338686702969655,0.650206216026
9,"Bayern",9185118,"Bergheim",1854,932,922,0.50269687162891,1802,898,904,0.498335183129856,0.0111070810043453,0.338686702969655,0.650206216026
9,"Bayern",9185123,"Brunnen",1612,820,792,0.508684863523573,1581,785,796,0.49652118912081,0.0111070810043453,0.338686702969655,0.650206216026
9,"Bayern",9185125,"Burgheim, M",4481,2248,2233,0.50167373354162,4484,2239,2245,0.499330954504906,0.0111070810043453,0.338686702969655,0.650206216026
9,"Bayern",9185127,"Ehekirchen",3634,1835,1799,0.504953219592735,3670,1852,1818,0.504632152588556,0.0111070810043453,0.338686702969655,0.650206216026
9,"Bayern",9185131,"Gachenbach",2341,1177,1164,0.502776591200342,2335,1188,1147,0.508779443254818,0.0111070810043453,0.338686702969655,0.650206216026
9,"Bayern",9185139,"Karlshuld",5210,2578,2632,0.494817658349328,5237,2589,2648,0.494367004009929,0.0111070810043453,0.338686702969655,0.650206216026
9,"Bayern",9185140,"Karlskron",4726,2387,2339,0.505078290308929,4767,2406,2361,0.50471994965387,0.0111070810043453,0.338686702969655,0.650206216026
9,"Bayern",9185143,"Langenmosen",1501,760,741,0.506329113924051,1498,761,737,0.508010680907877,0.0111070810043453,0.338686702969655,0.650206216026
9,"Bayern",9185149,"Neuburg a.d.Donau, GKSt",27945,13870,14075,0.496332080873144,28548,14267,14281,0.499754798935127,0.0111070810043453,0.338686702969655,0.650206216026
9,"Bayern",9185150,"Oberhausen",2643,1309,1334,0.495270525917518,2681,1351,1330,0.503916449086162,0.0111070810043453,0.338686702969655,0.650206216026
9,"Bayern",9185153,"Rennertshofen, M",4751,2368,2383,0.498421384971585,4763,2379,2384,0.499475120722234,0.0111070810043453,0.338686702969655,0.650206216026
9,"Bayern",9185157,"Rohrenfels",1512,773,739,0.511243386243386,1539,790,749,0.513320337881741,0.0111070810043453,0.338686702969655,0.650206216026
9,"Bayern",9185158,"Schrobenhausen, St",15908,7717,8191,0.485101835554438,15995,7758,8237,0.485026570803376,0.0111070810043453,0.338686702969655,0.650206216026
9,"Bayern",9185163,"Königsmoos",4468,2269,2199,0.507833482542525,4479,2284,2195,0.509935253404778,0.0111070810043453,0.338686702969655,0.650206216026
9,"Bayern",9185166,"Waidhofen",2182,1088,1094,0.498625114573785,2177,1093,1084,0.502067064768029,0.0111070810043453,0.338686702969655,0.650206216026
9,"Bayern",9185168,"Weichering",2277,1156,1121,0.507685551163812,2397,1236,1161,0.515644555694618,0.0111070810043453,0.338686702969655,0.650206216026
9,"Bayern",9186113,"Baar-Ebenhausen",5001,2554,2447,0.510697860427914,4892,2503,2389,0.511651676206051,0.0111070810043453,0.338686702969655,0.650206216026
9,"Bayern",9186116,"Ernsgaden",1503,772,731,0.513639387890885,1538,792,746,0.514954486345904,0.0111070810043453,0.338686702969655,0.650206216026
9,"Bayern",9186122,"Geisenfeld, St",10015,5089,4926,0.508137793310035,10083,5158,4925,0.511554100962015,0.0111070810043453,0.338686702969655,0.650206216026
9,"Bayern",9186125,"Gerolsbach",3316,1679,1637,0.506332931242461,3335,1705,1630,0.511244377811094,0.0111070810043453,0.338686702969655,0.650206216026
9,"Bayern",9186126,"Hettenshausen",1969,1016,953,0.515997968511935,2001,1026,975,0.512743628185907,0.0111070810043453,0.338686702969655,0.650206216026
9,"Bayern",9186128,"Hohenwart, M",4410,2213,2197,0.501814058956916,4529,2280,2249,0.503422389048355,0.0111070810043453,0.338686702969655,0.650206216026
9,"Bayern",9186130,"Ilmmünster",2097,1041,1056,0.496423462088698,2096,1047,1049,0.499522900763359,0.0111070810043453,0.338686702969655,0.650206216026
9,"Bayern",9186132,"Jetzendorf",2947,1441,1506,0.488971835765185,3002,1479,1523,0.492671552298468,0.0111070810043453,0.338686702969655,0.650206216026
9,"Bayern",9186137,"Manching, M",11249,5562,5687,0.494443950573384,11297,5608,5689,0.496414977427636,0.0111070810043453,0.338686702969655,0.650206216026
9,"Bayern",9186139,"Münchsmünster",2810,1430,1380,0.508896797153025,2818,1428,1390,0.506742370475515,0.0111070810043453,0.338686702969655,0.650206216026
9,"Bayern",9186143,"Pfaffenhofen a.d.Ilm, St",23773,11646,12127,0.489883481260253,24308,11972,12336,0.492512753003127,0.0111070810043453,0.338686702969655,0.650206216026
9,"Bayern",9186144,"Pörnbach",2040,1038,1002,0.508823529411765,2085,1056,1029,0.506474820143885,0.0111070810043453,0.338686702969655,0.650206216026
9,"Bayern",9186146,"Reichertshausen",4906,2437,2469,0.496738687321647,4927,2458,2469,0.498883702049929,0.0111070810043453,0.338686702969655,0.650206216026
9,"Bayern",9186147,"Reichertshofen, M",7558,3788,3770,0.501190791214607,7567,3825,3742,0.505484339896921,0.0111070810043453,0.338686702969655,0.650206216026
9,"Bayern",9186149,"Rohrbach",5652,2791,2861,0.493807501769285,5676,2798,2878,0.492952783650458,0.0111070810043453,0.338686702969655,0.650206216026
9,"Bayern",9186151,"Scheyern",4674,2380,2294,0.509199828840394,4620,2350,2270,0.508658008658009,0.0111070810043453,0.338686702969655,0.650206216026
9,"Bayern",9186152,"Schweitenkirchen",4840,2521,2319,0.520867768595041,4906,2569,2337,0.523644516918059,0.0111070810043453,0.338686702969655,0.650206216026
9,"Bayern",9186158,"Vohburg a.d.Donau, St",7387,3765,3622,0.509679166102613,7444,3817,3627,0.512761955937668,0.0111070810043453,0.338686702969655,0.650206216026
9,"Bayern",9186162,"Wolnzach, M",10826,5429,5397,0.501477923517458,11031,5493,5538,0.497960293717705,0.0111070810043453,0.338686702969655,0.650206216026
9,"Bayern",9187113,"Amerang",3585,1773,1812,0.494560669456067,3594,1794,1800,0.499165275459099,0.0111070810043453,0.338686702969655,0.650206216026
9,"Bayern",9187114,"Aschau i.Chiemgau",5475,2587,2888,0.472511415525114,5725,2700,3025,0.471615720524017,0.0111070810043453,0.338686702969655,0.650206216026
9,"Bayern",9187116,"Babensham",2913,1472,1441,0.505320974939924,2927,1467,1460,0.501195763580458,0.0111070810043453,0.338686702969655,0.650206216026
9,"Bayern",9187117,"Bad Aibling, St",17099,8059,9040,0.471314111936371,18405,8821,9584,0.479271936973648,0.0111070810043453,0.338686702969655,0.650206216026
9,"Bayern",9187118,"Bernau a.Chiemsee",6537,3381,3156,0.517209729233593,7118,3905,3213,0.54860915987637,0.0111070810043453,0.338686702969655,0.650206216026
9,"Bayern",9187120,"Brannenburg",5681,2774,2907,0.488294314381271,5805,2841,2964,0.489405684754522,0.0111070810043453,0.338686702969655,0.650206216026
9,"Bayern",9187121,"Breitbrunn a.Chiemsee",1570,760,810,0.484076433121019,1479,725,754,0.490196078431373,0.0111070810043453,0.338686702969655,0.650206216026
9,"Bayern",9187122,"Bruckmühl, M",15717,7856,7861,0.499840936565502,16140,8121,8019,0.503159851301115,0.0111070810043453,0.338686702969655,0.650206216026
9,"Bayern",9187123,"Chiemsee",245,120,125,0.489795918367347,304,137,167,0.450657894736842,0.0111070810043453,0.338686702969655,0.650206216026
9,"Bayern",9187124,"Edling",4228,2139,2089,0.505912961210975,4232,2136,2096,0.504725897920605,0.0111070810043453,0.338686702969655,0.650206216026
9,"Bayern",9187125,"Eggstätt",2776,1312,1464,0.472622478386167,2896,1366,1530,0.471685082872928,0.0111070810043453,0.338686702969655,0.650206216026
9,"Bayern",9187126,"Eiselfing",2874,1433,1441,0.498608211551844,2911,1471,1440,0.505324630711096,0.0111070810043453,0.338686702969655,0.650206216026
9,"Bayern",9187128,"Bad Endorf, M",7950,3835,4115,0.482389937106918,8048,3922,4126,0.487326043737575,0.0111070810043453,0.338686702969655,0.650206216026
9,"Bayern",9187129,"Bad Feilnbach",7578,3762,3816,0.496437054631829,7597,3781,3816,0.497696459128603,0.0111070810043453,0.338686702969655,0.650206216026
9,"Bayern",9187130,"Feldkirchen-Westerham",10254,5222,5032,0.509264677199142,10340,5204,5136,0.503288201160542,0.0111070810043453,0.338686702969655,0.650206216026
9,"Bayern",9187131,"Flintsbach a.Inn",2876,1381,1495,0.480180806675939,2931,1426,1505,0.486523370863187,0.0111070810043453,0.338686702969655,0.650206216026
9,"Bayern",9187132,"Frasdorf",2926,1452,1474,0.496240601503759,3009,1513,1496,0.502824858757062,0.0111070810043453,0.338686702969655,0.650206216026
9,"Bayern",9187134,"Griesstätt",2593,1319,1274,0.508677207867335,2674,1356,1318,0.507105459985041,0.0111070810043453,0.338686702969655,0.650206216026
9,"Bayern",9187137,"Großkarolinenfeld",6982,3454,3528,0.494700658837009,7081,3514,3567,0.496257590735772,0.0111070810043453,0.338686702969655,0.650206216026
9,"Bayern",9187138,"Gstadt a.Chiemsee",1145,569,576,0.496943231441048,1369,667,702,0.487216946676406,0.0111070810043453,0.338686702969655,0.650206216026
9,"Bayern",9187139,"Halfing",2614,1290,1324,0.493496557000765,2666,1298,1368,0.486871717929482,0.0111070810043453,0.338686702969655,0.650206216026
9,"Bayern",9187142,"Schechen",4560,2297,2263,0.503728070175439,4601,2325,2276,0.505324929363182,0.0111070810043453,0.338686702969655,0.650206216026
9,"Bayern",9187145,"Höslwang",1224,620,604,0.506535947712418,1239,635,604,0.512510088781275,0.0111070810043453,0.338686702969655,0.650206216026
9,"Bayern",9187148,"Kiefersfelden",6530,3179,3351,0.486830015313936,6816,3397,3419,0.498386150234742,0.0111070810043453,0.338686702969655,0.650206216026
9,"Bayern",9187150,"Kolbermoor, St",17799,8666,9133,0.486881285465476,18119,8884,9235,0.490314034990894,0.0111070810043453,0.338686702969655,0.650206216026
9,"Bayern",9187154,"Neubeuern, M",4246,2066,2180,0.486575600565238,4256,2104,2152,0.494360902255639,0.0111070810043453,0.338686702969655,0.650206216026
9,"Bayern",9187156,"Nußdorf a.Inn",2595,1254,1341,0.483236994219653,2618,1267,1351,0.483957219251337,0.0111070810043453,0.338686702969655,0.650206216026
9,"Bayern",9187157,"Oberaudorf",4827,2331,2496,0.482908638906153,5028,2420,2608,0.481304693715195,0.0111070810043453,0.338686702969655,0.650206216026
9,"Bayern",9187159,"Pfaffing",3888,2000,1888,0.51440329218107,3950,2019,1931,0.511139240506329,0.0111070810043453,0.338686702969655,0.650206216026
9,"Bayern",9187162,"Prien a.Chiemsee, M",9931,4549,5382,0.458060618266036,10417,4845,5572,0.465105116636268,0.0111070810043453,0.338686702969655,0.650206216026
9,"Bayern",9187163,"Prutting",2543,1256,1287,0.493904836806921,2547,1253,1294,0.49195131527287,0.0111070810043453,0.338686702969655,0.650206216026
9,"Bayern",9187164,"Ramerberg",1330,671,659,0.504511278195489,1364,676,688,0.495601173020528,0.0111070810043453,0.338686702969655,0.650206216026
9,"Bayern",9187165,"Raubling",11045,5399,5646,0.488818469895881,11190,5474,5716,0.489186773905273,0.0111070810043453,0.338686702969655,0.650206216026
9,"Bayern",9187167,"Riedering",5447,2692,2755,0.494217000183587,5525,2734,2791,0.494841628959276,0.0111070810043453,0.338686702969655,0.650206216026
9,"Bayern",9187168,"Rimsting",3679,1728,1951,0.469692851318293,3749,1754,1995,0.467858095492131,0.0111070810043453,0.338686702969655,0.650206216026
9,"Bayern",9187169,"Rohrdorf",5429,2719,2710,0.500828881930374,5525,2787,2738,0.504434389140271,0.0111070810043453,0.338686702969655,0.650206216026
9,"Bayern",9187170,"Rott a.Inn",3695,1871,1824,0.506359945872801,3677,1851,1826,0.503399510470492,0.0111070810043453,0.338686702969655,0.650206216026
9,"Bayern",9187172,"Samerberg",2604,1266,1338,0.486175115207373,2669,1289,1380,0.482952416635444,0.0111070810043453,0.338686702969655,0.650206216026
9,"Bayern",9187173,"Schonstett",1281,642,639,0.501170960187354,1296,651,645,0.502314814814815,0.0111070810043453,0.338686702969655,0.650206216026
9,"Bayern",9187174,"Söchtenau",2581,1296,1285,0.502130956993413,2658,1341,1317,0.50451467268623,0.0111070810043453,0.338686702969655,0.650206216026
9,"Bayern",9187176,"Soyen",2717,1342,1375,0.493927125506073,2708,1345,1363,0.496676514032496,0.0111070810043453,0.338686702969655,0.650206216026
9,"Bayern",9187177,"Stephanskirchen",9853,4656,5197,0.472546432558612,9918,4678,5240,0.471667674934463,0.0111070810043453,0.338686702969655,0.650206216026
9,"Bayern",9187179,"Tuntenhausen",6911,3514,3397,0.508464766314571,6977,3569,3408,0.511537910276623,0.0111070810043453,0.338686702969655,0.650206216026
9,"Bayern",9187181,"Vogtareuth",3063,1553,1510,0.50701926216128,3137,1591,1546,0.507172457762193,0.0111070810043453,0.338686702969655,0.650206216026
9,"Bayern",9187182,"Wasserburg a.Inn, St",12220,6056,6164,0.495581014729951,12248,6105,6143,0.498448726322665,0.0111070810043453,0.338686702969655,0.650206216026
9,"Bayern",9187186,"Albaching",1648,835,813,0.506674757281553,1622,830,792,0.511713933415536,0.0111070810043453,0.338686702969655,0.650206216026
9,"Bayern",9188113,"Berg",7951,3889,4062,0.489120865299962,8235,4012,4223,0.487188828172435,0.0111070810043453,0.338686702969655,0.650206216026
9,"Bayern",9188117,"Andechs",3298,1658,1640,0.502728926622195,3299,1642,1657,0.497726583813277,0.0111070810043453,0.338686702969655,0.650206216026
9,"Bayern",9188118,"Feldafing",4224,2003,2221,0.474195075757576,4376,2079,2297,0.475091407678245,0.0111070810043453,0.338686702969655,0.650206216026
9,"Bayern",9188120,"Gauting",19448,9294,10154,0.477889757301522,20201,9704,10497,0.480372258799069,0.0111070810043453,0.338686702969655,0.650206216026
9,"Bayern",9188121,"Gilching",17246,8491,8755,0.492346051258263,17710,8658,9052,0.488876341050254,0.0111070810043453,0.338686702969655,0.650206216026
9,"Bayern",9188124,"Herrsching a.Ammersee",10062,4626,5436,0.459749552772809,10198,4711,5487,0.461953324181212,0.0111070810043453,0.338686702969655,0.650206216026
9,"Bayern",9188126,"Inning a.Ammersee",4293,2181,2112,0.508036338225017,4372,2173,2199,0.497026532479414,0.0111070810043453,0.338686702969655,0.650206216026
9,"Bayern",9188127,"Krailling",7467,3495,3972,0.468059461631177,7621,3590,4031,0.471066789135284,0.0111070810043453,0.338686702969655,0.650206216026
9,"Bayern",9188132,"Seefeld",7064,3419,3645,0.484003397508494,7009,3387,3622,0.483235839634755,0.0111070810043453,0.338686702969655,0.650206216026
9,"Bayern",9188137,"Pöcking",5411,2605,2806,0.481426723341342,5643,2760,2883,0.489101541733121,0.0111070810043453,0.338686702969655,0.650206216026
9,"Bayern",9188139,"Starnberg, St",22329,10355,11974,0.463746697120337,23354,11048,12306,0.473066712340498,0.0111070810043453,0.338686702969655,0.650206216026
9,"Bayern",9188141,"Tutzing",9260,4333,4927,0.46792656587473,9466,4361,5105,0.460701457849144,0.0111070810043453,0.338686702969655,0.650206216026
9,"Bayern",9188144,"Weßling",5187,2607,2580,0.502602660497397,5215,2637,2578,0.505656759348035,0.0111070810043453,0.338686702969655,0.650206216026
9,"Bayern",9188145,"Wörthsee",4871,2363,2508,0.48511599260932,4892,2382,2510,0.486917416189697,0.0111070810043453,0.338686702969655,0.650206216026
9,"Bayern",9189111,"Altenmarkt a.d.Alz",4156,2031,2125,0.488691049085659,4225,2065,2160,0.488757396449704,0.0111070810043453,0.338686702969655,0.650206216026
9,"Bayern",9189113,"Bergen",4791,2287,2504,0.477353370903778,4908,2358,2550,0.480440097799511,0.0111070810043453,0.338686702969655,0.650206216026
9,"Bayern",9189114,"Chieming",4709,2250,2459,0.477808451900616,4580,2200,2380,0.480349344978166,0.0111070810043453,0.338686702969655,0.650206216026
9,"Bayern",9189115,"Engelsberg",2597,1325,1272,0.510204081632653,2624,1352,1272,0.515243902439024,0.0111070810043453,0.338686702969655,0.650206216026
9,"Bayern",9189118,"Fridolfing",4089,2038,2051,0.498410369283443,4113,2049,2064,0.4981765134938,0.0111070810043453,0.338686702969655,0.650206216026
9,"Bayern",9189119,"Grabenstätt",4214,2016,2198,0.478405315614618,4302,2048,2254,0.476057647605765,0.0111070810043453,0.338686702969655,0.650206216026
9,"Bayern",9189120,"Grassau, M",6332,3085,3247,0.487207833228048,6405,3104,3301,0.484621389539422,0.0111070810043453,0.338686702969655,0.650206216026
9,"Bayern",9189124,"Inzell",4429,2168,2261,0.489501016030707,4462,2173,2289,0.48700134468848,0.0111070810043453,0.338686702969655,0.650206216026
9,"Bayern",9189126,"Kienberg",1345,673,672,0.500371747211896,1359,673,686,0.495217071376012,0.0111070810043453,0.338686702969655,0.650206216026
9,"Bayern",9189127,"Kirchanschöring",3092,1565,1527,0.50614489003881,3150,1597,1553,0.506984126984127,0.0111070810043453,0.338686702969655,0.650206216026
9,"Bayern",9189129,"Marquartstein",3158,1467,1691,0.464534515516149,3166,1496,1670,0.472520530638029,0.0111070810043453,0.338686702969655,0.650206216026
9,"Bayern",9189130,"Nußdorf",2434,1205,1229,0.495069843878389,2436,1221,1215,0.501231527093596,0.0111070810043453,0.338686702969655,0.650206216026
9,"Bayern",9189133,"Obing",3940,1929,2011,0.489593908629442,3937,1943,1994,0.493522987045974,0.0111070810043453,0.338686702969655,0.650206216026
9,"Bayern",9189134,"Palling",3350,1691,1659,0.504776119402985,3358,1681,1677,0.500595592614652,0.0111070810043453,0.338686702969655,0.650206216026
9,"Bayern",9189135,"Petting",2309,1194,1115,0.517106972715461,2321,1199,1122,0.516587677725118,0.0111070810043453,0.338686702969655,0.650206216026
9,"Bayern",9189137,"Pittenhart",1675,837,838,0.499701492537313,1696,847,849,0.499410377358491,0.0111070810043453,0.338686702969655,0.650206216026
9,"Bayern",9189139,"Reit im Winkl",2406,1180,1226,0.490440565253533,2359,1138,1221,0.482407799915218,0.0111070810043453,0.338686702969655,0.650206216026
9,"Bayern",9189140,"Ruhpolding",6387,3069,3318,0.48050728041334,6282,3058,3224,0.4867876472461,0.0111070810043453,0.338686702969655,0.650206216026
9,"Bayern",9189141,"Schleching",1666,802,864,0.481392557022809,1722,851,871,0.494192799070848,0.0111070810043453,0.338686702969655,0.650206216026
9,"Bayern",9189142,"Schnaitsee",3511,1764,1747,0.502420962688693,3593,1805,1788,0.502365711104926,0.0111070810043453,0.338686702969655,0.650206216026
9,"Bayern",9189143,"Seeon-Seebruck",4497,2208,2289,0.490993995997332,4627,2266,2361,0.489734169007997,0.0111070810043453,0.338686702969655,0.650206216026
9,"Bayern",9189145,"Siegsdorf",8169,3936,4233,0.481821520381932,8091,3897,4194,0.481646273637375,0.0111070810043453,0.338686702969655,0.650206216026
9,"Bayern",9189146,"Staudach-Egerndach",1121,560,561,0.499553969669938,1105,558,547,0.504977375565611,0.0111070810043453,0.338686702969655,0.650206216026
9,"Bayern",9189148,"Surberg",3179,1581,1598,0.497326203208556,3184,1597,1587,0.501570351758794,0.0111070810043453,0.338686702969655,0.650206216026
9,"Bayern",9189149,"Tacherting",5469,2703,2766,0.494240263302249,5472,2718,2754,0.496710526315789,0.0111070810043453,0.338686702969655,0.650206216026
9,"Bayern",9189150,"Taching a.See",1940,940,1000,0.484536082474227,1948,952,996,0.48870636550308,0.0111070810043453,0.338686702969655,0.650206216026
9,"Bayern",9189152,"Tittmoning, St",5850,2951,2899,0.504444444444444,5996,3073,2923,0.512508338892595,0.0111070810043453,0.338686702969655,0.650206216026
9,"Bayern",9189154,"Traunreut, St",20010,9672,10338,0.48335832083958,20720,10102,10618,0.487548262548263,0.0111070810043453,0.338686702969655,0.650206216026
9,"Bayern",9189155,"Traunstein, GKSt",18703,8783,9920,0.469603806875902,18989,8903,10086,0.468850387066196,0.0111070810043453,0.338686702969655,0.650206216026
9,"Bayern",9189157,"Trostberg, St",11209,5421,5788,0.483629226514408,11527,5599,5928,0.485729157629912,0.0111070810043453,0.338686702969655,0.650206216026
9,"Bayern",9189159,"Übersee",4865,2364,2501,0.485919835560123,4893,2370,2523,0.484365419987738,0.0111070810043453,0.338686702969655,0.650206216026
9,"Bayern",9189160,"Unterwössen",3462,1669,1793,0.48209127671866,3507,1711,1796,0.487881380096949,0.0111070810043453,0.338686702969655,0.650206216026
9,"Bayern",9189161,"Vachendorf",1852,882,970,0.476241900647948,1859,890,969,0.478752017213556,0.0111070810043453,0.338686702969655,0.650206216026
9,"Bayern",9189162,"Waging a.See, M",6442,3135,3307,0.486650108661906,6443,3159,3284,0.490299549899115,0.0111070810043453,0.338686702969655,0.650206216026
9,"Bayern",9189165,"Wonneberg",1469,728,741,0.495575221238938,1495,738,757,0.493645484949833,0.0111070810043453,0.338686702969655,0.650206216026
9,"Bayern",9190111,"Altenstadt",3195,1603,1592,0.501721439749609,3226,1682,1544,0.521388716676999,0.0111070810043453,0.338686702969655,0.650206216026
9,"Bayern",9190113,"Antdorf",1206,611,595,0.506633499170813,1228,627,601,0.510586319218241,0.0111070810043453,0.338686702969655,0.650206216026
9,"Bayern",9190114,"Bernbeuren",2341,1208,1133,0.516018795386587,2264,1156,1108,0.510600706713781,0.0111070810043453,0.338686702969655,0.650206216026
9,"Bayern",9190115,"Bernried am Starnberger See",2129,994,1135,0.466885861906999,2235,1032,1203,0.461744966442953,0.0111070810043453,0.338686702969655,0.650206216026
9,"Bayern",9190117,"Böbing",1773,919,854,0.518330513254371,1774,909,865,0.512401352874859,0.0111070810043453,0.338686702969655,0.650206216026
9,"Bayern",9190118,"Burggen",1687,854,833,0.506224066390041,1705,866,839,0.50791788856305,0.0111070810043453,0.338686702969655,0.650206216026
9,"Bayern",9190120,"Eberfing",1335,686,649,0.513857677902622,1336,695,641,0.520209580838323,0.0111070810043453,0.338686702969655,0.650206216026
9,"Bayern",9190121,"Eglfing",998,497,501,0.497995991983968,1005,496,509,0.493532338308458,0.0111070810043453,0.338686702969655,0.650206216026
9,"Bayern",9190126,"Habach",1084,537,547,0.495387453874539,1042,523,519,0.501919385796545,0.0111070810043453,0.338686702969655,0.650206216026
9,"Bayern",9190129,"Hohenfurch",1524,775,749,0.508530183727034,1514,770,744,0.508586525759577,0.0111070810043453,0.338686702969655,0.650206216026
9,"Bayern",9190130,"Hohenpeißenberg",3796,1888,1908,0.49736564805058,3794,1888,1906,0.497627833421191,0.0111070810043453,0.338686702969655,0.650206216026
9,"Bayern",9190131,"Huglfing",2583,1280,1303,0.495547812620983,2565,1293,1272,0.504093567251462,0.0111070810043453,0.338686702969655,0.650206216026
9,"Bayern",9190132,"Iffeldorf",2511,1234,1277,0.491437674233373,2540,1254,1286,0.493700787401575,0.0111070810043453,0.338686702969655,0.650206216026
9,"Bayern",9190133,"Ingenried",949,481,468,0.506849315068493,917,465,452,0.507088331515812,0.0111070810043453,0.338686702969655,0.650206216026
9,"Bayern",9190135,"Oberhausen",2045,974,1071,0.476283618581907,2102,1001,1101,0.476213130352046,0.0111070810043453,0.338686702969655,0.650206216026
9,"Bayern",9190136,"Obersöchering",1495,784,711,0.524414715719064,1553,810,743,0.521571152607856,0.0111070810043453,0.338686702969655,0.650206216026
9,"Bayern",9190138,"Pähl",2237,1092,1145,0.48815377738042,2375,1196,1179,0.503578947368421,0.0111070810043453,0.338686702969655,0.650206216026
9,"Bayern",9190139,"Peißenberg, M",12323,5988,6335,0.485920636208715,12514,6070,6444,0.48505673645517,0.0111070810043453,0.338686702969655,0.650206216026
9,"Bayern",9190140,"Peiting, M",11382,5821,5561,0.511421542786856,11624,6139,5485,0.528131452167928,0.0111070810043453,0.338686702969655,0.650206216026
9,"Bayern",9190141,"Penzberg, St",16046,7757,8289,0.483422659852923,16285,7896,8389,0.484863371200491,0.0111070810043453,0.338686702969655,0.650206216026
9,"Bayern",9190142,"Polling",3237,1589,1648,0.490886623416744,3250,1589,1661,0.488923076923077,0.0111070810043453,0.338686702969655,0.650206216026
9,"Bayern",9190143,"Prem",870,411,459,0.472413793103448,884,431,453,0.487556561085973,0.0111070810043453,0.338686702969655,0.650206216026
9,"Bayern",9190144,"Raisting",2173,1102,1071,0.50713299585826,2215,1116,1099,0.503837471783296,0.0111070810043453,0.338686702969655,0.650206216026
9,"Bayern",9190145,"Rottenbuch",1712,839,873,0.490070093457944,1770,838,932,0.473446327683616,0.0111070810043453,0.338686702969655,0.650206216026
9,"Bayern",9190148,"Schongau, St",11659,5719,5940,0.490522343254138,12150,5950,6200,0.489711934156379,0.0111070810043453,0.338686702969655,0.650206216026
9,"Bayern",9190149,"Schwabbruck",940,461,479,0.490425531914894,935,461,474,0.493048128342246,0.0111070810043453,0.338686702969655,0.650206216026
9,"Bayern",9190151,"Schwabsoien",1312,671,641,0.511432926829268,1299,664,635,0.511162432640493,0.0111070810043453,0.338686702969655,0.650206216026
9,"Bayern",9190152,"Seeshaupt",2967,1384,1583,0.466464442197506,2866,1323,1543,0.461618981158409,0.0111070810043453,0.338686702969655,0.650206216026
9,"Bayern",9190153,"Sindelsdorf",1064,525,539,0.493421052631579,1058,521,537,0.492438563327032,0.0111070810043453,0.338686702969655,0.650206216026
9,"Bayern",9190154,"Steingaden",2708,1358,1350,0.501477104874446,2760,1380,1380,0.5,0.0111070810043453,0.338686702969655,0.650206216026
9,"Bayern",9190157,"Weilheim i.OB, St",21297,10132,11165,0.475747757900174,21865,10553,11312,0.482643494168763,0.0111070810043453,0.338686702969655,0.650206216026
9,"Bayern",9190158,"Wessobrunn",2118,1076,1042,0.508026440037772,2133,1103,1030,0.517112048757618,0.0111070810043453,0.338686702969655,0.650206216026
9,"Bayern",9190159,"Wielenbach",3098,1555,1543,0.501936733376372,3180,1589,1591,0.499685534591195,0.0111070810043453,0.338686702969655,0.650206216026
9,"Bayern",9190160,"Wildsteig",1266,645,621,0.509478672985782,1278,651,627,0.509389671361502,0.0111070810043453,0.338686702969655,0.650206216026
9,"Bayern",9261000,"Landshut",64277,30718,33559,0.477900337601319,64258,30770,33488,0.478850882380404,0.0111070810043453,0.338686702969655,0.650206216026
9,"Bayern",9262000,"Passau",48623,22908,25715,0.471135059539724,50548,23975,26573,0.474301653873546,0.0111070810043453,0.338686702969655,0.650206216026
9,"Bayern",9263000,"Straubing",44642,22053,22589,0.493996684736347,44724,22270,22454,0.497942938914229,0.0111070810043453,0.338686702969655,0.650206216026
9,"Bayern",9271111,"Aholming",2263,1129,1134,0.498895271763146,2294,1142,1152,0.497820401046208,0.0111070810043453,0.338686702969655,0.650206216026
9,"Bayern",9271113,"Auerbach",2065,1036,1029,0.501694915254237,2172,1078,1094,0.496316758747698,0.0111070810043453,0.338686702969655,0.650206216026
9,"Bayern",9271114,"Außernzell",1374,684,690,0.497816593886463,1408,701,707,0.497869318181818,0.0111070810043453,0.338686702969655,0.650206216026
9,"Bayern",9271116,"Bernried",4802,2393,2409,0.498334027488546,4933,2468,2465,0.500304074599635,0.0111070810043453,0.338686702969655,0.650206216026
9,"Bayern",9271118,"Buchhofen",897,448,449,0.499442586399108,918,463,455,0.504357298474945,0.0111070810043453,0.338686702969655,0.650206216026
9,"Bayern",9271119,"Deggendorf, GKSt",31597,15305,16292,0.484381428616641,31727,15329,16398,0.483153150313613,0.0111070810043453,0.338686702969655,0.650206216026
9,"Bayern",9271122,"Grafling",2769,1374,1395,0.496208017334778,2767,1381,1386,0.499096494398265,0.0111070810043453,0.338686702969655,0.650206216026
9,"Bayern",9271123,"Grattersdorf",1275,612,663,0.48,1338,646,692,0.482810164424514,0.0111070810043453,0.338686702969655,0.650206216026
9,"Bayern",9271125,"Hengersberg, M",7075,3453,3622,0.488056537102473,7640,3794,3846,0.496596858638743,0.0111070810043453,0.338686702969655,0.650206216026
9,"Bayern",9271126,"Hunding",1160,597,563,0.514655172413793,1186,604,582,0.509274873524452,0.0111070810043453,0.338686702969655,0.650206216026
9,"Bayern",9271127,"Iggensbach",2064,1057,1007,0.512112403100775,2144,1088,1056,0.507462686567164,0.0111070810043453,0.338686702969655,0.650206216026
9,"Bayern",9271128,"Künzing",3123,1538,1585,0.492475184117835,3139,1555,1584,0.495380694488691,0.0111070810043453,0.338686702969655,0.650206216026
9,"Bayern",9271130,"Lalling",1529,768,761,0.502289077828646,1566,794,772,0.507024265644955,0.0111070810043453,0.338686702969655,0.650206216026
9,"Bayern",9271132,"Metten, M",4160,2022,2138,0.486057692307692,4373,2196,2177,0.502172421678482,0.0111070810043453,0.338686702969655,0.650206216026
9,"Bayern",9271135,"Moos",2175,1085,1090,0.498850574712644,2174,1082,1092,0.49770009199632,0.0111070810043453,0.338686702969655,0.650206216026
9,"Bayern",9271138,"Niederalteich",1795,910,885,0.506963788300836,1907,1006,901,0.527530152071316,0.0111070810043453,0.338686702969655,0.650206216026
9,"Bayern",9271139,"Oberpöring",1169,585,584,0.500427715996578,1142,558,584,0.48861646234676,0.0111070810043453,0.338686702969655,0.650206216026
9,"Bayern",9271140,"Offenberg",3248,1617,1631,0.497844827586207,3263,1618,1645,0.495862703034018,0.0111070810043453,0.338686702969655,0.650206216026
9,"Bayern",9271141,"Osterhofen, St",11436,5597,5839,0.489419377404687,11613,5635,5978,0.485232067510549,0.0111070810043453,0.338686702969655,0.650206216026
9,"Bayern",9271143,"Otzing",1928,962,966,0.49896265560166,1981,998,983,0.503785966683493,0.0111070810043453,0.338686702969655,0.650206216026
9,"Bayern",9271146,"Plattling, St",12280,6011,6269,0.489495114006515,12882,6412,6470,0.497748796770688,0.0111070810043453,0.338686702969655,0.650206216026
9,"Bayern",9271148,"Schaufling",1482,721,761,0.486504723346829,1525,751,774,0.492459016393443,0.0111070810043453,0.338686702969655,0.650206216026
9,"Bayern",9271149,"Schöllnach, M",4808,2378,2430,0.49459234608985,4958,2451,2507,0.494352561516741,0.0111070810043453,0.338686702969655,0.650206216026
9,"Bayern",9271151,"Stephansposching",3031,1525,1506,0.503134279115803,3051,1528,1523,0.500819403474271,0.0111070810043453,0.338686702969655,0.650206216026
9,"Bayern",9271152,"Wallerfing",1369,708,661,0.517165814463112,1362,703,659,0.516152716593245,0.0111070810043453,0.338686702969655,0.650206216026
9,"Bayern",9271153,"Winzer, M",3816,1871,1945,0.490303983228512,3818,1887,1931,0.494237820848612,0.0111070810043453,0.338686702969655,0.650206216026
9,"Bayern",9272116,"Eppenschlag",1000,493,507,0.493,967,485,482,0.501551189245088,0.0111070810043453,0.338686702969655,0.650206216026
9,"Bayern",9272118,"Freyung, St",6923,3325,3598,0.480283114256825,6973,3353,3620,0.480854725369282,0.0111070810043453,0.338686702969655,0.650206216026
9,"Bayern",9272119,"Fürsteneck",889,445,444,0.500562429696288,938,477,461,0.508528784648188,0.0111070810043453,0.338686702969655,0.650206216026
9,"Bayern",9272120,"Grafenau, St",8346,4151,4195,0.497364006709801,8431,4211,4220,0.499466255485707,0.0111070810043453,0.338686702969655,0.650206216026
9,"Bayern",9272121,"Grainet",2385,1163,1222,0.487631027253669,2428,1185,1243,0.488056013179572,0.0111070810043453,0.338686702969655,0.650206216026
9,"Bayern",9272122,"Haidmühle",1328,677,651,0.509789156626506,1388,703,685,0.506484149855908,0.0111070810043453,0.338686702969655,0.650206216026
9,"Bayern",9272126,"Hinterschmiding",2509,1240,1269,0.494220805101634,2539,1249,1290,0.491925955100433,0.0111070810043453,0.338686702969655,0.650206216026
9,"Bayern",9272127,"Hohenau",3364,1685,1679,0.50089179548157,3353,1686,1667,0.502833283626603,0.0111070810043453,0.338686702969655,0.650206216026
9,"Bayern",9272128,"Innernzell",1615,830,785,0.513931888544892,1603,828,775,0.516531503431067,0.0111070810043453,0.338686702969655,0.650206216026
9,"Bayern",9272129,"Jandelsbrunn",3319,1675,1644,0.504670081349804,3284,1655,1629,0.503958587088916,0.0111070810043453,0.338686702969655,0.650206216026
9,"Bayern",9272134,"Mauth",2358,1158,1200,0.491094147582697,2398,1192,1206,0.497080900750625,0.0111070810043453,0.338686702969655,0.650206216026
9,"Bayern",9272136,"Neureichenau",4321,2152,2169,0.498032862763249,4396,2182,2214,0.496360327570519,0.0111070810043453,0.338686702969655,0.650206216026
9,"Bayern",9272138,"Perlesreut, M",2790,1386,1404,0.496774193548387,2903,1432,1471,0.493282810885291,0.0111070810043453,0.338686702969655,0.650206216026
9,"Bayern",9272139,"Philippsreut",695,358,337,0.515107913669065,711,364,347,0.511954992967651,0.0111070810043453,0.338686702969655,0.650206216026
9,"Bayern",9272140,"Ringelai",1977,979,998,0.495194739504299,2046,1012,1034,0.494623655913978,0.0111070810043453,0.338686702969655,0.650206216026
9,"Bayern",9272141,"Röhrnbach, M",4439,2236,2203,0.503717053390403,4475,2246,2229,0.501899441340782,0.0111070810043453,0.338686702969655,0.650206216026
9,"Bayern",9272142,"Saldenburg",1927,951,976,0.49351323300467,1918,939,979,0.489572471324296,0.0111070810043453,0.338686702969655,0.650206216026
9,"Bayern",9272143,"Sankt Oswald-Riedlhütte",2948,1410,1538,0.478290366350068,3014,1438,1576,0.477106834771068,0.0111070810043453,0.338686702969655,0.650206216026
9,"Bayern",9272145,"Schöfweg",1267,637,630,0.502762430939227,1289,673,616,0.52211016291699,0.0111070810043453,0.338686702969655,0.650206216026
9,"Bayern",9272146,"Neuschönau",2260,1132,1128,0.500884955752212,2327,1160,1167,0.498495917490331,0.0111070810043453,0.338686702969655,0.650206216026
9,"Bayern",9272147,"Schönberg, M",3881,1902,1979,0.490079876320536,3766,1833,1933,0.48672331386086,0.0111070810043453,0.338686702969655,0.650206216026
9,"Bayern",9272149,"Spiegelau",3911,1890,2021,0.483252365124009,3954,1895,2059,0.479261507334345,0.0111070810043453,0.338686702969655,0.650206216026
9,"Bayern",9272150,"Thurmansbang",2315,1156,1159,0.499352051835853,2390,1203,1187,0.503347280334728,0.0111070810043453,0.338686702969655,0.650206216026
9,"Bayern",9272151,"Waldkirchen, St",10230,4925,5305,0.481427174975562,10507,5134,5373,0.488626629865804,0.0111070810043453,0.338686702969655,0.650206216026
9,"Bayern",9272152,"Zenting",1133,564,569,0.497793468667255,1171,589,582,0.502988898377455,0.0111070810043453,0.338686702969655,0.650206216026
9,"Bayern",9273111,"Abensberg, St",12797,6456,6341,0.504493240603266,12822,6449,6373,0.502963656215879,0.0111070810043453,0.338686702969655,0.650206216026
9,"Bayern",9273113,"Aiglsbach",1682,864,818,0.513674197384067,1695,871,824,0.513864306784661,0.0111070810043453,0.338686702969655,0.650206216026
9,"Bayern",9273115,"Attenhofen",1335,653,682,0.489138576779026,1344,664,680,0.494047619047619,0.0111070810043453,0.338686702969655,0.650206216026
9,"Bayern",9273116,"Bad Abbach, M",11488,5626,5862,0.489728412256267,11340,5561,5779,0.490388007054674,0.0111070810043453,0.338686702969655,0.650206216026
9,"Bayern",9273119,"Biburg",1186,622,564,0.524451939291737,1210,627,583,0.518181818181818,0.0111070810043453,0.338686702969655,0.650206216026
9,"Bayern",9273121,"Essing, M",978,490,488,0.501022494887526,987,503,484,0.509625126646403,0.0111070810043453,0.338686702969655,0.650206216026
9,"Bayern",9273125,"Hausen",2044,1030,1014,0.503913894324853,2040,1038,1002,0.508823529411765,0.0111070810043453,0.338686702969655,0.650206216026
9,"Bayern",9273127,"Herrngiersdorf",1188,626,562,0.526936026936027,1181,627,554,0.530906011854361,0.0111070810043453,0.338686702969655,0.650206216026
9,"Bayern",9273133,"Ihrlerstein",4122,2054,2068,0.498301795245027,4155,2061,2094,0.496028880866426,0.0111070810043453,0.338686702969655,0.650206216026
9,"Bayern",9273137,"Kelheim, St",15459,7593,7866,0.491170192121095,15581,7648,7933,0.490854245555484,0.0111070810043453,0.338686702969655,0.650206216026
9,"Bayern",9273139,"Kirchdorf",876,444,432,0.506849315068493,884,444,440,0.502262443438914,0.0111070810043453,0.338686702969655,0.650206216026
9,"Bayern",9273141,"Langquaid, M",5253,2640,2613,0.502569960022844,5248,2639,2609,0.502858231707317,0.0111070810043453,0.338686702969655,0.650206216026
9,"Bayern",9273147,"Mainburg, St",14121,7090,7031,0.502089087175129,14164,7096,7068,0.500988421349901,0.0111070810043453,0.338686702969655,0.650206216026
9,"Bayern",9273152,"Neustadt a.d.Donau, St",12751,6322,6429,0.495804250647008,12863,6471,6392,0.503070823291612,0.0111070810043453,0.338686702969655,0.650206216026
9,"Bayern",9273159,"Painten, M",2184,1108,1076,0.507326007326007,2184,1125,1059,0.51510989010989,0.0111070810043453,0.338686702969655,0.650206216026
9,"Bayern",9273163,"Elsendorf",1973,1020,953,0.516979219462747,2022,1060,962,0.524233432245302,0.0111070810043453,0.338686702969655,0.650206216026
9,"Bayern",9273164,"Riedenburg, St",5470,2741,2729,0.50109689213894,5628,2783,2845,0.494491826581379,0.0111070810043453,0.338686702969655,0.650206216026
9,"Bayern",9273165,"Rohr i.NB, M",3215,1599,1616,0.497356143079316,3267,1631,1636,0.499234771962045,0.0111070810043453,0.338686702969655,0.650206216026
9,"Bayern",9273166,"Saal a.d.Donau",5226,2550,2676,0.487944890929966,5287,2577,2710,0.487421978437677,0.0111070810043453,0.338686702969655,0.650206216026
9,"Bayern",9273172,"Siegenburg, M",3434,1711,1723,0.498252766453116,3427,1723,1704,0.502772103880945,0.0111070810043453,0.338686702969655,0.650206216026
9,"Bayern",9273175,"Teugn",1603,770,833,0.480349344978166,1597,770,827,0.482154038822793,0.0111070810043453,0.338686702969655,0.650206216026
9,"Bayern",9273177,"Train",1805,900,905,0.498614958448753,1830,930,900,0.508196721311475,0.0111070810043453,0.338686702969655,0.650206216026
9,"Bayern",9273178,"Volkenschwand",1682,830,852,0.49346016646849,1680,836,844,0.497619047619048,0.0111070810043453,0.338686702969655,0.650206216026
9,"Bayern",9273181,"Wildenberg",1319,663,656,0.502653525398029,1323,652,671,0.492819349962207,0.0111070810043453,0.338686702969655,0.650206216026
9,"Bayern",9274111,"Adlkofen",3793,1905,1888,0.502240970208278,3847,1943,1904,0.505068884845334,0.0111070810043453,0.338686702969655,0.650206216026
9,"Bayern",9274112,"Aham",1911,959,952,0.501831501831502,1899,954,945,0.502369668246445,0.0111070810043453,0.338686702969655,0.650206216026
9,"Bayern",9274113,"Altdorf, M",10997,5362,5635,0.487587523870146,11214,5456,5758,0.48653468878188,0.0111070810043453,0.338686702969655,0.650206216026
9,"Bayern",9274114,"Altfraunhofen",2114,1093,1021,0.517029328287606,2102,1078,1024,0.512844909609895,0.0111070810043453,0.338686702969655,0.650206216026
9,"Bayern",9274118,"Baierbach",777,401,376,0.516087516087516,782,396,386,0.506393861892583,0.0111070810043453,0.338686702969655,0.650206216026
9,"Bayern",9274119,"Bayerbach b.Ergoldsbach",1758,873,885,0.496587030716724,1754,866,888,0.493728620296465,0.0111070810043453,0.338686702969655,0.650206216026
9,"Bayern",9274120,"Bodenkirchen",5213,2638,2575,0.506042585843085,5300,2692,2608,0.507924528301887,0.0111070810043453,0.338686702969655,0.650206216026
9,"Bayern",9274121,"Buch a.Erlbach",3470,1712,1758,0.493371757925072,3487,1727,1760,0.495268138801262,0.0111070810043453,0.338686702969655,0.650206216026
9,"Bayern",9274124,"Eching",3717,1860,1857,0.500403551251009,3773,1898,1875,0.503047972435728,0.0111070810043453,0.338686702969655,0.650206216026
9,"Bayern",9274126,"Ergolding, M",11634,5728,5906,0.492350008595496,11905,5848,6057,0.491222175556489,0.0111070810043453,0.338686702969655,0.650206216026
9,"Bayern",9274127,"Ergoldsbach, M",7386,3647,3739,0.49377200108313,7504,3693,3811,0.492137526652452,0.0111070810043453,0.338686702969655,0.650206216026
9,"Bayern",9274128,"Essenbach, M",11162,5565,5597,0.498566565131697,11313,5770,5543,0.510032705736763,0.0111070810043453,0.338686702969655,0.650206216026
9,"Bayern",9274132,"Furth",3432,1710,1722,0.498251748251748,3379,1706,1673,0.504883101509322,0.0111070810043453,0.338686702969655,0.650206216026
9,"Bayern",9274134,"Geisenhausen, M",6492,3196,3296,0.492298213185459,6471,3178,3293,0.49111420182352,0.0111070810043453,0.338686702969655,0.650206216026
9,"Bayern",9274135,"Gerzen",1709,839,870,0.49093036863663,1675,834,841,0.497910447761194,0.0111070810043453,0.338686702969655,0.650206216026
9,"Bayern",9274141,"Hohenthann",3823,1974,1849,0.516348417473189,3853,2000,1853,0.51907604464054,0.0111070810043453,0.338686702969655,0.650206216026
9,"Bayern",9274145,"Kröning",1933,968,965,0.500775995861355,1917,966,951,0.503912363067293,0.0111070810043453,0.338686702969655,0.650206216026
9,"Bayern",9274146,"Kumhausen",5106,2546,2560,0.498629063846455,5195,2603,2592,0.501058710298364,0.0111070810043453,0.338686702969655,0.650206216026
9,"Bayern",9274153,"Neufahrn i.NB",3826,1921,1905,0.50209095661265,3786,1896,1890,0.500792393026941,0.0111070810043453,0.338686702969655,0.650206216026
9,"Bayern",9274154,"Neufraunhofen",1073,545,528,0.507921714818267,1081,550,531,0.508788159111933,0.0111070810043453,0.338686702969655,0.650206216026
9,"Bayern",9274156,"Niederaichbach",3620,1901,1719,0.525138121546961,3697,1950,1747,0.52745469299432,0.0111070810043453,0.338686702969655,0.650206216026
9,"Bayern",9274165,"Obersüßbach",1708,879,829,0.51463700234192,1733,880,853,0.507789959607617,0.0111070810043453,0.338686702969655,0.650206216026
9,"Bayern",9274172,"Pfeffenhausen, M",4716,2460,2256,0.521628498727735,4784,2522,2262,0.527173913043478,0.0111070810043453,0.338686702969655,0.650206216026
9,"Bayern",9274174,"Postau",1612,797,815,0.494416873449131,1643,821,822,0.49969567863664,0.0111070810043453,0.338686702969655,0.650206216026
9,"Bayern",9274176,"Rottenburg a.d.Laaber, St",7587,3751,3836,0.494398312903651,7587,3799,3788,0.500724924212469,0.0111070810043453,0.338686702969655,0.650206216026
9,"Bayern",9274179,"Schalkham",865,454,411,0.52485549132948,962,516,446,0.536382536382536,0.0111070810043453,0.338686702969655,0.650206216026
9,"Bayern",9274182,"Tiefenbach",3635,1826,1809,0.502338376891334,3668,1847,1821,0.503544165757906,0.0111070810043453,0.338686702969655,0.650206216026
9,"Bayern",9274183,"Velden, M",6509,3360,3149,0.51620832693194,6589,3403,3186,0.516466838670511,0.0111070810043453,0.338686702969655,0.650206216026
9,"Bayern",9274184,"Vilsbiburg, St",11108,5465,5643,0.49198775657184,11445,5644,5801,0.493141109654871,0.0111070810043453,0.338686702969655,0.650206216026
9,"Bayern",9274185,"Vilsheim",2369,1234,1135,0.520894892359645,2386,1234,1152,0.517183570829841,0.0111070810043453,0.338686702969655,0.650206216026
9,"Bayern",9274187,"Weihmichl",2454,1247,1207,0.508149959250204,2486,1252,1234,0.503620273531778,0.0111070810043453,0.338686702969655,0.650206216026
9,"Bayern",9274188,"Weng",1385,720,665,0.51985559566787,1400,727,673,0.519285714285714,0.0111070810043453,0.338686702969655,0.650206216026
9,"Bayern",9274191,"Wörth a.d.Isar",2493,1256,1237,0.503810669875652,2452,1227,1225,0.500407830342578,0.0111070810043453,0.338686702969655,0.650206216026
9,"Bayern",9274193,"Wurmsham",1297,667,630,0.514263685427911,1315,676,639,0.514068441064639,0.0111070810043453,0.338686702969655,0.650206216026
9,"Bayern",9274194,"Bruckberg",5074,2522,2552,0.49704375246354,5030,2501,2529,0.497216699801193,0.0111070810043453,0.338686702969655,0.650206216026
9,"Bayern",9275111,"Aicha vorm Wald",2398,1230,1168,0.512927439532944,2496,1294,1202,0.518429487179487,0.0111070810043453,0.338686702969655,0.650206216026
9,"Bayern",9275112,"Aidenbach, M",2902,1436,1466,0.494831150930393,3099,1543,1556,0.497902549209422,0.0111070810043453,0.338686702969655,0.650206216026
9,"Bayern",9275114,"Aldersbach",4243,2114,2129,0.498232382748056,4301,2148,2153,0.499418739827947,0.0111070810043453,0.338686702969655,0.650206216026
9,"Bayern",9275116,"Bad Füssing",6692,3187,3505,0.476240286909743,6898,3291,3607,0.477094810089881,0.0111070810043453,0.338686702969655,0.650206216026
9,"Bayern",9275117,"Beutelsbach",1151,581,570,0.504778453518679,1140,567,573,0.497368421052632,0.0111070810043453,0.338686702969655,0.650206216026
9,"Bayern",9275118,"Breitenberg",2142,1069,1073,0.49906629318394,2173,1083,1090,0.498389323515877,0.0111070810043453,0.338686702969655,0.650206216026
9,"Bayern",9275119,"Büchlberg",4087,2078,2009,0.508441399559579,4129,2107,2022,0.510293049164447,0.0111070810043453,0.338686702969655,0.650206216026
9,"Bayern",9275120,"Eging a.See, M",4085,1977,2108,0.483965728274174,4041,1969,2072,0.487255629794605,0.0111070810043453,0.338686702969655,0.650206216026
9,"Bayern",9275121,"Fürstenstein",3332,1638,1694,0.491596638655462,3375,1687,1688,0.499851851851852,0.0111070810043453,0.338686702969655,0.650206216026
9,"Bayern",9275122,"Fürstenzell, M",7676,3743,3933,0.487623762376238,7704,3748,3956,0.4865005192108,0.0111070810043453,0.338686702969655,0.650206216026
9,"Bayern",9275124,"Bad Griesbach i.Rottal, St",8290,4035,4255,0.486731001206273,8410,4084,4326,0.485612366230678,0.0111070810043453,0.338686702969655,0.650206216026
9,"Bayern",9275125,"Haarbach",2543,1246,1297,0.489972473456547,2543,1251,1292,0.491938655131734,0.0111070810043453,0.338686702969655,0.650206216026
9,"Bayern",9275126,"Hauzenberg, St",11642,5731,5911,0.492269369524137,12025,5949,6076,0.494719334719335,0.0111070810043453,0.338686702969655,0.650206216026
9,"Bayern",9275127,"Hofkirchen, M",3549,1787,1762,0.503522118906734,3597,1800,1797,0.500417014178482,0.0111070810043453,0.338686702969655,0.650206216026
9,"Bayern",9275128,"Hutthurm, M",5853,2905,2948,0.496326670083718,5900,2955,2945,0.500847457627119,0.0111070810043453,0.338686702969655,0.650206216026
9,"Bayern",9275130,"Kirchham",2089,1021,1068,0.488750598372427,2373,1247,1126,0.525495153813738,0.0111070810043453,0.338686702969655,0.650206216026
9,"Bayern",9275131,"Kößlarn, M",1924,949,975,0.493243243243243,1904,939,965,0.493172268907563,0.0111070810043453,0.338686702969655,0.650206216026
9,"Bayern",9275132,"Malching",1260,612,648,0.485714285714286,1286,622,664,0.483670295489891,0.0111070810043453,0.338686702969655,0.650206216026
9,"Bayern",9275133,"Neuburg a.Inn",4225,2050,2175,0.485207100591716,4249,2078,2171,0.489056248529066,0.0111070810043453,0.338686702969655,0.650206216026
9,"Bayern",9275134,"Neuhaus a.Inn",3421,1689,1732,0.493715287927507,3682,1843,1839,0.500543183052689,0.0111070810043453,0.338686702969655,0.650206216026
9,"Bayern",9275135,"Neukirchen vorm Wald",2661,1315,1346,0.494175122134536,2711,1356,1355,0.50018443378827,0.0111070810043453,0.338686702969655,0.650206216026
9,"Bayern",9275137,"Obernzell, M",3724,1831,1893,0.491675617615467,3850,1900,1950,0.493506493506494,0.0111070810043453,0.338686702969655,0.650206216026
9,"Bayern",9275138,"Ortenburg, M",6994,3483,3511,0.497998284243637,7051,3531,3520,0.500780031201248,0.0111070810043453,0.338686702969655,0.650206216026
9,"Bayern",9275141,"Pocking, St",14817,7118,7699,0.480394141864075,14937,7220,7717,0.483363459864765,0.0111070810043453,0.338686702969655,0.650206216026
9,"Bayern",9275143,"Rotthalmünster, M",4799,2306,2493,0.480516774327985,4969,2447,2522,0.492453209901389,0.0111070810043453,0.338686702969655,0.650206216026
9,"Bayern",9275144,"Ruderting",3068,1498,1570,0.488265971316819,3051,1491,1560,0.488692232055064,0.0111070810043453,0.338686702969655,0.650206216026
9,"Bayern",9275145,"Ruhstorf a.d.Rott, M",6952,3424,3528,0.492520138089758,7081,3503,3578,0.494704137833639,0.0111070810043453,0.338686702969655,0.650206216026
9,"Bayern",9275146,"Salzweg",6509,3203,3306,0.492087878322323,6585,3212,3373,0.487775246772969,0.0111070810043453,0.338686702969655,0.650206216026
9,"Bayern",9275148,"Sonnen",1414,716,698,0.506364922206506,1447,717,730,0.49550794747754,0.0111070810043453,0.338686702969655,0.650206216026
9,"Bayern",9275149,"Tettenweis",1701,853,848,0.501469723691946,1698,858,840,0.50530035335689,0.0111070810043453,0.338686702969655,0.650206216026
9,"Bayern",9275150,"Thyrnau",4090,1988,2102,0.486063569682152,4235,2052,2183,0.484533648170012,0.0111070810043453,0.338686702969655,0.650206216026
9,"Bayern",9275151,"Tiefenbach",6634,3267,3367,0.492463069038288,6693,3298,3395,0.492753623188406,0.0111070810043453,0.338686702969655,0.650206216026
9,"Bayern",9275152,"Tittling, M",3972,1914,2058,0.481873111782477,3639,1730,1909,0.475405331134927,0.0111070810043453,0.338686702969655,0.650206216026
9,"Bayern",9275153,"Untergriesbach, M",6100,3016,3084,0.494426229508197,6104,3024,3080,0.495412844036697,0.0111070810043453,0.338686702969655,0.650206216026
9,"Bayern",9275154,"Vilshofen an der Donau, St",15815,7676,8139,0.485361998103067,16179,7925,8254,0.489832498918351,0.0111070810043453,0.338686702969655,0.650206216026
9,"Bayern",9275156,"Wegscheid, M",5541,2772,2769,0.500270709258257,5517,2750,2767,0.498459307594707,0.0111070810043453,0.338686702969655,0.650206216026
9,"Bayern",9275159,"Windorf, M",4751,2373,2378,0.499473794990528,4809,2394,2415,0.497816593886463,0.0111070810043453,0.338686702969655,0.650206216026
9,"Bayern",9275160,"Witzmannsberg",1485,727,758,0.48956228956229,1729,851,878,0.492192018507808,0.0111070810043453,0.338686702969655,0.650206216026
9,"Bayern",9276111,"Achslach",934,498,436,0.533190578158458,971,518,453,0.533470648815654,0.0111070810043453,0.338686702969655,0.650206216026
9,"Bayern",9276113,"Arnbruck",1963,983,980,0.500764136525726,2010,995,1015,0.495024875621891,0.0111070810043453,0.338686702969655,0.650206216026
9,"Bayern",9276115,"Bayerisch Eisenstein",988,502,486,0.508097165991903,1074,543,531,0.505586592178771,0.0111070810043453,0.338686702969655,0.650206216026
9,"Bayern",9276116,"Bischofsmais",3204,1651,1553,0.515293383270911,3240,1674,1566,0.516666666666667,0.0111070810043453,0.338686702969655,0.650206216026
9,"Bayern",9276117,"Bodenmais, M",3275,1613,1662,0.492519083969466,3322,1633,1689,0.49157134256472,0.0111070810043453,0.338686702969655,0.650206216026
9,"Bayern",9276118,"Böbrach",1631,827,804,0.507050889025138,1619,828,791,0.511426806670784,0.0111070810043453,0.338686702969655,0.650206216026
9,"Bayern",9276120,"Drachselsried",2340,1151,1189,0.491880341880342,2348,1138,1210,0.484667802385009,0.0111070810043453,0.338686702969655,0.650206216026
9,"Bayern",9276121,"Frauenau",2690,1289,1401,0.479182156133829,2773,1352,1421,0.487558600793365,0.0111070810043453,0.338686702969655,0.650206216026
9,"Bayern",9276122,"Geiersthal",2168,1081,1087,0.498616236162362,2196,1089,1107,0.495901639344262,0.0111070810043453,0.338686702969655,0.650206216026
9,"Bayern",9276123,"Gotteszell",1182,563,619,0.476311336717428,1187,555,632,0.467565290648694,0.0111070810043453,0.338686702969655,0.650206216026
9,"Bayern",9276126,"Kirchberg i.Wald",4310,2181,2129,0.506032482598608,4200,2117,2083,0.504047619047619,0.0111070810043453,0.338686702969655,0.650206216026
9,"Bayern",9276127,"Kirchdorf i.Wald",2137,1063,1074,0.497426298549368,2118,1058,1060,0.499527856468366,0.0111070810043453,0.338686702969655,0.650206216026
9,"Bayern",9276128,"Kollnburg",2872,1464,1408,0.50974930362117,2863,1466,1397,0.512050296891373,0.0111070810043453,0.338686702969655,0.650206216026
9,"Bayern",9276129,"Langdorf",1882,948,934,0.503719447396387,1979,1012,967,0.511369378473977,0.0111070810043453,0.338686702969655,0.650206216026
9,"Bayern",9276130,"Lindberg",2391,1193,1198,0.498954412379757,2388,1189,1199,0.497906197654941,0.0111070810043453,0.338686702969655,0.650206216026
9,"Bayern",9276134,"Patersdorf",1742,851,891,0.488518943742824,1780,864,916,0.485393258426966,0.0111070810043453,0.338686702969655,0.650206216026
9,"Bayern",9276135,"Prackenbach",2687,1325,1362,0.493114998139189,2666,1314,1352,0.492873218304576,0.0111070810043453,0.338686702969655,0.650206216026
9,"Bayern",9276138,"Regen, St",10767,5289,5478,0.491223181944831,11664,5939,5725,0.509173525377229,0.0111070810043453,0.338686702969655,0.650206216026
9,"Bayern",9276139,"Rinchnach",3074,1533,1541,0.498698763825634,3190,1582,1608,0.495924764890282,0.0111070810043453,0.338686702969655,0.650206216026
9,"Bayern",9276142,"Ruhmannsfelden, M",2008,981,1027,0.488545816733068,2001,986,1015,0.492753623188406,0.0111070810043453,0.338686702969655,0.650206216026
9,"Bayern",9276143,"Teisnach, M",2802,1362,1440,0.486081370449679,2873,1417,1456,0.493212669683258,0.0111070810043453,0.338686702969655,0.650206216026
9,"Bayern",9276144,"Viechtach, St",8059,3946,4113,0.489638913016503,8250,4083,4167,0.494909090909091,0.0111070810043453,0.338686702969655,0.650206216026
9,"Bayern",9276146,"Zachenberg",2100,1059,1041,0.504285714285714,2099,1061,1038,0.505478799428299,0.0111070810043453,0.338686702969655,0.650206216026
9,"Bayern",9276148,"Zwiesel, St",9319,4526,4793,0.485674428586758,9642,4743,4899,0.491910392034848,0.0111070810043453,0.338686702969655,0.650206216026
9,"Bayern",9277111,"Arnstorf, M",6324,3163,3161,0.500158127767236,6717,3572,3145,0.531785023075778,0.0111070810043453,0.338686702969655,0.650206216026
9,"Bayern",9277112,"Bayerbach",1617,814,803,0.503401360544218,1638,820,818,0.500610500610501,0.0111070810043453,0.338686702969655,0.650206216026
9,"Bayern",9277113,"Bad Birnbach, M",5516,2706,2810,0.490572878897752,5527,2695,2832,0.487606296363307,0.0111070810043453,0.338686702969655,0.650206216026
9,"Bayern",9277114,"Dietersburg",3116,1553,1563,0.498395378690629,3099,1530,1569,0.493707647628267,0.0111070810043453,0.338686702969655,0.650206216026
9,"Bayern",9277116,"Eggenfelden, St",12846,6201,6645,0.482718355908454,12908,6283,6625,0.486752401611404,0.0111070810043453,0.338686702969655,0.650206216026
9,"Bayern",9277117,"Egglham",2374,1209,1165,0.509267059814659,2378,1218,1160,0.51219512195122,0.0111070810043453,0.338686702969655,0.650206216026
9,"Bayern",9277118,"Ering",1793,873,920,0.486893474623536,1864,917,947,0.491952789699571,0.0111070810043453,0.338686702969655,0.650206216026
9,"Bayern",9277119,"Falkenberg",3775,1856,1919,0.491655629139073,3823,1884,1939,0.492806696311797,0.0111070810043453,0.338686702969655,0.650206216026
9,"Bayern",9277121,"Gangkofen, M",6364,3142,3222,0.493714644877436,6427,3190,3237,0.496343550645713,0.0111070810043453,0.338686702969655,0.650206216026
9,"Bayern",9277122,"Geratskirchen",851,417,434,0.490011750881316,875,420,455,0.48,0.0111070810043453,0.338686702969655,0.650206216026
9,"Bayern",9277124,"Hebertsfelden",3626,1763,1863,0.486210700496415,3697,1802,1895,0.487422234243982,0.0111070810043453,0.338686702969655,0.650206216026
9,"Bayern",9277126,"Johanniskirchen",2392,1205,1187,0.50376254180602,2444,1239,1205,0.5069558101473,0.0111070810043453,0.338686702969655,0.650206216026
9,"Bayern",9277127,"Julbach",2308,1173,1135,0.508232235701906,2314,1173,1141,0.506914433880726,0.0111070810043453,0.338686702969655,0.650206216026
9,"Bayern",9277128,"Kirchdorf a.Inn",5236,2571,2665,0.491023682200153,5249,2594,2655,0.494189369403696,0.0111070810043453,0.338686702969655,0.650206216026
9,"Bayern",9277131,"Malgersdorf",1188,602,586,0.506734006734007,1204,616,588,0.511627906976744,0.0111070810043453,0.338686702969655,0.650206216026
9,"Bayern",9277133,"Massing, M",4002,2002,2000,0.500249875062469,4045,2015,2030,0.49814585908529,0.0111070810043453,0.338686702969655,0.650206216026
9,"Bayern",9277134,"Mitterskirchen",2036,1026,1010,0.503929273084479,2087,1061,1026,0.508385241974125,0.0111070810043453,0.338686702969655,0.650206216026
9,"Bayern",9277138,"Pfarrkirchen, St",11725,5611,6114,0.478550106609808,11724,5659,6065,0.482685090412828,0.0111070810043453,0.338686702969655,0.650206216026
9,"Bayern",9277139,"Postmünster",2291,1116,1175,0.487123526844173,2272,1098,1174,0.483274647887324,0.0111070810043453,0.338686702969655,0.650206216026
9,"Bayern",9277140,"Reut",1780,905,875,0.508426966292135,1809,921,888,0.509121061359867,0.0111070810043453,0.338686702969655,0.650206216026
9,"Bayern",9277141,"Rimbach",862,420,442,0.487238979118329,868,414,454,0.476958525345622,0.0111070810043453,0.338686702969655,0.650206216026
9,"Bayern",9277142,"Roßbach",2863,1452,1411,0.50716032134125,2853,1444,1409,0.506133894146512,0.0111070810043453,0.338686702969655,0.650206216026
9,"Bayern",9277144,"Schönau",1943,960,983,0.49408131755018,1981,991,990,0.5002523977789,0.0111070810043453,0.338686702969655,0.650206216026
9,"Bayern",9277145,"Simbach a.Inn, St",9623,4598,5025,0.477813571651252,9781,4658,5123,0.476229424394234,0.0111070810043453,0.338686702969655,0.650206216026
9,"Bayern",9277147,"Stubenberg",1370,680,690,0.496350364963504,1382,681,701,0.492764109985528,0.0111070810043453,0.338686702969655,0.650206216026
9,"Bayern",9277148,"Tann, M",3898,1943,1955,0.498460749102104,3918,1966,1952,0.501786625829505,0.0111070810043453,0.338686702969655,0.650206216026
9,"Bayern",9277149,"Triftern, M",5233,2570,2663,0.491114083699599,5195,2570,2625,0.494706448508181,0.0111070810043453,0.338686702969655,0.650206216026
9,"Bayern",9277151,"Unterdietfurt",2087,1070,1017,0.512697652132247,2090,1081,1009,0.517224880382775,0.0111070810043453,0.338686702969655,0.650206216026
9,"Bayern",9277152,"Wittibreut",2024,988,1036,0.488142292490119,2036,996,1040,0.489194499017682,0.0111070810043453,0.338686702969655,0.650206216026
9,"Bayern",9277153,"Wurmannsquick, M",3655,1815,1840,0.496580027359781,3632,1842,1790,0.50715859030837,0.0111070810043453,0.338686702969655,0.650206216026
9,"Bayern",9277154,"Zeilarn",2131,1094,1037,0.51337400281558,2174,1126,1048,0.517939282428703,0.0111070810043453,0.338686702969655,0.650206216026
9,"Bayern",9278112,"Aholfing",1730,863,867,0.498843930635838,1768,879,889,0.497171945701357,0.0111070810043453,0.338686702969655,0.650206216026
9,"Bayern",9278113,"Aiterhofen",3222,1577,1645,0.489447548106766,3404,1618,1786,0.475323149236193,0.0111070810043453,0.338686702969655,0.650206216026
9,"Bayern",9278116,"Ascha",1562,785,777,0.502560819462228,1554,793,761,0.51029601029601,0.0111070810043453,0.338686702969655,0.650206216026
9,"Bayern",9278117,"Atting",1635,821,814,0.502140672782875,1663,845,818,0.508117859290439,0.0111070810043453,0.338686702969655,0.650206216026
9,"Bayern",9278118,"Bogen, St",9632,4778,4854,0.496054817275748,10120,5061,5059,0.500098814229249,0.0111070810043453,0.338686702969655,0.650206216026
9,"Bayern",9278120,"Falkenfels",1013,512,501,0.50542941757157,1007,519,488,0.515392254220457,0.0111070810043453,0.338686702969655,0.650206216026
9,"Bayern",9278121,"Feldkirchen",1831,917,914,0.500819224467504,2024,1060,964,0.523715415019763,0.0111070810043453,0.338686702969655,0.650206216026
9,"Bayern",9278123,"Geiselhöring, St",6564,3299,3265,0.502589884216941,6649,3370,3279,0.506843134305911,0.0111070810043453,0.338686702969655,0.650206216026
9,"Bayern",9278129,"Haibach",2158,1105,1053,0.512048192771084,2155,1093,1062,0.507192575406032,0.0111070810043453,0.338686702969655,0.650206216026
9,"Bayern",9278134,"Haselbach",1726,887,839,0.513904982618772,1662,846,816,0.509025270758123,0.0111070810043453,0.338686702969655,0.650206216026
9,"Bayern",9278139,"Hunderdorf",3227,1622,1605,0.502634025410598,3280,1654,1626,0.504268292682927,0.0111070810043453,0.338686702969655,0.650206216026
9,"Bayern",9278140,"Irlbach",1137,567,570,0.49868073878628,1132,569,563,0.502650176678445,0.0111070810043453,0.338686702969655,0.650206216026
9,"Bayern",9278141,"Kirchroth",3679,1846,1833,0.501766784452297,3758,1872,1886,0.498137307078233,0.0111070810043453,0.338686702969655,0.650206216026
9,"Bayern",9278143,"Konzell",1754,872,882,0.49714937286203,1793,903,890,0.503625209146682,0.0111070810043453,0.338686702969655,0.650206216026
9,"Bayern",9278144,"Laberweinting",3371,1712,1659,0.507861168792643,3397,1718,1679,0.505740359140418,0.0111070810043453,0.338686702969655,0.650206216026
9,"Bayern",9278146,"Leiblfing",4031,2018,2013,0.500620193500372,4051,2034,2017,0.502098247346334,0.0111070810043453,0.338686702969655,0.650206216026
9,"Bayern",9278147,"Loitzendorf",616,307,309,0.498376623376623,618,318,300,0.514563106796116,0.0111070810043453,0.338686702969655,0.650206216026
9,"Bayern",9278148,"Mallersdorf-Pfaffenberg, M",6367,2911,3456,0.457201193654782,6409,2887,3522,0.450460290216882,0.0111070810043453,0.338686702969655,0.650206216026
9,"Bayern",9278149,"Mariaposching",1412,712,700,0.504249291784703,1427,725,702,0.508058864751226,0.0111070810043453,0.338686702969655,0.650206216026
9,"Bayern",9278151,"Mitterfels, M",2421,1171,1250,0.483684427922346,2433,1170,1263,0.480887792848335,0.0111070810043453,0.338686702969655,0.650206216026
9,"Bayern",9278154,"Neukirchen",1701,862,839,0.506760728982951,1834,948,886,0.51690294438386,0.0111070810043453,0.338686702969655,0.650206216026
9,"Bayern",9278159,"Niederwinkling",2535,1260,1275,0.497041420118343,2589,1284,1305,0.495944380069525,0.0111070810043453,0.338686702969655,0.650206216026
9,"Bayern",9278167,"Oberschneiding",2721,1356,1365,0.498346196251378,2747,1359,1388,0.494721514379323,0.0111070810043453,0.338686702969655,0.650206216026
9,"Bayern",9278170,"Parkstetten",3032,1493,1539,0.492414248021108,3051,1503,1548,0.492625368731563,0.0111070810043453,0.338686702969655,0.650206216026
9,"Bayern",9278171,"Perasdorf",603,300,303,0.497512437810945,670,336,334,0.501492537313433,0.0111070810043453,0.338686702969655,0.650206216026
9,"Bayern",9278172,"Perkam",1536,753,783,0.490234375,1560,776,784,0.497435897435897,0.0111070810043453,0.338686702969655,0.650206216026
9,"Bayern",9278177,"Rain",2746,1408,1338,0.512745812090313,2699,1381,1318,0.51167098925528,0.0111070810043453,0.338686702969655,0.650206216026
9,"Bayern",9278178,"Rattenberg",1783,903,880,0.506449803701627,1857,931,926,0.501346257404416,0.0111070810043453,0.338686702969655,0.650206216026
9,"Bayern",9278179,"Rattiszell",1453,765,688,0.526496902959394,1442,763,679,0.529126213592233,0.0111070810043453,0.338686702969655,0.650206216026
9,"Bayern",9278182,"Salching",2437,1207,1230,0.495281083299138,2512,1259,1253,0.501194267515924,0.0111070810043453,0.338686702969655,0.650206216026
9,"Bayern",9278184,"Sankt Englmar",1582,804,778,0.508217446270544,1559,807,752,0.517639512508018,0.0111070810043453,0.338686702969655,0.650206216026
9,"Bayern",9278187,"Schwarzach, M",2716,1319,1397,0.485640648011782,2734,1326,1408,0.485003657644477,0.0111070810043453,0.338686702969655,0.650206216026
9,"Bayern",9278189,"Stallwang",1409,723,686,0.513129879347055,1363,690,673,0.506236243580337,0.0111070810043453,0.338686702969655,0.650206216026
9,"Bayern",9278190,"Steinach",2917,1428,1489,0.48954405210833,2985,1474,1511,0.493802345058626,0.0111070810043453,0.338686702969655,0.650206216026
9,"Bayern",9278192,"Straßkirchen",3221,1583,1638,0.491462278795405,3266,1624,1642,0.49724433557869,0.0111070810043453,0.338686702969655,0.650206216026
9,"Bayern",9278197,"Wiesenfelden",3615,1850,1765,0.511756569847856,3616,1860,1756,0.514380530973451,0.0111070810043453,0.338686702969655,0.650206216026
9,"Bayern",9278198,"Windberg",1045,535,510,0.511961722488038,1050,542,508,0.516190476190476,0.0111070810043453,0.338686702969655,0.650206216026
9,"Bayern",9279112,"Dingolfing, St",17918,8937,8981,0.49877218439558,18440,9387,9053,0.509056399132321,0.0111070810043453,0.338686702969655,0.650206216026
9,"Bayern",9279113,"Eichendorf, M",6409,3209,3200,0.500702137618973,6424,3212,3212,0.5,0.0111070810043453,0.338686702969655,0.650206216026
9,"Bayern",9279115,"Frontenhausen, M",4487,2284,2203,0.509026075328727,4454,2248,2206,0.504714863044454,0.0111070810043453,0.338686702969655,0.650206216026
9,"Bayern",9279116,"Gottfrieding",2086,1073,1013,0.5143815915628,2116,1111,1005,0.525047258979206,0.0111070810043453,0.338686702969655,0.650206216026
9,"Bayern",9279122,"Landau a.d.Isar, St",12461,6100,6361,0.489527325254795,12533,6155,6378,0.491103486794862,0.0111070810043453,0.338686702969655,0.650206216026
9,"Bayern",9279124,"Loiching",3523,1850,1673,0.525120635821743,3564,1884,1680,0.528619528619529,0.0111070810043453,0.338686702969655,0.650206216026
9,"Bayern",9279125,"Mamming",2891,1478,1413,0.511241784849533,2906,1475,1431,0.507570543702684,0.0111070810043453,0.338686702969655,0.650206216026
9,"Bayern",9279126,"Marklkofen",3604,1854,1750,0.514428412874584,3742,1904,1838,0.508818813468733,0.0111070810043453,0.338686702969655,0.650206216026
9,"Bayern",9279127,"Mengkofen",5776,2947,2829,0.510214681440443,5769,2928,2841,0.507540301612065,0.0111070810043453,0.338686702969655,0.650206216026
9,"Bayern",9279128,"Moosthenning",4749,2439,2310,0.513581806696147,4835,2507,2328,0.518510858324716,0.0111070810043453,0.338686702969655,0.650206216026
9,"Bayern",9279130,"Niederviehbach",2463,1242,1221,0.504263093788063,2519,1282,1237,0.508932115919015,0.0111070810043453,0.338686702969655,0.650206216026
9,"Bayern",9279132,"Pilsting, M",6317,3106,3211,0.491689092923856,6211,3052,3159,0.491386250201256,0.0111070810043453,0.338686702969655,0.650206216026
9,"Bayern",9279134,"Reisbach, M",7557,3845,3712,0.508799788275771,7671,3912,3759,0.509972624168948,0.0111070810043453,0.338686702969655,0.650206216026
9,"Bayern",9279135,"Simbach, M",3655,1849,1806,0.505882352941176,3590,1830,1760,0.50974930362117,0.0111070810043453,0.338686702969655,0.650206216026
9,"Bayern",9279137,"Wallersdorf, M",6671,3371,3300,0.505321540998351,6704,3411,3293,0.508800715990454,0.0111070810043453,0.338686702969655,0.650206216026
9,"Bayern",9361000,"Amberg",41790,20325,21465,0.486360373295047,43529,21193,22336,0.486870821751017,0.0111070810043453,0.338686702969655,0.650206216026
9,"Bayern",9362000,"Regensburg",136352,65004,71348,0.476736681530157,136577,65760,70817,0.48148663391347,0.0111070810043453,0.338686702969655,0.650206216026
9,"Bayern",9363000,"Weiden i.d.OPf.",41734,19734,22000,0.472851871375857,41954,19927,22027,0.474972589026076,0.0111070810043453,0.338686702969655,0.650206216026
9,"Bayern",9371111,"Ammerthal",2113,1098,1015,0.519640321817321,2093,1097,996,0.524128045867176,0.0111070810043453,0.338686702969655,0.650206216026
9,"Bayern",9371113,"Auerbach i.d.OPf., St",8833,4239,4594,0.479904902071776,8801,4218,4583,0.479263720031815,0.0111070810043453,0.338686702969655,0.650206216026
9,"Bayern",9371116,"Birgland",1784,934,850,0.523542600896861,1826,951,875,0.520810514786418,0.0111070810043453,0.338686702969655,0.650206216026
9,"Bayern",9371118,"Ebermannsdorf",2411,1225,1186,0.50808793031937,2419,1232,1187,0.509301364200083,0.0111070810043453,0.338686702969655,0.650206216026
9,"Bayern",9371119,"Edelsfeld",1868,916,952,0.490364025695931,1883,930,953,0.493892724375996,0.0111070810043453,0.338686702969655,0.650206216026
9,"Bayern",9371120,"Ensdorf",2213,1123,1090,0.507455942159964,2217,1131,1086,0.510148849797023,0.0111070810043453,0.338686702969655,0.650206216026
9,"Bayern",9371121,"Freihung, M",2637,1328,1309,0.503602578687903,2548,1311,1237,0.514521193092622,0.0111070810043453,0.338686702969655,0.650206216026
9,"Bayern",9371122,"Freudenberg",4182,2115,2067,0.505738880918221,4166,2103,2063,0.5048007681229,0.0111070810043453,0.338686702969655,0.650206216026
9,"Bayern",9371123,"Gebenbach",885,444,441,0.501694915254237,899,452,447,0.502780867630701,0.0111070810043453,0.338686702969655,0.650206216026
9,"Bayern",9371126,"Hahnbach, M",4941,2506,2435,0.507184780408824,4976,2542,2434,0.510852090032154,0.0111070810043453,0.338686702969655,0.650206216026
9,"Bayern",9371127,"Hirschau, St",5892,2897,2995,0.491683638832315,5893,2887,3006,0.489903275072119,0.0111070810043453,0.338686702969655,0.650206216026
9,"Bayern",9371128,"Hirschbach",1250,640,610,0.512,1269,647,622,0.509850275807723,0.0111070810043453,0.338686702969655,0.650206216026
9,"Bayern",9371129,"Hohenburg, M",1609,814,795,0.505904288377874,1631,807,824,0.494788473329246,0.0111070810043453,0.338686702969655,0.650206216026
9,"Bayern",9371131,"Illschwang",2016,1010,1006,0.500992063492063,2087,1049,1038,0.502635361763297,0.0111070810043453,0.338686702969655,0.650206216026
9,"Bayern",9371132,"Kastl, M",2407,1243,1164,0.516410469464063,2436,1277,1159,0.524220032840722,0.0111070810043453,0.338686702969655,0.650206216026
9,"Bayern",9371135,"Königstein, M",1752,909,843,0.518835616438356,1772,940,832,0.530474040632054,0.0111070810043453,0.338686702969655,0.650206216026
9,"Bayern",9371136,"Kümmersbruck",9793,4842,4951,0.49443480036761,9888,4894,4994,0.494943365695793,0.0111070810043453,0.338686702969655,0.650206216026
9,"Bayern",9371140,"Etzelwang",1397,684,713,0.489620615604868,1442,719,723,0.498613037447989,0.0111070810043453,0.338686702969655,0.650206216026
9,"Bayern",9371141,"Neukirchen b.Sulzbach-Rosenberg",2627,1324,1303,0.50399695470118,2652,1359,1293,0.512443438914027,0.0111070810043453,0.338686702969655,0.650206216026
9,"Bayern",9371144,"Poppenricht",3352,1666,1686,0.497016706443914,3439,1735,1704,0.504507124164001,0.0111070810043453,0.338686702969655,0.650206216026
9,"Bayern",9371146,"Rieden, M",2723,1365,1358,0.501285347043702,2837,1433,1404,0.505111032781107,0.0111070810043453,0.338686702969655,0.650206216026
9,"Bayern",9371148,"Schmidmühlen, M",2361,1154,1207,0.488775942397289,2387,1190,1197,0.498533724340176,0.0111070810043453,0.338686702969655,0.650206216026
9,"Bayern",9371150,"Schnaittenbach, St",4270,2122,2148,0.496955503512881,4180,2099,2081,0.502153110047847,0.0111070810043453,0.338686702969655,0.650206216026
9,"Bayern",9371151,"Sulzbach-Rosenberg, St",19481,9448,10033,0.484985370360864,19575,9526,10049,0.486641123882503,0.0111070810043453,0.338686702969655,0.650206216026
9,"Bayern",9371154,"Ursensollen",3645,1855,1790,0.508916323731139,3717,1893,1824,0.509281678773204,0.0111070810043453,0.338686702969655,0.650206216026
9,"Bayern",9371156,"Vilseck, St",5959,2837,3122,0.476086591710018,6473,2984,3489,0.460991812142747,0.0111070810043453,0.338686702969655,0.650206216026
9,"Bayern",9371157,"Weigendorf",1196,607,589,0.50752508361204,1203,615,588,0.511221945137157,0.0111070810043453,0.338686702969655,0.650206216026
9,"Bayern",9372112,"Arnschwang",1931,954,977,0.494044536509581,2007,1003,1004,0.499750871948181,0.0111070810043453,0.338686702969655,0.650206216026
9,"Bayern",9372113,"Arrach",2516,1252,1264,0.497615262321145,2622,1334,1288,0.508771929824561,0.0111070810043453,0.338686702969655,0.650206216026
9,"Bayern",9372115,"Blaibach",1941,971,970,0.500257599175683,1980,984,996,0.496969696969697,0.0111070810043453,0.338686702969655,0.650206216026
9,"Bayern",9372116,"Cham, St",16451,8071,8380,0.490608473649018,16961,8358,8603,0.492777548493603,0.0111070810043453,0.338686702969655,0.650206216026
9,"Bayern",9372117,"Chamerau",2579,1291,1288,0.500581620783249,2590,1291,1299,0.498455598455598,0.0111070810043453,0.338686702969655,0.650206216026
9,"Bayern",9372124,"Eschlkam, M",3398,1666,1732,0.490288404944085,3412,1661,1751,0.486811254396249,0.0111070810043453,0.338686702969655,0.650206216026
9,"Bayern",9372125,"Falkenstein, M",3254,1624,1630,0.499078057775046,3224,1611,1613,0.49968982630273,0.0111070810043453,0.338686702969655,0.650206216026
9,"Bayern",9372126,"Furth im Wald, St",9000,4491,4509,0.499,8960,4454,4506,0.497098214285714,0.0111070810043453,0.338686702969655,0.650206216026
9,"Bayern",9372128,"Gleißenberg",861,421,440,0.488966318234611,886,443,443,0.5,0.0111070810043453,0.338686702969655,0.650206216026
9,"Bayern",9372130,"Grafenwiesen",1504,739,765,0.491356382978723,1579,788,791,0.499050031665611,0.0111070810043453,0.338686702969655,0.650206216026
9,"Bayern",9372135,"Hohenwarth",1947,956,991,0.491011813045711,1992,968,1024,0.485943775100402,0.0111070810043453,0.338686702969655,0.650206216026
9,"Bayern",9372137,"Bad Kötzting, St",7084,3430,3654,0.484189723320158,7243,3595,3648,0.49634129504349,0.0111070810043453,0.338686702969655,0.650206216026
9,"Bayern",9372138,"Lam, M",2681,1305,1376,0.486758672137262,2764,1362,1402,0.492764109985528,0.0111070810043453,0.338686702969655,0.650206216026
9,"Bayern",9372142,"Michelsneukirchen",1771,891,880,0.503105590062112,1763,874,889,0.495745887691435,0.0111070810043453,0.338686702969655,0.650206216026
9,"Bayern",9372143,"Miltach",2245,1120,1125,0.498886414253898,2281,1144,1137,0.501534414730381,0.0111070810043453,0.338686702969655,0.650206216026
9,"Bayern",9372144,"Neukirchen b.Hl.Blut, M",3784,1874,1910,0.495243128964059,3832,1897,1935,0.495041753653445,0.0111070810043453,0.338686702969655,0.650206216026
9,"Bayern",9372146,"Pemfling",2225,1143,1082,0.513707865168539,2239,1123,1116,0.501563197856186,0.0111070810043453,0.338686702969655,0.650206216026
9,"Bayern",9372147,"Pösing",966,502,464,0.519668737060041,973,513,460,0.527235354573484,0.0111070810043453,0.338686702969655,0.650206216026
9,"Bayern",9372149,"Reichenbach",1199,757,442,0.631359466221852,1240,786,454,0.633870967741936,0.0111070810043453,0.338686702969655,0.650206216026
9,"Bayern",9372150,"Rettenbach",1755,881,874,0.501994301994302,1777,904,873,0.508722566122679,0.0111070810043453,0.338686702969655,0.650206216026
9,"Bayern",9372151,"Rimbach",1923,958,965,0.498179927197088,1966,980,986,0.498474059003052,0.0111070810043453,0.338686702969655,0.650206216026
9,"Bayern",9372153,"Roding, St",11301,5525,5776,0.488894788071852,11669,5750,5919,0.492758591138915,0.0111070810043453,0.338686702969655,0.650206216026
9,"Bayern",9372154,"Rötz, St",3389,1725,1664,0.508999704927707,3492,1771,1721,0.507159221076747,0.0111070810043453,0.338686702969655,0.650206216026
9,"Bayern",9372155,"Runding",2289,1120,1169,0.489296636085627,2282,1116,1166,0.489044697633655,0.0111070810043453,0.338686702969655,0.650206216026
9,"Bayern",9372157,"Schönthal",1967,974,993,0.495170310116929,2024,993,1031,0.490612648221344,0.0111070810043453,0.338686702969655,0.650206216026
9,"Bayern",9372158,"Schorndorf",2610,1311,1299,0.502298850574713,2614,1304,1310,0.49885233358837,0.0111070810043453,0.338686702969655,0.650206216026
9,"Bayern",9372161,"Stamsried, M",2161,1119,1042,0.517815826006478,2153,1105,1048,0.513237343241988,0.0111070810043453,0.338686702969655,0.650206216026
9,"Bayern",9372163,"Tiefenbach",2023,1007,1016,0.497775580820564,2068,1041,1027,0.503384912959381,0.0111070810043453,0.338686702969655,0.650206216026
9,"Bayern",9372164,"Traitsching",4027,2019,2008,0.501365780978396,4088,2056,2032,0.50293542074364,0.0111070810043453,0.338686702969655,0.650206216026
9,"Bayern",9372165,"Treffelstein",988,516,472,0.522267206477733,1005,528,477,0.525373134328358,0.0111070810043453,0.338686702969655,0.650206216026
9,"Bayern",9372167,"Zell",1869,973,896,0.52059925093633,1858,961,897,0.517222820236814,0.0111070810043453,0.338686702969655,0.650206216026
9,"Bayern",9372168,"Waffenbrunn",2043,1027,1016,0.502692119432207,2049,1019,1030,0.497315763787213,0.0111070810043453,0.338686702969655,0.650206216026
9,"Bayern",9372169,"Wald",2774,1375,1399,0.495674116798846,2804,1399,1405,0.498930099857347,0.0111070810043453,0.338686702969655,0.650206216026
9,"Bayern",9372170,"Walderbach",2048,1045,1003,0.51025390625,2093,1055,1038,0.504061156235069,0.0111070810043453,0.338686702969655,0.650206216026
9,"Bayern",9372171,"Waldmünchen, St",6709,3256,3453,0.485318229244299,6958,3413,3545,0.490514515665421,0.0111070810043453,0.338686702969655,0.650206216026
9,"Bayern",9372174,"Weiding",2475,1232,1243,0.497777777777778,2565,1282,1283,0.499805068226121,0.0111070810043453,0.338686702969655,0.650206216026
9,"Bayern",9372175,"Willmering",2049,1026,1023,0.500732064421669,2088,1038,1050,0.497126436781609,0.0111070810043453,0.338686702969655,0.650206216026
9,"Bayern",9372177,"Zandt",1831,870,961,0.475150191152376,1899,926,973,0.487625065824118,0.0111070810043453,0.338686702969655,0.650206216026
9,"Bayern",9372178,"Lohberg",1936,968,968,0.5,1993,984,1009,0.49372804816859,0.0111070810043453,0.338686702969655,0.650206216026
9,"Bayern",9373112,"Berching, St",8478,4226,4252,0.498466619485728,8525,4284,4241,0.502521994134897,0.0111070810043453,0.338686702969655,0.650206216026
9,"Bayern",9373113,"Berg b.Neumarkt i.d.OPf.",7432,3749,3683,0.504440258342304,7511,3822,3689,0.508853681267474,0.0111070810043453,0.338686702969655,0.650206216026
9,"Bayern",9373114,"Berngau",2481,1237,1244,0.498589278516727,2515,1256,1259,0.499403578528827,0.0111070810043453,0.338686702969655,0.650206216026
9,"Bayern",9373115,"Breitenbrunn, M",3371,1712,1659,0.507861168792643,3397,1706,1691,0.502207830438622,0.0111070810043453,0.338686702969655,0.650206216026
9,"Bayern",9373119,"Deining",4309,2136,2173,0.495706660478069,4296,2131,2165,0.496042830540037,0.0111070810043453,0.338686702969655,0.650206216026
9,"Bayern",9373121,"Dietfurt a.d.Altmühl, St",5909,3018,2891,0.510746319174141,6022,3093,2929,0.513616738625042,0.0111070810043453,0.338686702969655,0.650206216026
9,"Bayern",9373126,"Freystadt, St",8577,4398,4179,0.512766701643931,8531,4370,4161,0.512249443207127,0.0111070810043453,0.338686702969655,0.650206216026
9,"Bayern",9373134,"Hohenfels, M",2073,1047,1026,0.50506512301013,2050,1036,1014,0.505365853658537,0.0111070810043453,0.338686702969655,0.650206216026
9,"Bayern",9373140,"Lauterhofen, M",3616,1812,1804,0.501106194690266,3614,1812,1802,0.501383508577753,0.0111070810043453,0.338686702969655,0.650206216026
9,"Bayern",9373143,"Lupburg, M",2302,1165,1137,0.506081668114683,2334,1210,1124,0.518423307626392,0.0111070810043453,0.338686702969655,0.650206216026
9,"Bayern",9373146,"Mühlhausen",4627,2362,2265,0.51048195374973,4563,2357,2206,0.516546131930747,0.0111070810043453,0.338686702969655,0.650206216026
9,"Bayern",9373147,"Neumarkt i.d.OPf., GKSt",38356,18458,19898,0.481228490979247,39084,18768,20316,0.480196499846484,0.0111070810043453,0.338686702969655,0.650206216026
9,"Bayern",9373151,"Parsberg, St",6569,3289,3280,0.50068503577409,6731,3409,3322,0.506462635566781,0.0111070810043453,0.338686702969655,0.650206216026
9,"Bayern",9373153,"Pilsach",2697,1400,1297,0.519095291064145,2720,1413,1307,0.519485294117647,0.0111070810043453,0.338686702969655,0.650206216026
9,"Bayern",9373155,"Postbauer-Heng, M",7341,3651,3690,0.497343686146302,7361,3666,3695,0.498030158945795,0.0111070810043453,0.338686702969655,0.650206216026
9,"Bayern",9373156,"Pyrbaum, M",5542,2747,2795,0.495669433417539,5639,2826,2813,0.501152686646569,0.0111070810043453,0.338686702969655,0.650206216026
9,"Bayern",9373159,"Sengenthal",2820,1571,1249,0.55709219858156,2889,1635,1254,0.565939771547248,0.0111070810043453,0.338686702969655,0.650206216026
9,"Bayern",9373160,"Seubersdorf i.d.OPf.",5011,2504,2507,0.499700658551187,4998,2475,2523,0.495198079231693,0.0111070810043453,0.338686702969655,0.650206216026
9,"Bayern",9373167,"Velburg, St",5235,2648,2587,0.505826170009551,5144,2607,2537,0.506804043545879,0.0111070810043453,0.338686702969655,0.650206216026
9,"Bayern",9374111,"Altenstadt a.d.Waldnaab",4787,2331,2456,0.486943806141634,4814,2352,2462,0.488574989613627,0.0111070810043453,0.338686702969655,0.650206216026
9,"Bayern",9374117,"Eschenbach i.d.OPf., St",3994,1903,2091,0.476464697045568,4121,1972,2149,0.478524629944188,0.0111070810043453,0.338686702969655,0.650206216026
9,"Bayern",9374118,"Eslarn, M",2763,1391,1372,0.503438291711907,2800,1409,1391,0.503214285714286,0.0111070810043453,0.338686702969655,0.650206216026
9,"Bayern",9374119,"Etzenricht",1590,768,822,0.483018867924528,1583,764,819,0.48262792166772,0.0111070810043453,0.338686702969655,0.650206216026
9,"Bayern",9374121,"Floß, M",3488,1728,1760,0.495412844036697,3458,1701,1757,0.491902834008097,0.0111070810043453,0.338686702969655,0.650206216026
9,"Bayern",9374122,"Flossenbürg",1645,811,834,0.493009118541033,1651,807,844,0.488794669897032,0.0111070810043453,0.338686702969655,0.650206216026
9,"Bayern",9374123,"Georgenberg",1371,707,664,0.515681983953319,1405,726,679,0.516725978647687,0.0111070810043453,0.338686702969655,0.650206216026
9,"Bayern",9374124,"Grafenwöhr, St",6495,3161,3334,0.486682063125481,6718,3333,3385,0.496129800535874,0.0111070810043453,0.338686702969655,0.650206216026
9,"Bayern",9374127,"Irchenrieth",1177,571,606,0.485131690739167,1172,571,601,0.487201365187713,0.0111070810043453,0.338686702969655,0.650206216026
9,"Bayern",9374128,"Kirchendemenreuth",870,446,424,0.512643678160919,879,453,426,0.515358361774744,0.0111070810043453,0.338686702969655,0.650206216026
9,"Bayern",9374129,"Kirchenthumbach, M",3301,1691,1610,0.512269009391094,3261,1663,1598,0.509966268015946,0.0111070810043453,0.338686702969655,0.650206216026
9,"Bayern",9374131,"Kohlberg, M",1222,617,605,0.504909983633388,1262,634,628,0.502377179080824,0.0111070810043453,0.338686702969655,0.650206216026
9,"Bayern",9374132,"Leuchtenberg, M",1236,617,619,0.499190938511327,1255,619,636,0.493227091633466,0.0111070810043453,0.338686702969655,0.650206216026
9,"Bayern",9374133,"Luhe-Wildenau, M",3374,1691,1683,0.501185536455246,3375,1684,1691,0.498962962962963,0.0111070810043453,0.338686702969655,0.650206216026
9,"Bayern",9374134,"Mantel, M",2963,1470,1493,0.496118798515019,2939,1452,1487,0.494045593739367,0.0111070810043453,0.338686702969655,0.650206216026
9,"Bayern",9374137,"Moosbach, M",2490,1247,1243,0.500803212851406,2479,1231,1248,0.496571198063735,0.0111070810043453,0.338686702969655,0.650206216026
9,"Bayern",9374139,"Neustadt a.d.Waldnaab, St",5875,2843,3032,0.483914893617021,5809,2804,3005,0.482699259769323,0.0111070810043453,0.338686702969655,0.650206216026
9,"Bayern",9374140,"Neustadt am Kulm, St",1202,575,627,0.478369384359401,1226,596,630,0.486133768352365,0.0111070810043453,0.338686702969655,0.650206216026
9,"Bayern",9374144,"Parkstein, M",2265,1132,1133,0.499779249448124,2288,1143,1145,0.499562937062937,0.0111070810043453,0.338686702969655,0.650206216026
9,"Bayern",9374146,"Pirk",1770,870,900,0.491525423728814,1785,877,908,0.491316526610644,0.0111070810043453,0.338686702969655,0.650206216026
9,"Bayern",9374147,"Pleystein, St",2453,1220,1233,0.497350183448838,2552,1274,1278,0.499216300940439,0.0111070810043453,0.338686702969655,0.650206216026
9,"Bayern",9374148,"Trabitz",1300,646,654,0.496923076923077,1318,649,669,0.492412746585736,0.0111070810043453,0.338686702969655,0.650206216026
9,"Bayern",9374149,"Pressath, St",4402,2142,2260,0.486597001363017,4332,2119,2213,0.489150507848569,0.0111070810043453,0.338686702969655,0.650206216026
9,"Bayern",9374150,"Püchersreuth",1611,803,808,0.49844816883923,1610,808,802,0.501863354037267,0.0111070810043453,0.338686702969655,0.650206216026
9,"Bayern",9374154,"Schirmitz",2029,983,1046,0.484475110892065,2048,993,1055,0.48486328125,0.0111070810043453,0.338686702969655,0.650206216026
9,"Bayern",9374155,"Schlammersdorf",873,449,424,0.514318442153494,882,452,430,0.512471655328798,0.0111070810043453,0.338686702969655,0.650206216026
9,"Bayern",9374156,"Schwarzenbach",1205,578,627,0.479668049792531,1174,553,621,0.471039182282794,0.0111070810043453,0.338686702969655,0.650206216026
9,"Bayern",9374157,"Speinshart",1104,549,555,0.497282608695652,1123,555,568,0.494211932324132,0.0111070810043453,0.338686702969655,0.650206216026
9,"Bayern",9374158,"Störnstein",1449,720,729,0.496894409937888,1474,729,745,0.494572591587517,0.0111070810043453,0.338686702969655,0.650206216026
9,"Bayern",9374159,"Tännesberg, M",1581,807,774,0.510436432637571,1486,745,741,0.501345895020188,0.0111070810043453,0.338686702969655,0.650206216026
9,"Bayern",9374160,"Theisseil",1204,621,583,0.51578073089701,1231,634,597,0.515028432168968,0.0111070810043453,0.338686702969655,0.650206216026
9,"Bayern",9374162,"Vohenstrauß, St",7589,3752,3837,0.494399789168533,7827,3961,3866,0.506068736425195,0.0111070810043453,0.338686702969655,0.650206216026
9,"Bayern",9374163,"Vorbach",1040,537,503,0.516346153846154,1032,552,480,0.534883720930233,0.0111070810043453,0.338686702969655,0.650206216026
9,"Bayern",9374164,"Waidhaus, M",2286,1167,1119,0.510498687664042,2352,1206,1146,0.512755102040816,0.0111070810043453,0.338686702969655,0.650206216026
9,"Bayern",9374165,"Waldthurn, M",1986,989,997,0.497985901309164,2017,1000,1017,0.495785820525533,0.0111070810043453,0.338686702969655,0.650206216026
9,"Bayern",9374166,"Weiherhammer",3870,1916,1954,0.495090439276486,3811,1888,1923,0.495408029388612,0.0111070810043453,0.338686702969655,0.650206216026
9,"Bayern",9374168,"Windischeschenbach, St",5156,2549,2607,0.494375484871994,5130,2510,2620,0.489278752436647,0.0111070810043453,0.338686702969655,0.650206216026
9,"Bayern",9374170,"Bechtsrieth",1078,534,544,0.495361781076067,1082,537,545,0.49630314232902,0.0111070810043453,0.338686702969655,0.650206216026
9,"Bayern",9375113,"Alteglofsheim",3181,1588,1593,0.499214083621503,3211,1623,1588,0.505450015571473,0.0111070810043453,0.338686702969655,0.650206216026
9,"Bayern",9375114,"Altenthann",1553,783,770,0.504185447520927,1550,783,767,0.505161290322581,0.0111070810043453,0.338686702969655,0.650206216026
9,"Bayern",9375115,"Aufhausen",1748,886,862,0.506864988558352,1732,881,851,0.508660508083141,0.0111070810043453,0.338686702969655,0.650206216026
9,"Bayern",9375116,"Bach a.d.Donau",1826,959,867,0.525191675794085,1840,980,860,0.532608695652174,0.0111070810043453,0.338686702969655,0.650206216026
9,"Bayern",9375117,"Barbing",5090,2536,2554,0.498231827111984,5145,2568,2577,0.499125364431487,0.0111070810043453,0.338686702969655,0.650206216026
9,"Bayern",9375118,"Beratzhausen, M",5442,2686,2756,0.493568540977582,5425,2656,2769,0.489585253456221,0.0111070810043453,0.338686702969655,0.650206216026
9,"Bayern",9375119,"Bernhardswald",5462,2685,2777,0.491578176492127,5555,2737,2818,0.492709270927093,0.0111070810043453,0.338686702969655,0.650206216026
9,"Bayern",9375120,"Brennberg",1913,961,952,0.502352326189232,1865,932,933,0.499731903485255,0.0111070810043453,0.338686702969655,0.650206216026
9,"Bayern",9375122,"Brunn",1402,719,683,0.51283880171184,1436,741,695,0.516016713091922,0.0111070810043453,0.338686702969655,0.650206216026
9,"Bayern",9375127,"Deuerling",2038,1016,1022,0.498527968596663,2079,1043,1036,0.501683501683502,0.0111070810043453,0.338686702969655,0.650206216026
9,"Bayern",9375130,"Donaustauf, M",3818,1890,1928,0.495023572551074,3794,1890,1904,0.498154981549816,0.0111070810043453,0.338686702969655,0.650206216026
9,"Bayern",9375131,"Duggendorf",1573,787,786,0.500317863954228,1610,811,799,0.503726708074534,0.0111070810043453,0.338686702969655,0.650206216026
9,"Bayern",9375143,"Hagelstadt",1989,1005,984,0.505279034690799,2003,1011,992,0.504742885671493,0.0111070810043453,0.338686702969655,0.650206216026
9,"Bayern",9375148,"Hemau, St",8503,4315,4188,0.507467952487357,8549,4354,4195,0.509299333255351,0.0111070810043453,0.338686702969655,0.650206216026
9,"Bayern",9375153,"Holzheim a.Forst",981,492,489,0.501529051987768,992,499,493,0.503024193548387,0.0111070810043453,0.338686702969655,0.650206216026
9,"Bayern",9375156,"Kallmünz, M",2799,1369,1430,0.489103251161129,2818,1383,1435,0.490773598296664,0.0111070810043453,0.338686702969655,0.650206216026
9,"Bayern",9375161,"Köfering",2357,1190,1167,0.504879083580823,2407,1225,1182,0.508932280847528,0.0111070810043453,0.338686702969655,0.650206216026
9,"Bayern",9375162,"Laaber, M",5150,2549,2601,0.49495145631068,5161,2574,2587,0.498740554156171,0.0111070810043453,0.338686702969655,0.650206216026
9,"Bayern",9375165,"Lappersdorf, M",12970,6235,6735,0.480724749421742,13181,6395,6786,0.485168044913133,0.0111070810043453,0.338686702969655,0.650206216026
9,"Bayern",9375170,"Mintraching",4730,2348,2382,0.496405919661734,4786,2377,2409,0.496656916005015,0.0111070810043453,0.338686702969655,0.650206216026
9,"Bayern",9375171,"Mötzing",1692,812,880,0.479905437352246,1731,898,833,0.518775274407857,0.0111070810043453,0.338686702969655,0.650206216026
9,"Bayern",9375174,"Neutraubling, St",12747,6211,6536,0.48725190240841,12774,6274,6500,0.491153906372319,0.0111070810043453,0.338686702969655,0.650206216026
9,"Bayern",9375175,"Nittendorf, M",8842,4309,4533,0.487333182537887,8875,4325,4550,0.487323943661972,0.0111070810043453,0.338686702969655,0.650206216026
9,"Bayern",9375179,"Obertraubling",7680,3788,3892,0.493229166666667,7824,3892,3932,0.497443762781186,0.0111070810043453,0.338686702969655,0.650206216026
9,"Bayern",9375180,"Pentling",5710,2832,2878,0.495971978984238,5928,2975,2953,0.501855600539811,0.0111070810043453,0.338686702969655,0.650206216026
9,"Bayern",9375181,"Pettendorf",3220,1598,1622,0.496273291925466,3296,1653,1643,0.501516990291262,0.0111070810043453,0.338686702969655,0.650206216026
9,"Bayern",9375182,"Pfakofen",1569,801,768,0.510516252390057,1578,801,777,0.507604562737643,0.0111070810043453,0.338686702969655,0.650206216026
9,"Bayern",9375183,"Pfatter",3048,1523,1525,0.499671916010499,3097,1580,1517,0.51017113335486,0.0111070810043453,0.338686702969655,0.650206216026
9,"Bayern",9375184,"Pielenhofen",1419,696,723,0.490486257928118,1446,723,723,0.5,0.0111070810043453,0.338686702969655,0.650206216026
9,"Bayern",9375190,"Regenstauf, M",15176,7477,7699,0.49268581971534,15233,7471,7762,0.490448368673275,0.0111070810043453,0.338686702969655,0.650206216026
9,"Bayern",9375191,"Riekofen",767,399,368,0.520208604954368,790,405,385,0.512658227848101,0.0111070810043453,0.338686702969655,0.650206216026
9,"Bayern",9375196,"Schierling, M",7377,3716,3661,0.503727802629795,7321,3691,3630,0.50416609752766,0.0111070810043453,0.338686702969655,0.650206216026
9,"Bayern",9375199,"Sinzing",6747,3371,3376,0.499629464947384,6805,3384,3421,0.497281410727406,0.0111070810043453,0.338686702969655,0.650206216026
9,"Bayern",9375201,"Sünching",1967,963,1004,0.489578037620742,1937,951,986,0.490965410428498,0.0111070810043453,0.338686702969655,0.650206216026
9,"Bayern",9375204,"Tegernheim",4934,2379,2555,0.482164572355087,5025,2429,2596,0.483383084577114,0.0111070810043453,0.338686702969655,0.650206216026
9,"Bayern",9375205,"Thalmassing",3258,1611,1647,0.494475138121547,3313,1626,1687,0.490793842438877,0.0111070810043453,0.338686702969655,0.650206216026
9,"Bayern",9375208,"Wenzenbach",8243,4171,4072,0.506005095232318,8293,4218,4075,0.508621729169179,0.0111070810043453,0.338686702969655,0.650206216026
9,"Bayern",9375209,"Wiesent",2482,1241,1241,0.5,2529,1267,1262,0.500988533017003,0.0111070810043453,0.338686702969655,0.650206216026
9,"Bayern",9375210,"Wörth a.d.Donau, St",4446,2220,2226,0.499325236167341,4453,2243,2210,0.503705367168201,0.0111070810043453,0.338686702969655,0.650206216026
9,"Bayern",9375211,"Wolfsegg",1458,746,712,0.511659807956104,1487,769,718,0.51714862138534,0.0111070810043453,0.338686702969655,0.650206216026
9,"Bayern",9375213,"Zeitlarn",5854,2887,2967,0.493167065254527,5971,2976,2995,0.498408976720817,0.0111070810043453,0.338686702969655,0.650206216026
9,"Bayern",9376112,"Altendorf",939,483,456,0.514376996805112,923,467,456,0.505958829902492,0.0111070810043453,0.338686702969655,0.650206216026
9,"Bayern",9376116,"Bodenwöhr",4098,2056,2042,0.501708150317228,4089,2070,2019,0.506236243580337,0.0111070810043453,0.338686702969655,0.650206216026
9,"Bayern",9376117,"Bruck i.d.OPf., M",4296,2107,2189,0.490456238361266,4334,2096,2238,0.483617904937702,0.0111070810043453,0.338686702969655,0.650206216026
9,"Bayern",9376119,"Burglengenfeld, St",12151,5943,6208,0.489095547691548,12361,6041,6320,0.488714505298924,0.0111070810043453,0.338686702969655,0.650206216026
9,"Bayern",9376122,"Dieterskirchen",1004,511,493,0.508964143426295,997,511,486,0.512537612838516,0.0111070810043453,0.338686702969655,0.650206216026
9,"Bayern",9376125,"Fensterbach",2375,1217,1158,0.512421052631579,2383,1218,1165,0.511120436424675,0.0111070810043453,0.338686702969655,0.650206216026
9,"Bayern",9376131,"Gleiritsch",654,332,322,0.507645259938838,653,331,322,0.506891271056662,0.0111070810043453,0.338686702969655,0.650206216026
9,"Bayern",9376133,"Guteneck",886,466,420,0.525959367945824,868,452,416,0.52073732718894,0.0111070810043453,0.338686702969655,0.650206216026
9,"Bayern",9376141,"Maxhütte-Haidhof, St",10524,5253,5271,0.499144811858609,10623,5290,5333,0.497976089616869,0.0111070810043453,0.338686702969655,0.650206216026
9,"Bayern",9376144,"Nabburg, St",6156,3043,3113,0.494314489928525,6033,2955,3078,0.489806066633516,0.0111070810043453,0.338686702969655,0.650206216026
9,"Bayern",9376146,"Neukirchen-Balbini, M",1137,586,551,0.515391380826737,1108,581,527,0.524368231046931,0.0111070810043453,0.338686702969655,0.650206216026
9,"Bayern",9376147,"Neunburg vorm Wald, St",7936,3968,3968,0.5,8021,4055,3966,0.505547936666251,0.0111070810043453,0.338686702969655,0.650206216026
9,"Bayern",9376148,"Niedermurach",1255,640,615,0.50996015936255,1264,640,624,0.506329113924051,0.0111070810043453,0.338686702969655,0.650206216026
9,"Bayern",9376149,"Nittenau, St",8435,4221,4214,0.500414937759336,8466,4246,4220,0.501535553980628,0.0111070810043453,0.338686702969655,0.650206216026
9,"Bayern",9376150,"Wernberg-Köblitz, M",5658,2832,2826,0.500530222693531,5616,2808,2808,0.5,0.0111070810043453,0.338686702969655,0.650206216026
9,"Bayern",9376151,"Oberviechtach, St",4975,2454,2521,0.493266331658291,4876,2394,2482,0.490976210008203,0.0111070810043453,0.338686702969655,0.650206216026
9,"Bayern",9376153,"Pfreimd, St",5425,2715,2710,0.500460829493088,5464,2756,2708,0.504392386530015,0.0111070810043453,0.338686702969655,0.650206216026
9,"Bayern",9376159,"Schmidgaden",2882,1450,1432,0.503122831367106,2890,1454,1436,0.503114186851211,0.0111070810043453,0.338686702969655,0.650206216026
9,"Bayern",9376160,"Schönsee, St",2568,1280,1288,0.498442367601246,2635,1315,1320,0.499051233396584,0.0111070810043453,0.338686702969655,0.650206216026
9,"Bayern",9376161,"Schwandorf, GKSt",27736,13721,14015,0.49470002884338,27921,13855,14066,0.496221482038609,0.0111070810043453,0.338686702969655,0.650206216026
9,"Bayern",9376162,"Schwarzach b.Nabburg",1502,766,736,0.509986684420772,1501,771,730,0.513657561625583,0.0111070810043453,0.338686702969655,0.650206216026
9,"Bayern",9376163,"Schwarzenfeld, M",6248,3032,3216,0.48527528809219,6173,2977,3196,0.482261461202009,0.0111070810043453,0.338686702969655,0.650206216026
9,"Bayern",9376164,"Schwarzhofen, M",1472,766,706,0.520380434782609,1437,750,687,0.521920668058455,0.0111070810043453,0.338686702969655,0.650206216026
9,"Bayern",9376167,"Stadlern",517,262,255,0.506769825918762,573,292,281,0.509598603839442,0.0111070810043453,0.338686702969655,0.650206216026
9,"Bayern",9376168,"Steinberg am See",1875,940,935,0.501333333333333,1867,935,932,0.500803427959293,0.0111070810043453,0.338686702969655,0.650206216026
9,"Bayern",9376169,"Stulln",1698,830,868,0.488810365135453,1672,805,867,0.481459330143541,0.0111070810043453,0.338686702969655,0.650206216026
9,"Bayern",9376170,"Teublitz, St",7369,3663,3706,0.497082372099335,7358,3689,3669,0.501359064963305,0.0111070810043453,0.338686702969655,0.650206216026
9,"Bayern",9376171,"Teunz",1884,937,947,0.497346072186837,1912,955,957,0.499476987447699,0.0111070810043453,0.338686702969655,0.650206216026
9,"Bayern",9376172,"Thanstein",1003,512,491,0.510468594217348,982,493,489,0.5020366598778,0.0111070810043453,0.338686702969655,0.650206216026
9,"Bayern",9376173,"Trausnitz",967,497,470,0.513960703205791,917,446,471,0.486368593238822,0.0111070810043453,0.338686702969655,0.650206216026
9,"Bayern",9376175,"Wackersdorf",5028,2513,2515,0.499801113762928,5019,2530,2489,0.504084478979877,0.0111070810043453,0.338686702969655,0.650206216026
9,"Bayern",9376176,"Weiding",528,298,230,0.564393939393939,538,311,227,0.578066914498141,0.0111070810043453,0.338686702969655,0.650206216026
9,"Bayern",9376178,"Winklarn, M",1449,717,732,0.494824016563147,1444,717,727,0.496537396121884,0.0111070810043453,0.338686702969655,0.650206216026
9,"Bayern",9377112,"Bärnau, St",3290,1694,1596,0.514893617021277,3202,1630,1572,0.509056839475328,0.0111070810043453,0.338686702969655,0.650206216026
9,"Bayern",9377113,"Brand",1175,556,619,0.473191489361702,1151,542,609,0.470894874022589,0.0111070810043453,0.338686702969655,0.650206216026
9,"Bayern",9377115,"Ebnath",1339,656,683,0.48991784914115,1331,658,673,0.494365138993238,0.0111070810043453,0.338686702969655,0.650206216026
9,"Bayern",9377116,"Erbendorf, St",5199,2562,2637,0.492787074437392,5254,2587,2667,0.492386752950133,0.0111070810043453,0.338686702969655,0.650206216026
9,"Bayern",9377117,"Falkenberg, M",967,482,485,0.498448810754912,945,478,467,0.505820105820106,0.0111070810043453,0.338686702969655,0.650206216026
9,"Bayern",9377118,"Friedenfels",1280,643,637,0.50234375,1279,635,644,0.496481626270524,0.0111070810043453,0.338686702969655,0.650206216026
9,"Bayern",9377119,"Fuchsmühl, M",1660,804,856,0.48433734939759,1671,817,854,0.488928785158588,0.0111070810043453,0.338686702969655,0.650206216026
9,"Bayern",9377127,"Immenreuth",1864,953,911,0.511266094420601,1826,922,904,0.504928806133625,0.0111070810043453,0.338686702969655,0.650206216026
9,"Bayern",9377128,"Kastl",1400,706,694,0.504285714285714,1401,716,685,0.511063526052819,0.0111070810043453,0.338686702969655,0.650206216026
9,"Bayern",9377129,"Kemnath, St",5305,2588,2717,0.487841658812441,5215,2544,2671,0.487823585810163,0.0111070810043453,0.338686702969655,0.650206216026
9,"Bayern",9377131,"Konnersreuth, M",1863,948,915,0.508856682769726,1886,983,903,0.521208907741251,0.0111070810043453,0.338686702969655,0.650206216026
9,"Bayern",9377132,"Krummennaab",1548,787,761,0.508397932816537,1544,778,766,0.503886010362694,0.0111070810043453,0.338686702969655,0.650206216026
9,"Bayern",9377133,"Kulmain",2324,1127,1197,0.484939759036145,2331,1112,1219,0.477048477048477,0.0111070810043453,0.338686702969655,0.650206216026
9,"Bayern",9377137,"Leonberg",1067,558,509,0.522961574507966,1102,567,535,0.514519056261343,0.0111070810043453,0.338686702969655,0.650206216026
9,"Bayern",9377139,"Mähring, M",1843,965,878,0.523602821486706,1871,973,898,0.520042757883485,0.0111070810043453,0.338686702969655,0.650206216026
9,"Bayern",9377141,"Mitterteich, St",6834,3349,3485,0.490049751243781,6751,3305,3446,0.489557102651459,0.0111070810043453,0.338686702969655,0.650206216026
9,"Bayern",9377142,"Neualbenreuth, M",1403,702,701,0.500356379187455,1463,738,725,0.504442925495557,0.0111070810043453,0.338686702969655,0.650206216026
9,"Bayern",9377143,"Neusorg",1928,940,988,0.487551867219917,1915,940,975,0.490861618798956,0.0111070810043453,0.338686702969655,0.650206216026
9,"Bayern",9377145,"Pechbrunn",1396,688,708,0.492836676217765,1400,694,706,0.495714285714286,0.0111070810043453,0.338686702969655,0.650206216026
9,"Bayern",9377146,"Plößberg, M",3317,1679,1638,0.506180283388604,3350,1691,1659,0.504776119402985,0.0111070810043453,0.338686702969655,0.650206216026
9,"Bayern",9377148,"Pullenreuth",1801,909,892,0.504719600222099,1818,925,893,0.508800880088009,0.0111070810043453,0.338686702969655,0.650206216026
9,"Bayern",9377149,"Reuth b.Erbendorf",1210,625,585,0.516528925619835,1202,636,566,0.529118136439268,0.0111070810043453,0.338686702969655,0.650206216026
9,"Bayern",9377154,"Tirschenreuth, St",9107,4373,4734,0.480180081256177,9073,4353,4720,0.479775157059407,0.0111070810043453,0.338686702969655,0.650206216026
9,"Bayern",9377157,"Waldershof, St",4348,2133,2215,0.490570377184913,4343,2137,2206,0.492056182362422,0.0111070810043453,0.338686702969655,0.650206216026
9,"Bayern",9377158,"Waldsassen, St",6889,3335,3554,0.484105095079112,6908,3351,3557,0.485089751013318,0.0111070810043453,0.338686702969655,0.650206216026
9,"Bayern",9377159,"Wiesau, M",4126,1995,2131,0.483519146873485,4094,1967,2127,0.480459208597948,0.0111070810043453,0.338686702969655,0.650206216026
9,"Bayern",9461000,"Bamberg",70712,33131,37581,0.468534336463401,70084,32783,37301,0.467767250727698,0.0111070810043453,0.338686702969655,0.650206216026
9,"Bayern",9462000,"Bayreuth",71214,34028,37186,0.477827393490044,73111,35419,37692,0.48445514354885,0.0111070810043453,0.338686702969655,0.650206216026
9,"Bayern",9463000,"Coburg",40991,19528,21463,0.476397257934669,40915,19600,21315,0.479041916167665,0.0111070810043453,0.338686702969655,0.650206216026
9,"Bayern",9464000,"Hof",44511,20937,23574,0.470378108782099,45904,22014,23890,0.479566050888811,0.0111070810043453,0.338686702969655,0.650206216026
9,"Bayern",9471111,"Altendorf",1992,978,1014,0.490963855421687,2040,1007,1033,0.493627450980392,0.0111070810043453,0.338686702969655,0.650206216026
9,"Bayern",9471115,"Baunach, St",4001,2040,1961,0.509872531867033,3927,2018,1909,0.513878278584161,0.0111070810043453,0.338686702969655,0.650206216026
9,"Bayern",9471117,"Bischberg",5994,2970,3024,0.495495495495495,6003,2991,3012,0.498250874562719,0.0111070810043453,0.338686702969655,0.650206216026
9,"Bayern",9471119,"Breitengüßbach",4513,2222,2291,0.492355417682251,4693,2295,2398,0.489026209247816,0.0111070810043453,0.338686702969655,0.650206216026
9,"Bayern",9471120,"Burgebrach, M",6465,3262,3203,0.504563031709203,6440,3261,3179,0.506366459627329,0.0111070810043453,0.338686702969655,0.650206216026
9,"Bayern",9471122,"Burgwindheim, M",1308,676,632,0.516819571865443,1374,718,656,0.522561863173217,0.0111070810043453,0.338686702969655,0.650206216026
9,"Bayern",9471123,"Buttenheim, M",3459,1741,1718,0.503324660306447,3394,1713,1681,0.504714201532116,0.0111070810043453,0.338686702969655,0.650206216026
9,"Bayern",9471128,"Ebrach, M",1855,1007,848,0.542857142857143,1862,1052,810,0.564983888292159,0.0111070810043453,0.338686702969655,0.650206216026
9,"Bayern",9471131,"Frensdorf",4882,2422,2460,0.496108152396559,4904,2429,2475,0.495309951060359,0.0111070810043453,0.338686702969655,0.650206216026
9,"Bayern",9471133,"Gerach",962,474,488,0.492723492723493,966,474,492,0.490683229813665,0.0111070810043453,0.338686702969655,0.650206216026
9,"Bayern",9471137,"Gundelsheim",3325,1617,1708,0.486315789473684,3325,1619,1706,0.486917293233083,0.0111070810043453,0.338686702969655,0.650206216026
9,"Bayern",9471140,"Hallstadt, St",8497,4162,4335,0.489819936448158,8514,4196,4318,0.492835330044632,0.0111070810043453,0.338686702969655,0.650206216026
9,"Bayern",9471142,"Heiligenstadt i.OFr., M",3555,1763,1792,0.49592123769339,3602,1787,1815,0.49611327040533,0.0111070810043453,0.338686702969655,0.650206216026
9,"Bayern",9471145,"Hirschaid, M",11632,5706,5926,0.490543328748281,11771,5793,5978,0.492141704188259,0.0111070810043453,0.338686702969655,0.650206216026
9,"Bayern",9471150,"Kemmern",2550,1245,1305,0.488235294117647,2567,1250,1317,0.486949746786132,0.0111070810043453,0.338686702969655,0.650206216026
9,"Bayern",9471151,"Königsfeld",1363,708,655,0.519442406456346,1338,688,650,0.514200298953662,0.0111070810043453,0.338686702969655,0.650206216026
9,"Bayern",9471152,"Lauter",1150,550,600,0.478260869565217,1141,551,590,0.482909728308501,0.0111070810043453,0.338686702969655,0.650206216026
9,"Bayern",9471154,"Lisberg",1791,863,928,0.481853713009492,1757,848,909,0.482640865110985,0.0111070810043453,0.338686702969655,0.650206216026
9,"Bayern",9471155,"Litzendorf",6019,3000,3019,0.49842166472836,6011,3007,3004,0.500249542505407,0.0111070810043453,0.338686702969655,0.650206216026
9,"Bayern",9471159,"Memmelsdorf",8768,4304,4464,0.490875912408759,8857,4365,4492,0.49283052952467,0.0111070810043453,0.338686702969655,0.650206216026
9,"Bayern",9471165,"Oberhaid",4518,2231,2287,0.493802567507747,4653,2299,2354,0.494089834515366,0.0111070810043453,0.338686702969655,0.650206216026
9,"Bayern",9471169,"Pettstadt",1957,970,987,0.495656617271334,1951,962,989,0.49308047155305,0.0111070810043453,0.338686702969655,0.650206216026
9,"Bayern",9471172,"Pommersfelden",2871,1438,1433,0.500870776732846,2943,1479,1464,0.502548419979613,0.0111070810043453,0.338686702969655,0.650206216026
9,"Bayern",9471173,"Priesendorf",1528,753,775,0.492801047120419,1535,765,770,0.498371335504886,0.0111070810043453,0.338686702969655,0.650206216026
9,"Bayern",9471174,"Rattelsdorf, M",4505,2256,2249,0.500776914539401,4474,2261,2213,0.505364327223961,0.0111070810043453,0.338686702969655,0.650206216026
9,"Bayern",9471175,"Reckendorf",2025,996,1029,0.491851851851852,1998,980,1018,0.49049049049049,0.0111070810043453,0.338686702969655,0.650206216026
9,"Bayern",9471185,"Scheßlitz, St",7159,3642,3517,0.508730269590725,7083,3582,3501,0.50571791613723,0.0111070810043453,0.338686702969655,0.650206216026
9,"Bayern",9471186,"Schönbrunn i.Steigerwald",1908,957,951,0.501572327044025,1885,951,934,0.504509283819629,0.0111070810043453,0.338686702969655,0.650206216026
9,"Bayern",9471189,"Stadelhofen",1271,637,634,0.501180173092054,1234,630,604,0.510534846029173,0.0111070810043453,0.338686702969655,0.650206216026
9,"Bayern",9471191,"Stegaurach",6761,3323,3438,0.491495340925899,6887,3354,3533,0.487004501234209,0.0111070810043453,0.338686702969655,0.650206216026
9,"Bayern",9471195,"Strullendorf",7759,3835,3924,0.494264724835675,7713,3806,3907,0.493452612472449,0.0111070810043453,0.338686702969655,0.650206216026
9,"Bayern",9471207,"Viereth-Trunstadt",3536,1750,1786,0.494909502262443,3619,1783,1836,0.492677535230727,0.0111070810043453,0.338686702969655,0.650206216026
9,"Bayern",9471208,"Walsdorf",2550,1239,1311,0.485882352941176,2571,1259,1312,0.489692726565539,0.0111070810043453,0.338686702969655,0.650206216026
9,"Bayern",9471209,"Wattendorf",699,347,352,0.496423462088698,687,339,348,0.493449781659389,0.0111070810043453,0.338686702969655,0.650206216026
9,"Bayern",9471214,"Zapfendorf, M",4984,2468,2516,0.495184590690209,4987,2472,2515,0.495688790856226,0.0111070810043453,0.338686702969655,0.650206216026
9,"Bayern",9471220,"Schlüsselfeld, St",5634,2810,2824,0.498757543485978,5655,2823,2832,0.49920424403183,0.0111070810043453,0.338686702969655,0.650206216026
9,"Bayern",9472111,"Ahorntal",2218,1112,1106,0.501352569882777,2246,1125,1121,0.500890471950134,0.0111070810043453,0.338686702969655,0.650206216026
9,"Bayern",9472115,"Aufseß",1334,682,652,0.511244377811094,1318,675,643,0.512139605462822,0.0111070810043453,0.338686702969655,0.650206216026
9,"Bayern",9472116,"Bad Berneck i.Fichtelgebirge, St",4261,2052,2209,0.481577094578737,4505,2178,2327,0.4834628190899,0.0111070810043453,0.338686702969655,0.650206216026
9,"Bayern",9472118,"Betzenstein, St",2490,1240,1250,0.497991967871486,2498,1262,1236,0.505204163330665,0.0111070810043453,0.338686702969655,0.650206216026
9,"Bayern",9472119,"Bindlach",7259,3502,3757,0.482435597189696,7193,3477,3716,0.483386625886278,0.0111070810043453,0.338686702969655,0.650206216026
9,"Bayern",9472121,"Bischofsgrün",1934,980,954,0.506721820062048,1947,992,955,0.509501797637391,0.0111070810043453,0.338686702969655,0.650206216026
9,"Bayern",9472127,"Creußen, St",4814,2352,2462,0.488574989613627,4670,2273,2397,0.486723768736617,0.0111070810043453,0.338686702969655,0.650206216026
9,"Bayern",9472131,"Eckersdorf",5149,2473,2676,0.480287434453292,5110,2439,2671,0.477299412915851,0.0111070810043453,0.338686702969655,0.650206216026
9,"Bayern",9472133,"Emtmannsberg",1053,512,541,0.486229819563153,1098,532,566,0.484517304189435,0.0111070810043453,0.338686702969655,0.650206216026
9,"Bayern",9472138,"Fichtelberg",1928,936,992,0.485477178423237,1906,941,965,0.493704092339979,0.0111070810043453,0.338686702969655,0.650206216026
9,"Bayern",9472139,"Gefrees, St",4513,2193,2320,0.485929536893419,4581,2275,2306,0.496616459288365,0.0111070810043453,0.338686702969655,0.650206216026
9,"Bayern",9472140,"Gesees",1280,630,650,0.4921875,1283,619,664,0.482462977396726,0.0111070810043453,0.338686702969655,0.650206216026
9,"Bayern",9472141,"Glashütten",1445,708,737,0.489965397923875,1456,719,737,0.493818681318681,0.0111070810043453,0.338686702969655,0.650206216026
9,"Bayern",9472143,"Goldkronach, St",3578,1739,1839,0.486025712688653,3606,1765,1841,0.489462007764836,0.0111070810043453,0.338686702969655,0.650206216026
9,"Bayern",9472146,"Haag",922,449,473,0.486984815618221,934,465,469,0.497858672376874,0.0111070810043453,0.338686702969655,0.650206216026
9,"Bayern",9472150,"Heinersreuth",3691,1798,1893,0.487130858845841,3672,1792,1880,0.4880174291939,0.0111070810043453,0.338686702969655,0.650206216026
9,"Bayern",9472154,"Hollfeld, St",5226,2585,2641,0.494642173746651,5101,2491,2610,0.488335620466575,0.0111070810043453,0.338686702969655,0.650206216026
9,"Bayern",9472155,"Hummeltal",2353,1142,1211,0.485337866553336,2391,1160,1231,0.485152655792555,0.0111070810043453,0.338686702969655,0.650206216026
9,"Bayern",9472156,"Kirchenpingarten",1286,663,623,0.515552099533437,1352,702,650,0.519230769230769,0.0111070810043453,0.338686702969655,0.650206216026
9,"Bayern",9472164,"Mehlmeisel",1384,690,694,0.498554913294798,1346,673,673,0.5,0.0111070810043453,0.338686702969655,0.650206216026
9,"Bayern",9472166,"Mistelbach",1617,787,830,0.486703772418058,1637,800,837,0.488698839340257,0.0111070810043453,0.338686702969655,0.650206216026
9,"Bayern",9472167,"Mistelgau",3774,1878,1896,0.497615262321145,3804,1902,1902,0.5,0.0111070810043453,0.338686702969655,0.650206216026
9,"Bayern",9472175,"Pegnitz, St",13493,6511,6982,0.482546505595494,13551,6635,6916,0.489631761493617,0.0111070810043453,0.338686702969655,0.650206216026
9,"Bayern",9472176,"Plankenfels",886,443,443,0.5,869,445,424,0.512082853855006,0.0111070810043453,0.338686702969655,0.650206216026
9,"Bayern",9472177,"Plech, M",1304,648,656,0.496932515337423,1325,657,668,0.495849056603774,0.0111070810043453,0.338686702969655,0.650206216026
9,"Bayern",9472179,"Pottenstein, St",5325,2686,2639,0.504413145539906,5319,2686,2633,0.504982139499906,0.0111070810043453,0.338686702969655,0.650206216026
9,"Bayern",9472180,"Prebitz",1003,510,493,0.508474576271186,1053,527,526,0.500474833808167,0.0111070810043453,0.338686702969655,0.650206216026
9,"Bayern",9472184,"Schnabelwaid, M",993,498,495,0.501510574018127,987,494,493,0.500506585612969,0.0111070810043453,0.338686702969655,0.650206216026
9,"Bayern",9472188,"Seybothenreuth",1273,641,632,0.503534956794973,1351,704,647,0.521095484826055,0.0111070810043453,0.338686702969655,0.650206216026
9,"Bayern",9472190,"Speichersdorf",5932,2976,2956,0.501685772083614,5966,2984,2982,0.500167616493463,0.0111070810043453,0.338686702969655,0.650206216026
9,"Bayern",9472197,"Waischenfeld, St",3162,1634,1528,0.516761543327008,3164,1629,1535,0.514854614412137,0.0111070810043453,0.338686702969655,0.650206216026
9,"Bayern",9472198,"Warmensteinach",2206,1085,1121,0.491840435176791,2131,1045,1086,0.490380103237916,0.0111070810043453,0.338686702969655,0.650206216026
9,"Bayern",9472199,"Weidenberg, M",6141,3007,3134,0.489659664549748,6370,3159,3211,0.495918367346939,0.0111070810043453,0.338686702969655,0.650206216026
9,"Bayern",9473112,"Ahorn",4293,2099,2194,0.48893547635686,4339,2129,2210,0.490666052085734,0.0111070810043453,0.338686702969655,0.650206216026
9,"Bayern",9473120,"Dörfles-Esbach",3696,1779,1917,0.481331168831169,3636,1755,1881,0.482673267326733,0.0111070810043453,0.338686702969655,0.650206216026
9,"Bayern",9473121,"Ebersdorf b.Coburg",6052,2979,3073,0.492233972240582,6006,2962,3044,0.493173493173493,0.0111070810043453,0.338686702969655,0.650206216026
9,"Bayern",9473132,"Großheirath",2610,1311,1299,0.502298850574713,2595,1330,1265,0.51252408477842,0.0111070810043453,0.338686702969655,0.650206216026
9,"Bayern",9473134,"Grub a.Forst",2938,1509,1429,0.513614703880191,2943,1510,1433,0.513081889228678,0.0111070810043453,0.338686702969655,0.650206216026
9,"Bayern",9473138,"Itzgrund",2327,1139,1188,0.489471422432316,2344,1153,1191,0.491894197952218,0.0111070810043453,0.338686702969655,0.650206216026
9,"Bayern",9473141,"Lautertal",4122,2019,2103,0.48981077147016,4152,2042,2110,0.491811175337187,0.0111070810043453,0.338686702969655,0.650206216026
9,"Bayern",9473144,"Meeder",3807,1884,1923,0.494877856579984,3814,1877,1937,0.492134242265338,0.0111070810043453,0.338686702969655,0.650206216026
9,"Bayern",9473151,"Neustadt b.Coburg, GKSt",15359,7486,7873,0.487401523536689,15682,7690,7992,0.490371126131871,0.0111070810043453,0.338686702969655,0.650206216026
9,"Bayern",9473153,"Niederfüllbach",1578,774,804,0.490494296577947,1589,781,808,0.491504090623033,0.0111070810043453,0.338686702969655,0.650206216026
9,"Bayern",9473158,"Bad Rodach, St",6312,3040,3272,0.481622306717364,6320,3056,3264,0.483544303797468,0.0111070810043453,0.338686702969655,0.650206216026
9,"Bayern",9473159,"Rödental, St",13197,6458,6739,0.48935364097901,13091,6393,6698,0.488350775341838,0.0111070810043453,0.338686702969655,0.650206216026
9,"Bayern",9473165,"Seßlach, St",4021,2027,1994,0.504103456851529,4008,2027,1981,0.505738522954092,0.0111070810043453,0.338686702969655,0.650206216026
9,"Bayern",9473166,"Sonnefeld",4911,2420,2491,0.492771329668092,4998,2460,2538,0.492196878751501,0.0111070810043453,0.338686702969655,0.650206216026
9,"Bayern",9473170,"Untersiemau",4061,2027,2034,0.499138143314455,4047,2021,2026,0.499382258463059,0.0111070810043453,0.338686702969655,0.650206216026
9,"Bayern",9473174,"Weidhausen b.Coburg",3125,1556,1569,0.49792,3148,1566,1582,0.497458703939009,0.0111070810043453,0.338686702969655,0.650206216026
9,"Bayern",9473175,"Weitramsdorf",4995,2425,2570,0.485485485485485,5032,2457,2575,0.488275039745628,0.0111070810043453,0.338686702969655,0.650206216026
9,"Bayern",9474119,"Dormitz",2042,1017,1025,0.498041136141038,2018,1010,1008,0.500495540138751,0.0111070810043453,0.338686702969655,0.650206216026
9,"Bayern",9474121,"Ebermannstadt, St",6942,3445,3497,0.49625468164794,6818,3394,3424,0.497799941331769,0.0111070810043453,0.338686702969655,0.650206216026
9,"Bayern",9474122,"Effeltrich",2611,1295,1316,0.49597855227882,2636,1321,1315,0.50113808801214,0.0111070810043453,0.338686702969655,0.650206216026
9,"Bayern",9474123,"Eggolsheim, M",6403,3166,3237,0.494455723879432,6384,3167,3217,0.496083959899749,0.0111070810043453,0.338686702969655,0.650206216026
9,"Bayern",9474124,"Egloffstein, M",1968,1004,964,0.510162601626016,1977,1017,960,0.514415781487102,0.0111070810043453,0.338686702969655,0.650206216026
9,"Bayern",9474126,"Forchheim, GKSt",30434,14507,15927,0.476670828678452,30497,14646,15851,0.48024395842214,0.0111070810043453,0.338686702969655,0.650206216026
9,"Bayern",9474129,"Gößweinstein, M",4092,2081,2011,0.508553274682307,4057,2061,1996,0.508010845452305,0.0111070810043453,0.338686702969655,0.650206216026
9,"Bayern",9474132,"Gräfenberg, St",4068,2026,2042,0.49803343166175,4055,2028,2027,0.500123304562269,0.0111070810043453,0.338686702969655,0.650206216026
9,"Bayern",9474133,"Hallerndorf",4008,1992,2016,0.497005988023952,4007,2014,1993,0.502620414275019,0.0111070810043453,0.338686702969655,0.650206216026
9,"Bayern",9474134,"Hausen",3648,1853,1795,0.507949561403509,3680,1875,1805,0.509510869565217,0.0111070810043453,0.338686702969655,0.650206216026
9,"Bayern",9474135,"Heroldsbach",4939,2440,2499,0.494027130998178,4938,2441,2497,0.494329688132847,0.0111070810043453,0.338686702969655,0.650206216026
9,"Bayern",9474137,"Hetzles",1292,632,660,0.489164086687306,1308,640,668,0.489296636085627,0.0111070810043453,0.338686702969655,0.650206216026
9,"Bayern",9474138,"Hiltpoltstein, M",1599,827,772,0.517198248905566,1563,812,751,0.519513755598209,0.0111070810043453,0.338686702969655,0.650206216026
9,"Bayern",9474140,"Igensdorf, M",4890,2470,2420,0.505112474437628,4934,2503,2431,0.507296311309283,0.0111070810043453,0.338686702969655,0.650206216026
9,"Bayern",9474143,"Kirchehrenbach",2259,1141,1118,0.505090748118637,2257,1130,1127,0.500664599025255,0.0111070810043453,0.338686702969655,0.650206216026
9,"Bayern",9474144,"Kleinsendelbach",1500,737,763,0.491333333333333,1519,747,772,0.491770901909151,0.0111070810043453,0.338686702969655,0.650206216026
9,"Bayern",9474145,"Kunreuth",1387,689,698,0.496755587599135,1377,674,703,0.489469862018882,0.0111070810043453,0.338686702969655,0.650206216026
9,"Bayern",9474146,"Langensendelbach",2950,1463,1487,0.495932203389831,2997,1491,1506,0.497497497497497,0.0111070810043453,0.338686702969655,0.650206216026
9,"Bayern",9474147,"Leutenbach",1688,860,828,0.509478672985782,1731,873,858,0.504332755632582,0.0111070810043453,0.338686702969655,0.650206216026
9,"Bayern",9474154,"Neunkirchen a.Brand, M",7753,3805,3948,0.490777763446408,7892,3886,4006,0.492397364419665,0.0111070810043453,0.338686702969655,0.650206216026
9,"Bayern",9474156,"Obertrubach",2149,1106,1043,0.514657980456026,2199,1138,1061,0.517507958162801,0.0111070810043453,0.338686702969655,0.650206216026
9,"Bayern",9474158,"Pinzberg",1854,920,934,0.496224379719525,1896,937,959,0.494198312236287,0.0111070810043453,0.338686702969655,0.650206216026
9,"Bayern",9474160,"Poxdorf",1499,735,764,0.490326884589727,1499,717,782,0.478318879252835,0.0111070810043453,0.338686702969655,0.650206216026
9,"Bayern",9474161,"Pretzfeld, M",2466,1227,1239,0.497566909975669,2458,1210,1248,0.492270138323841,0.0111070810043453,0.338686702969655,0.650206216026
9,"Bayern",9474168,"Unterleinleiter",1240,619,621,0.499193548387097,1228,617,611,0.502442996742671,0.0111070810043453,0.338686702969655,0.650206216026
9,"Bayern",9474171,"Weilersbach",2024,1006,1018,0.49703557312253,2003,999,1004,0.498751872191712,0.0111070810043453,0.338686702969655,0.650206216026
9,"Bayern",9474173,"Weißenohe",1110,545,565,0.490990990990991,1098,548,550,0.499089253187614,0.0111070810043453,0.338686702969655,0.650206216026
9,"Bayern",9474175,"Wiesenthau",1657,832,825,0.502112251056126,1667,834,833,0.500299940011998,0.0111070810043453,0.338686702969655,0.650206216026
9,"Bayern",9474176,"Wiesenttal, M",2514,1257,1257,0.5,2514,1254,1260,0.498806682577566,0.0111070810043453,0.338686702969655,0.650206216026
9,"Bayern",9475112,"Bad Steben, M",3404,1591,1813,0.467391304347826,3444,1603,1841,0.465447154471545,0.0111070810043453,0.338686702969655,0.650206216026
9,"Bayern",9475113,"Berg",2280,1123,1157,0.492543859649123,2364,1189,1175,0.502961082910321,0.0111070810043453,0.338686702969655,0.650206216026
9,"Bayern",9475120,"Döhlau",4012,1989,2023,0.495762711864407,4044,1982,2062,0.490108803165183,0.0111070810043453,0.338686702969655,0.650206216026
9,"Bayern",9475123,"Feilitzsch",2883,1448,1435,0.502254595907041,2847,1443,1404,0.506849315068493,0.0111070810043453,0.338686702969655,0.650206216026
9,"Bayern",9475127,"Gattendorf",1071,518,553,0.483660130718954,1094,529,565,0.483546617915905,0.0111070810043453,0.338686702969655,0.650206216026
9,"Bayern",9475128,"Geroldsgrün",2929,1443,1486,0.492659610788665,2844,1400,1444,0.492264416315049,0.0111070810043453,0.338686702969655,0.650206216026
9,"Bayern",9475136,"Helmbrechts, St",8783,4237,4546,0.482409199590117,8765,4236,4529,0.483285795778665,0.0111070810043453,0.338686702969655,0.650206216026
9,"Bayern",9475137,"Issigau",1050,507,543,0.482857142857143,1093,533,560,0.487648673376029,0.0111070810043453,0.338686702969655,0.650206216026
9,"Bayern",9475141,"Köditz",2545,1244,1301,0.488801571709234,2590,1285,1305,0.496138996138996,0.0111070810043453,0.338686702969655,0.650206216026
9,"Bayern",9475142,"Konradsreuth",3314,1629,1685,0.491550995775498,3313,1629,1684,0.491699366133414,0.0111070810043453,0.338686702969655,0.650206216026
9,"Bayern",9475145,"Leupoldsgrün",1261,606,655,0.480570975416336,1273,609,664,0.478397486252946,0.0111070810043453,0.338686702969655,0.650206216026
9,"Bayern",9475146,"Lichtenberg, St",1099,534,565,0.48589626933576,1089,530,559,0.486685032139578,0.0111070810043453,0.338686702969655,0.650206216026
9,"Bayern",9475154,"Münchberg, St",10424,4964,5460,0.476208749040675,10752,5198,5554,0.48344494047619,0.0111070810043453,0.338686702969655,0.650206216026
9,"Bayern",9475156,"Naila, St",7906,3748,4158,0.47407032633443,8014,3823,4191,0.47704017968555,0.0111070810043453,0.338686702969655,0.650206216026
9,"Bayern",9475158,"Oberkotzau, M",5513,2677,2836,0.485579539270814,5501,2681,2820,0.487365933466642,0.0111070810043453,0.338686702969655,0.650206216026
9,"Bayern",9475161,"Regnitzlosau",2433,1209,1224,0.49691738594328,2464,1216,1248,0.493506493506494,0.0111070810043453,0.338686702969655,0.650206216026
9,"Bayern",9475162,"Rehau, St",9412,4518,4894,0.480025499362516,9419,4553,4866,0.48338464805181,0.0111070810043453,0.338686702969655,0.650206216026
9,"Bayern",9475165,"Schauenstein, St",2030,1006,1024,0.495566502463054,1982,981,1001,0.494954591321897,0.0111070810043453,0.338686702969655,0.650206216026
9,"Bayern",9475168,"Schwarzenbach a.d.Saale, St",7333,3594,3739,0.490113186963044,7181,3493,3688,0.48642250382955,0.0111070810043453,0.338686702969655,0.650206216026
9,"Bayern",9475169,"Schwarzenbach a.Wald, St",4724,2269,2455,0.480313293818798,4688,2268,2420,0.483788395904437,0.0111070810043453,0.338686702969655,0.650206216026
9,"Bayern",9475171,"Selbitz, St",4448,2080,2368,0.467625899280576,4446,2091,2355,0.470310391363023,0.0111070810043453,0.338686702969655,0.650206216026
9,"Bayern",9475174,"Sparneck, M",1683,811,872,0.481877599524658,1637,770,867,0.470372632864997,0.0111070810043453,0.338686702969655,0.650206216026
9,"Bayern",9475175,"Stammbach, M",2407,1161,1246,0.482343165766514,2366,1148,1218,0.485207100591716,0.0111070810043453,0.338686702969655,0.650206216026
9,"Bayern",9475181,"Töpen",1080,531,549,0.491666666666667,1132,559,573,0.493816254416961,0.0111070810043453,0.338686702969655,0.650206216026
9,"Bayern",9475182,"Trogen",1440,692,748,0.480555555555556,1490,716,774,0.480536912751678,0.0111070810043453,0.338686702969655,0.650206216026
9,"Bayern",9475184,"Weißdorf",1226,595,631,0.48531810766721,1187,585,602,0.492839090143218,0.0111070810043453,0.338686702969655,0.650206216026
9,"Bayern",9475189,"Zell im Fichtelgebirge, M",2097,1045,1052,0.498330948974726,2117,1057,1060,0.499291450165328,0.0111070810043453,0.338686702969655,0.650206216026
9,"Bayern",9476145,"Kronach, St",17101,8212,8889,0.480205835916028,17201,8362,8839,0.48613452706238,0.0111070810043453,0.338686702969655,0.650206216026
9,"Bayern",9476146,"Küps, M",7925,3848,4077,0.485552050473186,7924,3944,3980,0.497728419989904,0.0111070810043453,0.338686702969655,0.650206216026
9,"Bayern",9476152,"Ludwigsstadt, St",3551,1745,1806,0.491410870177415,3489,1713,1776,0.490971625107481,0.0111070810043453,0.338686702969655,0.650206216026
9,"Bayern",9476154,"Mitwitz, M",2882,1424,1458,0.494101318528799,2887,1435,1452,0.497055767232421,0.0111070810043453,0.338686702969655,0.650206216026
9,"Bayern",9476159,"Nordhalben, M",1825,885,940,0.484931506849315,1823,878,945,0.481623697202414,0.0111070810043453,0.338686702969655,0.650206216026
9,"Bayern",9476164,"Pressig, M",3998,1969,2029,0.492496248124062,4084,2022,2062,0.495102840352595,0.0111070810043453,0.338686702969655,0.650206216026
9,"Bayern",9476166,"Reichenbach",742,368,374,0.495956873315364,729,359,370,0.492455418381344,0.0111070810043453,0.338686702969655,0.650206216026
9,"Bayern",9476171,"Schneckenlohe",1109,535,574,0.482416591523895,1093,522,571,0.477584629460201,0.0111070810043453,0.338686702969655,0.650206216026
9,"Bayern",9476175,"Steinbach a.Wald",3286,1616,1670,0.491783323189288,3318,1637,1681,0.493369499698614,0.0111070810043453,0.338686702969655,0.650206216026
9,"Bayern",9476177,"Steinwiesen, M",3549,1792,1757,0.504930966469428,3558,1828,1730,0.513771781899944,0.0111070810043453,0.338686702969655,0.650206216026
9,"Bayern",9476178,"Stockheim",5146,2542,2604,0.493975903614458,5076,2512,2564,0.494877856579984,0.0111070810043453,0.338686702969655,0.650206216026
9,"Bayern",9476179,"Tettau, M",2254,1115,1139,0.494676131322094,2252,1129,1123,0.50133214920071,0.0111070810043453,0.338686702969655,0.650206216026
9,"Bayern",9476180,"Teuschnitz, St",2092,1024,1068,0.489483747609943,2019,985,1034,0.487865279841506,0.0111070810043453,0.338686702969655,0.650206216026
9,"Bayern",9476182,"Tschirn",558,258,300,0.462365591397849,531,243,288,0.457627118644068,0.0111070810043453,0.338686702969655,0.650206216026
9,"Bayern",9476183,"Marktrodach, M",3806,1882,1924,0.4944823962165,3828,1928,1900,0.503657262277952,0.0111070810043453,0.338686702969655,0.650206216026
9,"Bayern",9476184,"Wallenfels, St",2884,1416,1468,0.490984743411928,2850,1398,1452,0.490526315789474,0.0111070810043453,0.338686702969655,0.650206216026
9,"Bayern",9476185,"Weißenbrunn",3000,1503,1497,0.501,2981,1499,1482,0.502851392150285,0.0111070810043453,0.338686702969655,0.650206216026
9,"Bayern",9476189,"Wilhelmsthal",3891,1928,1963,0.49550244153174,3903,1932,1971,0.49500384319754,0.0111070810043453,0.338686702969655,0.650206216026
9,"Bayern",9477117,"Grafengehaig, M",946,468,478,0.494714587737844,950,467,483,0.491578947368421,0.0111070810043453,0.338686702969655,0.650206216026
9,"Bayern",9477118,"Guttenberg",538,263,275,0.488847583643123,528,259,269,0.490530303030303,0.0111070810043453,0.338686702969655,0.650206216026
9,"Bayern",9477119,"Harsdorf",1006,493,513,0.490059642147117,1022,502,520,0.49119373776908,0.0111070810043453,0.338686702969655,0.650206216026
9,"Bayern",9477121,"Himmelkron",3435,1641,1794,0.477729257641921,3478,1661,1817,0.47757331799885,0.0111070810043453,0.338686702969655,0.650206216026
9,"Bayern",9477124,"Kasendorf, M",2501,1239,1262,0.495401839264294,2479,1233,1246,0.497377974989915,0.0111070810043453,0.338686702969655,0.650206216026
9,"Bayern",9477127,"Ködnitz",1598,770,828,0.481852315394243,1615,779,836,0.482352941176471,0.0111070810043453,0.338686702969655,0.650206216026
9,"Bayern",9477128,"Kulmbach, GKSt",26521,12771,13750,0.481542928245541,26637,12741,13896,0.47831963058903,0.0111070810043453,0.338686702969655,0.650206216026
9,"Bayern",9477129,"Kupferberg, St",1052,531,521,0.504752851711027,1040,526,514,0.505769230769231,0.0111070810043453,0.338686702969655,0.650206216026
9,"Bayern",9477135,"Ludwigschorgast, M",1001,481,520,0.480519480519481,973,473,500,0.486125385405961,0.0111070810043453,0.338686702969655,0.650206216026
9,"Bayern",9477136,"Mainleus, M",6502,3219,3283,0.495078437403876,6464,3193,3271,0.493966584158416,0.0111070810043453,0.338686702969655,0.650206216026
9,"Bayern",9477138,"Marktleugast, M",3340,1667,1673,0.499101796407186,3266,1640,1626,0.502143294549908,0.0111070810043453,0.338686702969655,0.650206216026
9,"Bayern",9477139,"Marktschorgast, M",1438,697,741,0.484700973574409,1460,719,741,0.492465753424658,0.0111070810043453,0.338686702969655,0.650206216026
9,"Bayern",9477142,"Neudrossenfeld",3879,1918,1961,0.494457334364527,3917,1942,1975,0.495787592545315,0.0111070810043453,0.338686702969655,0.650206216026
9,"Bayern",9477143,"Neuenmarkt",3034,1473,1561,0.485497692814766,3094,1490,1604,0.481577246283129,0.0111070810043453,0.338686702969655,0.650206216026
9,"Bayern",9477148,"Presseck, M",1900,932,968,0.490526315789474,1899,936,963,0.492890995260663,0.0111070810043453,0.338686702969655,0.650206216026
9,"Bayern",9477151,"Rugendorf",1026,512,514,0.499025341130604,1012,504,508,0.49802371541502,0.0111070810043453,0.338686702969655,0.650206216026
9,"Bayern",9477156,"Stadtsteinach, St",3239,1567,1672,0.483791293609139,3295,1598,1697,0.484977238239757,0.0111070810043453,0.338686702969655,0.650206216026
9,"Bayern",9477157,"Thurnau, M",4285,2083,2202,0.486114352392065,4297,2101,2196,0.488945776122876,0.0111070810043453,0.338686702969655,0.650206216026
9,"Bayern",9477158,"Trebgast",1634,839,795,0.513463892288862,1615,835,780,0.51702786377709,0.0111070810043453,0.338686702969655,0.650206216026
9,"Bayern",9477159,"Untersteinach",1844,908,936,0.492407809110629,1836,892,944,0.485838779956427,0.0111070810043453,0.338686702969655,0.650206216026
9,"Bayern",9477163,"Wirsberg, M",1839,884,955,0.480696030451332,1907,906,1001,0.475091767173571,0.0111070810043453,0.338686702969655,0.650206216026
9,"Bayern",9477164,"Wonsees, M",1152,568,584,0.493055555555556,1142,578,564,0.506129597197898,0.0111070810043453,0.338686702969655,0.650206216026
9,"Bayern",9478111,"Altenkunstadt",5471,2644,2827,0.483275452385304,5416,2620,2796,0.483751846381093,0.0111070810043453,0.338686702969655,0.650206216026
9,"Bayern",9478116,"Burgkunstadt, St",6568,3148,3420,0.479293544457978,6573,3158,3415,0.480450327095695,0.0111070810043453,0.338686702969655,0.650206216026
9,"Bayern",9478120,"Ebensfeld, M",5593,2809,2784,0.502234936527803,5631,2844,2787,0.50506126798082,0.0111070810043453,0.338686702969655,0.650206216026
9,"Bayern",9478127,"Hochstadt a.Main",1678,814,864,0.485101311084625,1683,816,867,0.484848484848485,0.0111070810043453,0.338686702969655,0.650206216026
9,"Bayern",9478139,"Lichtenfels, St",20154,9854,10300,0.488935198967947,20503,10052,10451,0.490269716626835,0.0111070810043453,0.338686702969655,0.650206216026
9,"Bayern",9478143,"Marktgraitz, M",1243,596,647,0.479485116653258,1280,619,661,0.48359375,0.0111070810043453,0.338686702969655,0.650206216026
9,"Bayern",9478144,"Marktzeuln, M",1612,789,823,0.489454094292804,1638,821,817,0.501221001221001,0.0111070810043453,0.338686702969655,0.650206216026
9,"Bayern",9478145,"Michelau i.OFr.",6486,3196,3290,0.492753623188406,6505,3212,3293,0.493774019984627,0.0111070810043453,0.338686702969655,0.650206216026
9,"Bayern",9478155,"Redwitz a.d.Rodach",3437,1668,1769,0.485306953738726,3396,1640,1756,0.482921083627797,0.0111070810043453,0.338686702969655,0.650206216026
9,"Bayern",9478165,"Bad Staffelstein, St",10306,5137,5169,0.498447506307006,10636,5295,5341,0.497837532907108,0.0111070810043453,0.338686702969655,0.650206216026
9,"Bayern",9478176,"Weismain, St",4697,2339,2358,0.497977432403662,4691,2346,2345,0.500106587081646,0.0111070810043453,0.338686702969655,0.650206216026
9,"Bayern",9479111,"Bad Alexandersbad",1124,505,619,0.449288256227758,1187,540,647,0.454928390901432,0.0111070810043453,0.338686702969655,0.650206216026
9,"Bayern",9479112,"Arzberg, St",5370,2586,2784,0.481564245810056,5437,2627,2810,0.483170866286555,0.0111070810043453,0.338686702969655,0.650206216026
9,"Bayern",9479126,"Höchstädt i.Fichtelgebirge",1167,582,585,0.498714652956298,1169,576,593,0.492728828058169,0.0111070810043453,0.338686702969655,0.650206216026
9,"Bayern",9479127,"Hohenberg a.d.Eger, St",1477,717,760,0.485443466486121,1464,702,762,0.479508196721311,0.0111070810043453,0.338686702969655,0.650206216026
9,"Bayern",9479129,"Kirchenlamitz, St",3408,1679,1729,0.492664319248826,3479,1715,1764,0.492957746478873,0.0111070810043453,0.338686702969655,0.650206216026
9,"Bayern",9479135,"Marktleuthen, St",3249,1573,1676,0.484148968913512,3334,1648,1686,0.494301139772046,0.0111070810043453,0.338686702969655,0.650206216026
9,"Bayern",9479136,"Marktredwitz, GKSt",17262,8077,9185,0.467906383964778,17045,7958,9087,0.466881783514227,0.0111070810043453,0.338686702969655,0.650206216026
9,"Bayern",9479138,"Nagel",1812,846,966,0.466887417218543,1802,834,968,0.462819089900111,0.0111070810043453,0.338686702969655,0.650206216026
9,"Bayern",9479145,"Röslau",2262,1095,1167,0.484084880636605,2268,1114,1154,0.491181657848325,0.0111070810043453,0.338686702969655,0.650206216026
9,"Bayern",9479147,"Schirnding, M",1311,644,667,0.491228070175439,1274,639,635,0.501569858712716,0.0111070810043453,0.338686702969655,0.650206216026
9,"Bayern",9479150,"Schönwald, St",3385,1581,1804,0.467060561299852,3387,1594,1793,0.4706229701801,0.0111070810043453,0.338686702969655,0.650206216026
9,"Bayern",9479152,"Selb, GKSt",15343,7326,8017,0.477481587694714,15763,7547,8216,0.478779420161137,0.0111070810043453,0.338686702969655,0.650206216026
9,"Bayern",9479158,"Thiersheim, M",1883,930,953,0.493892724375996,1882,939,943,0.498937300743889,0.0111070810043453,0.338686702969655,0.650206216026
9,"Bayern",9479159,"Thierstein, M",1163,565,598,0.485812553740327,1190,588,602,0.494117647058824,0.0111070810043453,0.338686702969655,0.650206216026
9,"Bayern",9479161,"Tröstau",2455,1206,1249,0.491242362525458,2482,1235,1247,0.497582594681708,0.0111070810043453,0.338686702969655,0.650206216026
9,"Bayern",9479166,"Weißenstadt, St",3323,1614,1709,0.485705687631658,3270,1591,1679,0.486544342507645,0.0111070810043453,0.338686702969655,0.650206216026
9,"Bayern",9479169,"Wunsiedel, St",9447,4578,4869,0.484598285169895,9349,4521,4828,0.483581131671837,0.0111070810043453,0.338686702969655,0.650206216026
9,"Bayern",9561000,"Ansbach",39600,18623,20977,0.470277777777778,40296,19164,21132,0.475580702799285,0.0111070810043453,0.338686702969655,0.650206216026
9,"Bayern",9562000,"Erlangen",104312,51026,53286,0.489167114042488,106326,52243,54083,0.491347365649042,0.0111070810043453,0.338686702969655,0.650206216026
9,"Bayern",9563000,"Fürth",116640,56252,60388,0.482270233196159,116317,56583,59734,0.486455118340397,0.0111070810043453,0.338686702969655,0.650206216026
9,"Bayern",9564000,"Nürnberg",490085,235495,254590,0.480518685534142,510602,247939,262663,0.485581725100959,0.0111070810043453,0.338686702969655,0.650206216026
9,"Bayern",9565000,"Schwabach",38610,18525,20085,0.47979797979798,39112,18843,20269,0.481770300674985,0.0111070810043453,0.338686702969655,0.650206216026
9,"Bayern",9571111,"Adelshofen",970,493,477,0.508247422680412,941,470,471,0.499468650371945,0.0111070810043453,0.338686702969655,0.650206216026
9,"Bayern",9571113,"Arberg, M",2288,1157,1131,0.505681818181818,2291,1162,1129,0.507202095154954,0.0111070810043453,0.338686702969655,0.650206216026
9,"Bayern",9571114,"Aurach",2833,1413,1420,0.498764560536534,2886,1441,1445,0.499306999306999,0.0111070810043453,0.338686702969655,0.650206216026
9,"Bayern",9571115,"Bechhofen, M",5851,2991,2860,0.511194667578192,5886,3024,2862,0.513761467889908,0.0111070810043453,0.338686702969655,0.650206216026
9,"Bayern",9571122,"Bruckberg",1320,724,596,0.548484848484848,1292,702,590,0.543343653250774,0.0111070810043453,0.338686702969655,0.650206216026
9,"Bayern",9571125,"Buch a.Wald",969,498,471,0.513931888544892,933,480,453,0.514469453376206,0.0111070810043453,0.338686702969655,0.650206216026
9,"Bayern",9571127,"Burgoberbach",3218,1598,1620,0.496581727781231,3306,1656,1650,0.500907441016334,0.0111070810043453,0.338686702969655,0.650206216026
9,"Bayern",9571128,"Burk",1118,568,550,0.508050089445438,1130,575,555,0.508849557522124,0.0111070810043453,0.338686702969655,0.650206216026
9,"Bayern",9571130,"Colmberg, M",1974,968,1006,0.490374873353597,2013,989,1024,0.49130650769995,0.0111070810043453,0.338686702969655,0.650206216026
9,"Bayern",9571132,"Dentlein a.Forst, M",2345,1168,1177,0.498081023454158,2326,1150,1176,0.494411006018917,0.0111070810043453,0.338686702969655,0.650206216026
9,"Bayern",9571134,"Diebach",1097,562,535,0.512306289881495,1098,557,541,0.507285974499089,0.0111070810043453,0.338686702969655,0.650206216026
9,"Bayern",9571135,"Dietenhofen, M",5513,2781,2732,0.504444041356793,5582,2809,2773,0.503224650662845,0.0111070810043453,0.338686702969655,0.650206216026
9,"Bayern",9571136,"Dinkelsbühl, GKSt",11256,5484,5772,0.487206823027719,11546,5619,5927,0.486662047462325,0.0111070810043453,0.338686702969655,0.650206216026
9,"Bayern",9571137,"Dombühl, M",1635,841,794,0.514373088685015,1613,827,786,0.512709237445753,0.0111070810043453,0.338686702969655,0.650206216026
9,"Bayern",9571139,"Dürrwangen, M",2551,1274,1277,0.499411995295962,2547,1285,1262,0.504515115822536,0.0111070810043453,0.338686702969655,0.650206216026
9,"Bayern",9571141,"Ehingen",1979,1017,962,0.513895907023749,1971,1001,970,0.507864028411974,0.0111070810043453,0.338686702969655,0.650206216026
9,"Bayern",9571145,"Feuchtwangen, St",11984,5913,6071,0.493407877169559,12143,6063,6080,0.499300008235197,0.0111070810043453,0.338686702969655,0.650206216026
9,"Bayern",9571146,"Flachslanden, M",2361,1197,1164,0.506988564167726,2386,1213,1173,0.508382229673093,0.0111070810043453,0.338686702969655,0.650206216026
9,"Bayern",9571152,"Gebsattel",1777,911,866,0.512661789532921,1780,931,849,0.523033707865169,0.0111070810043453,0.338686702969655,0.650206216026
9,"Bayern",9571154,"Gerolfingen",1003,505,498,0.503489531405783,990,485,505,0.48989898989899,0.0111070810043453,0.338686702969655,0.650206216026
9,"Bayern",9571155,"Geslau",1364,691,673,0.506598240469208,1361,687,674,0.504775900073475,0.0111070810043453,0.338686702969655,0.650206216026
9,"Bayern",9571165,"Heilsbronn, St",9023,4406,4617,0.488307658206805,9020,4412,4608,0.489135254988914,0.0111070810043453,0.338686702969655,0.650206216026
9,"Bayern",9571166,"Herrieden, St",7491,3694,3797,0.493125083433453,7519,3735,3784,0.496741587977125,0.0111070810043453,0.338686702969655,0.650206216026
9,"Bayern",9571169,"Insingen",1127,586,541,0.519964507542147,1130,591,539,0.523008849557522,0.0111070810043453,0.338686702969655,0.650206216026
9,"Bayern",9571170,"Langfurth",2134,1068,1066,0.500468603561387,2108,1045,1063,0.49573055028463,0.0111070810043453,0.338686702969655,0.650206216026
9,"Bayern",9571171,"Lehrberg, M",3057,1517,1540,0.496238141969251,3098,1555,1543,0.501936733376372,0.0111070810043453,0.338686702969655,0.650206216026
9,"Bayern",9571174,"Leutershausen, St",5481,2723,2758,0.496807151979566,5494,2709,2785,0.493083363669458,0.0111070810043453,0.338686702969655,0.650206216026
9,"Bayern",9571175,"Lichtenau, M",3722,1843,1879,0.495163890381515,3750,1839,1911,0.4904,0.0111070810043453,0.338686702969655,0.650206216026
9,"Bayern",9571177,"Merkendorf, St",2714,1369,1345,0.504421518054532,2736,1404,1332,0.513157894736842,0.0111070810043453,0.338686702969655,0.650206216026
9,"Bayern",9571178,"Mitteleschenbach",1582,779,803,0.492414664981037,1594,775,819,0.486198243412798,0.0111070810043453,0.338686702969655,0.650206216026
9,"Bayern",9571179,"Mönchsroth",1605,781,824,0.486604361370716,1591,766,825,0.481458202388435,0.0111070810043453,0.338686702969655,0.650206216026
9,"Bayern",9571180,"Neuendettelsau",7435,3450,3985,0.464021519838601,7797,3568,4229,0.457611902013595,0.0111070810043453,0.338686702969655,0.650206216026
9,"Bayern",9571181,"Neusitz",2012,983,1029,0.488568588469185,2021,990,1031,0.489856506679861,0.0111070810043453,0.338686702969655,0.650206216026
9,"Bayern",9571183,"Oberdachstetten",1604,768,836,0.478802992518703,1648,804,844,0.487864077669903,0.0111070810043453,0.338686702969655,0.650206216026
9,"Bayern",9571188,"Ohrenbach",607,307,300,0.505766062602965,587,291,296,0.495741056218058,0.0111070810043453,0.338686702969655,0.650206216026
9,"Bayern",9571189,"Ornbau, St",1585,786,799,0.49589905362776,1602,803,799,0.501248439450687,0.0111070810043453,0.338686702969655,0.650206216026
9,"Bayern",9571190,"Petersaurach",4880,2453,2427,0.502663934426229,4942,2476,2466,0.501011736139215,0.0111070810043453,0.338686702969655,0.650206216026
9,"Bayern",9571192,"Röckingen",735,369,366,0.502040816326531,734,377,357,0.513623978201635,0.0111070810043453,0.338686702969655,0.650206216026
9,"Bayern",9571193,"Rothenburg ob der Tauber, GKSt",10918,5239,5679,0.479849789338707,10930,5283,5647,0.483348581884721,0.0111070810043453,0.338686702969655,0.650206216026
9,"Bayern",9571194,"Rügland",1211,589,622,0.486374896779521,1252,611,641,0.488019169329073,0.0111070810043453,0.338686702969655,0.650206216026
9,"Bayern",9571196,"Sachsen b.Ansbach",3163,1556,1607,0.491938033512488,3269,1624,1645,0.49678800856531,0.0111070810043453,0.338686702969655,0.650206216026
9,"Bayern",9571198,"Schillingsfürst, St",2787,1341,1446,0.481162540365985,2747,1311,1436,0.477247906807426,0.0111070810043453,0.338686702969655,0.650206216026
9,"Bayern",9571199,"Schnelldorf",3504,1789,1715,0.510559360730594,3480,1785,1695,0.512931034482759,0.0111070810043453,0.338686702969655,0.650206216026
9,"Bayern",9571200,"Schopfloch, M",2838,1442,1396,0.508104298801973,2842,1434,1408,0.5045742434905,0.0111070810043453,0.338686702969655,0.650206216026
9,"Bayern",9571205,"Steinsfeld",1206,609,597,0.504975124378109,1217,616,601,0.506162695152013,0.0111070810043453,0.338686702969655,0.650206216026
9,"Bayern",9571208,"Unterschwaningen",884,449,435,0.507918552036199,869,441,428,0.507479861910242,0.0111070810043453,0.338686702969655,0.650206216026
9,"Bayern",9571214,"Wassertrüdingen, St",5919,2922,2997,0.493664470349721,5916,2941,2975,0.497126436781609,0.0111070810043453,0.338686702969655,0.650206216026
9,"Bayern",9571216,"Weidenbach, M",2187,1105,1082,0.505258344764518,2177,1126,1051,0.517225539733578,0.0111070810043453,0.338686702969655,0.650206216026
9,"Bayern",9571217,"Weihenzell",2802,1414,1388,0.50463954318344,2816,1424,1392,0.505681818181818,0.0111070810043453,0.338686702969655,0.650206216026
9,"Bayern",9571218,"Weiltingen, M",1383,702,681,0.507592190889371,1385,715,670,0.516245487364621,0.0111070810043453,0.338686702969655,0.650206216026
9,"Bayern",9571222,"Wettringen",952,492,460,0.516806722689076,913,473,440,0.518072289156627,0.0111070810043453,0.338686702969655,0.650206216026
9,"Bayern",9571223,"Wieseth",1377,693,684,0.503267973856209,1412,717,695,0.507790368271955,0.0111070810043453,0.338686702969655,0.650206216026
9,"Bayern",9571224,"Wilburgstetten",2088,1050,1038,0.502873563218391,2080,1052,1028,0.505769230769231,0.0111070810043453,0.338686702969655,0.650206216026
9,"Bayern",9571225,"Windelsbach",1073,559,514,0.520969245107176,1075,549,526,0.510697674418605,0.0111070810043453,0.338686702969655,0.650206216026
9,"Bayern",9571226,"Windsbach, St",6046,3116,2930,0.515382070790605,6028,3154,2874,0.523224950232249,0.0111070810043453,0.338686702969655,0.650206216026
9,"Bayern",9571227,"Wittelshofen",1260,645,615,0.511904761904762,1252,639,613,0.51038338658147,0.0111070810043453,0.338686702969655,0.650206216026
9,"Bayern",9571228,"Wörnitz",1694,851,843,0.502361275088548,1657,832,825,0.502112251056126,0.0111070810043453,0.338686702969655,0.650206216026
9,"Bayern",9571229,"Wolframs-Eschenbach, St",2770,1359,1411,0.490613718411552,2848,1399,1449,0.49122191011236,0.0111070810043453,0.338686702969655,0.650206216026
9,"Bayern",9572111,"Adelsdorf",7318,3700,3618,0.505602623667669,7215,3648,3567,0.505613305613306,0.0111070810043453,0.338686702969655,0.650206216026
9,"Bayern",9572114,"Aurachtal",3003,1518,1485,0.505494505494505,3059,1555,1504,0.508336057535142,0.0111070810043453,0.338686702969655,0.650206216026
9,"Bayern",9572115,"Baiersdorf, St",7389,3623,3766,0.49032345378265,7303,3618,3685,0.495412844036697,0.0111070810043453,0.338686702969655,0.650206216026
9,"Bayern",9572119,"Bubenreuth",4445,2161,2284,0.486164229471316,4518,2210,2308,0.489154493138557,0.0111070810043453,0.338686702969655,0.650206216026
9,"Bayern",9572120,"Buckenhof",3268,1599,1669,0.489290085679315,3346,1647,1699,0.492229527794381,0.0111070810043453,0.338686702969655,0.650206216026
9,"Bayern",9572121,"Eckental, M",13934,6855,7079,0.491962107076216,13960,6852,7108,0.490830945558739,0.0111070810043453,0.338686702969655,0.650206216026
9,"Bayern",9572126,"Gremsdorf",1545,900,645,0.58252427184466,1560,910,650,0.583333333333333,0.0111070810043453,0.338686702969655,0.650206216026
9,"Bayern",9572127,"Großenseebach",2351,1130,1221,0.480646533390047,2432,1170,1262,0.481085526315789,0.0111070810043453,0.338686702969655,0.650206216026
9,"Bayern",9572130,"Hemhofen",5193,2528,2665,0.486809166185249,5152,2527,2625,0.490489130434783,0.0111070810043453,0.338686702969655,0.650206216026
9,"Bayern",9572131,"Heroldsberg, M",8285,4007,4278,0.483645141822571,8262,3981,4281,0.481844589687727,0.0111070810043453,0.338686702969655,0.650206216026
9,"Bayern",9572132,"Herzogenaurach, St",22346,11199,11147,0.501163519198067,23232,11670,11562,0.502324380165289,0.0111070810043453,0.338686702969655,0.650206216026
9,"Bayern",9572133,"Heßdorf",3386,1709,1677,0.504725339633786,3489,1779,1710,0.509888220120378,0.0111070810043453,0.338686702969655,0.650206216026
9,"Bayern",9572135,"Höchstadt a.d.Aisch, St",13145,6537,6608,0.497299353366299,13216,6564,6652,0.496670702179177,0.0111070810043453,0.338686702969655,0.650206216026
9,"Bayern",9572137,"Kalchreuth",2915,1396,1519,0.478902229845626,3009,1464,1545,0.48654037886341,0.0111070810043453,0.338686702969655,0.650206216026
9,"Bayern",9572139,"Lonnerstadt, M",1986,994,992,0.500503524672709,1961,985,976,0.502294747577766,0.0111070810043453,0.338686702969655,0.650206216026
9,"Bayern",9572141,"Marloffstein",1546,778,768,0.503234152652005,1597,816,781,0.510958046336882,0.0111070810043453,0.338686702969655,0.650206216026
9,"Bayern",9572142,"Möhrendorf",4508,2256,2252,0.500443655723159,4534,2279,2255,0.502646669607411,0.0111070810043453,0.338686702969655,0.650206216026
9,"Bayern",9572143,"Mühlhausen, M",1673,839,834,0.501494321578004,1698,862,836,0.507656065959953,0.0111070810043453,0.338686702969655,0.650206216026
9,"Bayern",9572147,"Oberreichenbach",1237,615,622,0.49717057396928,1224,619,605,0.505718954248366,0.0111070810043453,0.338686702969655,0.650206216026
9,"Bayern",9572149,"Röttenbach",4607,2246,2361,0.487518992836987,4608,2272,2336,0.493055555555556,0.0111070810043453,0.338686702969655,0.650206216026
9,"Bayern",9572154,"Spardorf",1883,908,975,0.482209240573553,1951,953,998,0.488467452588416,0.0111070810043453,0.338686702969655,0.650206216026
9,"Bayern",9572158,"Uttenreuth",4848,2381,2467,0.491130363036304,4719,2344,2375,0.496715405806315,0.0111070810043453,0.338686702969655,0.650206216026
9,"Bayern",9572159,"Vestenbergsgreuth, M",1516,760,756,0.50131926121372,1535,779,756,0.507491856677524,0.0111070810043453,0.338686702969655,0.650206216026
9,"Bayern",9572160,"Wachenroth, M",2129,1106,1023,0.51949271958666,2188,1136,1052,0.519195612431444,0.0111070810043453,0.338686702969655,0.650206216026
9,"Bayern",9572164,"Weisendorf, M",6291,3105,3186,0.493562231759657,6281,3095,3186,0.492755930584302,0.0111070810043453,0.338686702969655,0.650206216026
9,"Bayern",9573111,"Ammerndorf, M",2103,1053,1050,0.500713266761769,2119,1052,1067,0.496460594620104,0.0111070810043453,0.338686702969655,0.650206216026
9,"Bayern",9573114,"Cadolzburg, M",10323,5073,5250,0.491426910781749,10397,5118,5279,0.492257381937097,0.0111070810043453,0.338686702969655,0.650206216026
9,"Bayern",9573115,"Großhabersdorf",4053,1993,2060,0.491734517641253,4162,2050,2112,0.4925516578568,0.0111070810043453,0.338686702969655,0.650206216026
9,"Bayern",9573120,"Langenzenn, St",10303,4949,5354,0.480345530428031,10475,5084,5391,0.485346062052506,0.0111070810043453,0.338686702969655,0.650206216026
9,"Bayern",9573122,"Oberasbach, St",17175,8252,8923,0.480465793304221,17252,8290,8962,0.480523997217714,0.0111070810043453,0.338686702969655,0.650206216026
9,"Bayern",9573123,"Obermichelbach",3141,1576,1565,0.501751034702324,3145,1574,1571,0.500476947535771,0.0111070810043453,0.338686702969655,0.650206216026
9,"Bayern",9573124,"Puschendorf",2141,992,1149,0.463334890238206,2125,986,1139,0.464,0.0111070810043453,0.338686702969655,0.650206216026
9,"Bayern",9573125,"Roßtal, M",9730,4761,4969,0.489311408016444,9687,4756,4931,0.49096727573036,0.0111070810043453,0.338686702969655,0.650206216026
9,"Bayern",9573126,"Seukendorf",3067,1524,1543,0.496902510596674,3097,1528,1569,0.493380690991282,0.0111070810043453,0.338686702969655,0.650206216026
9,"Bayern",9573127,"Stein, St",13567,6392,7175,0.471143215154419,13902,6592,7310,0.47417637749964,0.0111070810043453,0.338686702969655,0.650206216026
9,"Bayern",9573129,"Tuchenbach",1343,673,670,0.501116902457185,1334,671,663,0.502998500749625,0.0111070810043453,0.338686702969655,0.650206216026
9,"Bayern",9573130,"Veitsbronn",6215,3023,3192,0.486403861625101,6217,3028,3189,0.487051632620235,0.0111070810043453,0.338686702969655,0.650206216026
9,"Bayern",9573133,"Wilhermsdorf, M",4918,2449,2469,0.497966653111021,5053,2549,2504,0.504452800316644,0.0111070810043453,0.338686702969655,0.650206216026
9,"Bayern",9573134,"Zirndorf, St",25180,12148,13032,0.482446386020651,26663,13523,13140,0.507182237557664,0.0111070810043453,0.338686702969655,0.650206216026
9,"Bayern",9574111,"Alfeld",1109,555,554,0.500450856627592,1096,558,538,0.509124087591241,0.0111070810043453,0.338686702969655,0.650206216026
9,"Bayern",9574112,"Altdorf b.Nürnberg, St",15062,7371,7691,0.489377240738282,15301,7495,7806,0.4898372655382,0.0111070810043453,0.338686702969655,0.650206216026
9,"Bayern",9574117,"Burgthann",11188,5611,5577,0.501519485162674,11140,5509,5631,0.494524236983842,0.0111070810043453,0.338686702969655,0.650206216026
9,"Bayern",9574120,"Engelthal",1137,552,585,0.485488126649077,1126,544,582,0.483126110124334,0.0111070810043453,0.338686702969655,0.650206216026
9,"Bayern",9574123,"Feucht, M",12420,6063,6357,0.488164251207729,13357,6791,6566,0.508422549973797,0.0111070810043453,0.338686702969655,0.650206216026
9,"Bayern",9574128,"Happurg",3676,1797,1879,0.488846572361262,3647,1790,1857,0.490814367973677,0.0111070810043453,0.338686702969655,0.650206216026
9,"Bayern",9574129,"Hartenstein",1362,713,649,0.523494860499266,1390,731,659,0.52589928057554,0.0111070810043453,0.338686702969655,0.650206216026
9,"Bayern",9574131,"Henfenfeld",1875,916,959,0.488533333333333,1867,937,930,0.50187466523835,0.0111070810043453,0.338686702969655,0.650206216026
9,"Bayern",9574132,"Hersbruck, St",12114,5800,6314,0.478784877001816,12235,5944,6291,0.485819370657949,0.0111070810043453,0.338686702969655,0.650206216026
9,"Bayern",9574135,"Kirchensittenbach",2052,1023,1029,0.498538011695906,2184,1083,1101,0.495879120879121,0.0111070810043453,0.338686702969655,0.650206216026
9,"Bayern",9574138,"Lauf a.d.Pegnitz, St",25716,12380,13336,0.481412350287759,26238,12670,13568,0.482887415199329,0.0111070810043453,0.338686702969655,0.650206216026
9,"Bayern",9574139,"Leinburg",6336,3140,3196,0.495580808080808,6431,3190,3241,0.496034831285959,0.0111070810043453,0.338686702969655,0.650206216026
9,"Bayern",9574140,"Neuhaus a.d.Pegnitz, M",2836,1408,1428,0.496473906911142,2802,1390,1412,0.496074232690935,0.0111070810043453,0.338686702969655,0.650206216026
9,"Bayern",9574141,"Neunkirchen a.Sand",4617,2273,2344,0.492311024474767,4611,2261,2350,0.490349165040121,0.0111070810043453,0.338686702969655,0.650206216026
9,"Bayern",9574145,"Offenhausen",1567,779,788,0.497128270580728,1554,768,786,0.494208494208494,0.0111070810043453,0.338686702969655,0.650206216026
9,"Bayern",9574146,"Ottensoos",2045,1030,1015,0.503667481662592,2087,1062,1025,0.508864398658361,0.0111070810043453,0.338686702969655,0.650206216026
9,"Bayern",9574147,"Pommelsbrunn",5189,2542,2647,0.489882443630757,5269,2611,2658,0.495539950654773,0.0111070810043453,0.338686702969655,0.650206216026
9,"Bayern",9574150,"Reichenschwand",2270,1096,1174,0.482819383259912,2288,1105,1183,0.482954545454545,0.0111070810043453,0.338686702969655,0.650206216026
9,"Bayern",9574152,"Röthenbach a.d.Pegnitz, St",11791,5656,6135,0.479687897548978,11792,5650,6142,0.479138398914518,0.0111070810043453,0.338686702969655,0.650206216026
9,"Bayern",9574154,"Rückersdorf",4410,2146,2264,0.486621315192744,4438,2155,2283,0.485579089680036,0.0111070810043453,0.338686702969655,0.650206216026
9,"Bayern",9574155,"Schnaittach, M",7924,3918,4006,0.49444724886421,7949,3920,4029,0.493143791671908,0.0111070810043453,0.338686702969655,0.650206216026
9,"Bayern",9574156,"Schwaig b.Nürnberg",8347,3974,4373,0.476099197316401,8238,3916,4322,0.475358096625395,0.0111070810043453,0.338686702969655,0.650206216026
9,"Bayern",9574157,"Schwarzenbruck",8376,4084,4292,0.487583572110793,8397,4136,4261,0.492556865547219,0.0111070810043453,0.338686702969655,0.650206216026
9,"Bayern",9574158,"Simmelsdorf",3129,1574,1555,0.503036113774369,3138,1599,1539,0.509560229445507,0.0111070810043453,0.338686702969655,0.650206216026
9,"Bayern",9574160,"Velden, St",1785,890,895,0.49859943977591,1748,875,873,0.500572082379863,0.0111070810043453,0.338686702969655,0.650206216026
9,"Bayern",9574161,"Vorra",1691,823,868,0.486694263749261,1735,826,909,0.476080691642651,0.0111070810043453,0.338686702969655,0.650206216026
9,"Bayern",9574164,"Winkelhaid",4055,1944,2111,0.47940813810111,4151,2009,2142,0.48397976391231,0.0111070810043453,0.338686702969655,0.650206216026
9,"Bayern",9575112,"Bad Windsheim, St",11941,5701,6240,0.477430700946319,11814,5737,6077,0.485610292872863,0.0111070810043453,0.338686702969655,0.650206216026
9,"Bayern",9575113,"Baudenbach, M",1163,599,564,0.515047291487532,1190,606,584,0.509243697478992,0.0111070810043453,0.338686702969655,0.650206216026
9,"Bayern",9575115,"Burgbernheim, St",2963,1466,1497,0.494768815389808,2912,1439,1473,0.494162087912088,0.0111070810043453,0.338686702969655,0.650206216026
9,"Bayern",9575116,"Burghaslach, M",2461,1210,1251,0.491670052824055,2472,1220,1252,0.493527508090615,0.0111070810043453,0.338686702969655,0.650206216026
9,"Bayern",9575117,"Dachsbach, M",1703,846,857,0.496770405167352,1780,896,884,0.503370786516854,0.0111070810043453,0.338686702969655,0.650206216026
9,"Bayern",9575118,"Diespeck",3596,1796,1800,0.49944382647386,3676,1841,1835,0.500816104461371,0.0111070810043453,0.338686702969655,0.650206216026
9,"Bayern",9575119,"Dietersheim",2159,1082,1077,0.501157943492358,2173,1087,1086,0.500230096640589,0.0111070810043453,0.338686702969655,0.650206216026
9,"Bayern",9575121,"Emskirchen, M",5949,2999,2950,0.504118339216675,6019,3030,2989,0.503405881375644,0.0111070810043453,0.338686702969655,0.650206216026
9,"Bayern",9575122,"Ergersheim",1127,586,541,0.519964507542147,1111,584,527,0.525652565256526,0.0111070810043453,0.338686702969655,0.650206216026
9,"Bayern",9575124,"Gallmersgarten",788,387,401,0.491116751269036,791,384,407,0.485461441213654,0.0111070810043453,0.338686702969655,0.650206216026
9,"Bayern",9575125,"Gerhardshofen",2507,1262,1245,0.503390506581572,2546,1299,1247,0.510212097407698,0.0111070810043453,0.338686702969655,0.650206216026
9,"Bayern",9575127,"Gollhofen",836,423,413,0.505980861244019,823,421,402,0.511543134872418,0.0111070810043453,0.338686702969655,0.650206216026
9,"Bayern",9575128,"Gutenstetten",1293,654,639,0.505800464037123,1373,690,683,0.502549162418063,0.0111070810043453,0.338686702969655,0.650206216026
9,"Bayern",9575129,"Hagenbüchach",1244,633,611,0.508842443729904,1276,647,629,0.50705329153605,0.0111070810043453,0.338686702969655,0.650206216026
9,"Bayern",9575130,"Hemmersheim",702,360,342,0.512820512820513,678,347,331,0.511799410029499,0.0111070810043453,0.338686702969655,0.650206216026
9,"Bayern",9575133,"Illesheim",954,456,498,0.477987421383648,905,436,469,0.481767955801105,0.0111070810043453,0.338686702969655,0.650206216026
9,"Bayern",9575134,"Ippesheim, M",1132,561,571,0.495583038869258,1078,540,538,0.500927643784787,0.0111070810043453,0.338686702969655,0.650206216026
9,"Bayern",9575135,"Ipsheim, M",2103,1059,1044,0.503566333808845,2125,1060,1065,0.498823529411765,0.0111070810043453,0.338686702969655,0.650206216026
9,"Bayern",9575138,"Langenfeld",1019,515,504,0.505397448478901,1018,516,502,0.506876227897839,0.0111070810043453,0.338686702969655,0.650206216026
9,"Bayern",9575143,"Marktbergel, M",1528,769,759,0.503272251308901,1533,778,755,0.507501630789302,0.0111070810043453,0.338686702969655,0.650206216026
9,"Bayern",9575144,"Markt Bibart, M",1837,929,908,0.505715841045182,1865,949,916,0.508847184986595,0.0111070810043453,0.338686702969655,0.650206216026
9,"Bayern",9575145,"Markt Erlbach, M",5460,2760,2700,0.505494505494505,5519,2794,2725,0.506251132451531,0.0111070810043453,0.338686702969655,0.650206216026
9,"Bayern",9575146,"Markt Nordheim, M",1137,569,568,0.500439753737907,1098,552,546,0.502732240437158,0.0111070810043453,0.338686702969655,0.650206216026
9,"Bayern",9575147,"Markt Taschendorf, M",1007,502,505,0.498510427010924,1025,528,497,0.515121951219512,0.0111070810043453,0.338686702969655,0.650206216026
9,"Bayern",9575150,"Münchsteinach",1383,704,679,0.509038322487346,1411,726,685,0.514528703047484,0.0111070810043453,0.338686702969655,0.650206216026
9,"Bayern",9575152,"Neuhof a.d.Zenn, M",2065,1049,1016,0.507990314769976,2033,1034,999,0.508607968519429,0.0111070810043453,0.338686702969655,0.650206216026
9,"Bayern",9575153,"Neustadt a.d.Aisch, St",12346,5931,6415,0.480398509638749,12166,5851,6315,0.48093046194312,0.0111070810043453,0.338686702969655,0.650206216026
9,"Bayern",9575155,"Oberickelsheim",703,352,351,0.500711237553343,689,344,345,0.499274310595065,0.0111070810043453,0.338686702969655,0.650206216026
9,"Bayern",9575156,"Obernzenn, M",2638,1282,1356,0.485974222896133,2669,1296,1373,0.485575121768453,0.0111070810043453,0.338686702969655,0.650206216026
9,"Bayern",9575157,"Oberscheinfeld, M",1189,584,605,0.491169049621531,1204,608,596,0.504983388704319,0.0111070810043453,0.338686702969655,0.650206216026
9,"Bayern",9575161,"Scheinfeld, St",4582,2237,2345,0.488214753382802,4598,2256,2342,0.490648107872988,0.0111070810043453,0.338686702969655,0.650206216026
9,"Bayern",9575163,"Simmershofen",884,468,416,0.529411764705882,889,465,424,0.523059617547806,0.0111070810043453,0.338686702969655,0.650206216026
9,"Bayern",9575165,"Sugenheim, M",2319,1155,1164,0.498059508408797,2323,1164,1159,0.501076194575979,0.0111070810043453,0.338686702969655,0.650206216026
9,"Bayern",9575166,"Trautskirchen",1328,663,665,0.499246987951807,1303,651,652,0.499616270145817,0.0111070810043453,0.338686702969655,0.650206216026
9,"Bayern",9575167,"Uehlfeld, M",2884,1457,1427,0.505201109570042,2908,1463,1445,0.503094910591472,0.0111070810043453,0.338686702969655,0.650206216026
9,"Bayern",9575168,"Uffenheim, St",6206,2978,3228,0.479858201740251,6146,2965,3181,0.482427595183859,0.0111070810043453,0.338686702969655,0.650206216026
9,"Bayern",9575179,"Weigenheim",997,500,497,0.501504513540622,1014,523,491,0.51577909270217,0.0111070810043453,0.338686702969655,0.650206216026
9,"Bayern",9575181,"Wilhelmsdorf",1385,703,682,0.507581227436823,1328,668,660,0.503012048192771,0.0111070810043453,0.338686702969655,0.650206216026
9,"Bayern",9576111,"Abenberg, St",5446,2628,2818,0.482556004406904,5495,2661,2834,0.484258416742493,0.0111070810043453,0.338686702969655,0.650206216026
9,"Bayern",9576113,"Allersberg, M",7971,3925,4046,0.492409986199975,7987,3927,4060,0.491673970201578,0.0111070810043453,0.338686702969655,0.650206216026
9,"Bayern",9576117,"Büchenbach",5132,2543,2589,0.49551831644583,5121,2545,2576,0.496973247412615,0.0111070810043453,0.338686702969655,0.650206216026
9,"Bayern",9576121,"Georgensgmünd",6650,3303,3347,0.496691729323308,6640,3298,3342,0.496686746987952,0.0111070810043453,0.338686702969655,0.650206216026
9,"Bayern",9576122,"Greding, St",6934,3522,3412,0.507931929622152,7071,3585,3486,0.507000424268138,0.0111070810043453,0.338686702969655,0.650206216026
9,"Bayern",9576126,"Heideck, St",4630,2341,2289,0.50561555075594,4632,2344,2288,0.506044905008636,0.0111070810043453,0.338686702969655,0.650206216026
9,"Bayern",9576127,"Hilpoltstein, St",13080,6630,6450,0.506880733944954,13363,6822,6541,0.510514106113897,0.0111070810043453,0.338686702969655,0.650206216026
9,"Bayern",9576128,"Kammerstein",2763,1391,1372,0.503438291711907,2834,1437,1397,0.507057163020466,0.0111070810043453,0.338686702969655,0.650206216026
9,"Bayern",9576132,"Schwanstetten, M",7297,3551,3746,0.486638344525147,7362,3558,3804,0.483292583537082,0.0111070810043453,0.338686702969655,0.650206216026
9,"Bayern",9576137,"Rednitzhembach",6804,3300,3504,0.485008818342152,6814,3274,3540,0.480481361901967,0.0111070810043453,0.338686702969655,0.650206216026
9,"Bayern",9576141,"Röttenbach",2867,1421,1446,0.495640041855598,2916,1456,1460,0.499314128943759,0.0111070810043453,0.338686702969655,0.650206216026
9,"Bayern",9576142,"Rohr",3542,1770,1772,0.499717673630717,3515,1752,1763,0.498435277382646,0.0111070810043453,0.338686702969655,0.650206216026
9,"Bayern",9576143,"Roth, St",24279,11823,12456,0.486964043000124,24359,12007,12352,0.492918428506917,0.0111070810043453,0.338686702969655,0.650206216026
9,"Bayern",9576147,"Spalt, St",4993,2497,2496,0.500100140196275,5019,2506,2513,0.499302649930265,0.0111070810043453,0.338686702969655,0.650206216026
9,"Bayern",9576148,"Thalmässing, M",5177,2599,2578,0.502028201661194,5169,2592,2577,0.501450957632037,0.0111070810043453,0.338686702969655,0.650206216026
9,"Bayern",9576151,"Wendelstein, M",15555,7485,8070,0.481195756991321,15685,7625,8060,0.486133248326427,0.0111070810043453,0.338686702969655,0.650206216026
9,"Bayern",9577111,"Absberg, M",1317,634,683,0.481397114654518,1299,630,669,0.484988452655889,0.0111070810043453,0.338686702969655,0.650206216026
9,"Bayern",9577113,"Alesheim",970,478,492,0.492783505154639,965,467,498,0.483937823834197,0.0111070810043453,0.338686702969655,0.650206216026
9,"Bayern",9577114,"Muhr a.See",2198,1096,1102,0.498635122838945,2218,1107,1111,0.499098286744815,0.0111070810043453,0.338686702969655,0.650206216026
9,"Bayern",9577115,"Bergen",1129,575,554,0.509300265721878,1136,580,556,0.51056338028169,0.0111070810043453,0.338686702969655,0.650206216026
9,"Bayern",9577120,"Burgsalach",1160,619,541,0.533620689655172,1174,626,548,0.533219761499148,0.0111070810043453,0.338686702969655,0.650206216026
9,"Bayern",9577122,"Dittenheim",1744,909,835,0.521215596330275,1703,897,806,0.526717557251908,0.0111070810043453,0.338686702969655,0.650206216026
9,"Bayern",9577125,"Ellingen, St",3632,1811,1821,0.498623348017621,3641,1829,1812,0.50233452348256,0.0111070810043453,0.338686702969655,0.650206216026
9,"Bayern",9577127,"Ettenstatt",839,421,418,0.501787842669845,822,414,408,0.503649635036496,0.0111070810043453,0.338686702969655,0.650206216026
9,"Bayern",9577133,"Gnotzheim, M",850,429,421,0.504705882352941,862,434,428,0.503480278422274,0.0111070810043453,0.338686702969655,0.650206216026
9,"Bayern",9577136,"Gunzenhausen, St",16222,7711,8511,0.475342127974356,16069,7652,8417,0.476196403012011,0.0111070810043453,0.338686702969655,0.650206216026
9,"Bayern",9577138,"Haundorf",2623,1346,1277,0.51315287838353,2651,1354,1297,0.510750660128254,0.0111070810043453,0.338686702969655,0.650206216026
9,"Bayern",9577140,"Heidenheim, M",2473,1281,1192,0.517994338859685,2347,1225,1122,0.521942905837239,0.0111070810043453,0.338686702969655,0.650206216026
9,"Bayern",9577141,"Höttingen",1154,582,572,0.504332755632582,1162,583,579,0.501721170395869,0.0111070810043453,0.338686702969655,0.650206216026
9,"Bayern",9577148,"Langenaltheim",2261,1165,1096,0.515258735072977,2318,1190,1128,0.513373597929249,0.0111070810043453,0.338686702969655,0.650206216026
9,"Bayern",9577149,"Markt Berolzheim, M",1298,644,654,0.496147919876733,1320,653,667,0.49469696969697,0.0111070810043453,0.338686702969655,0.650206216026
9,"Bayern",9577150,"Meinheim",862,442,420,0.512761020881671,845,434,411,0.513609467455621,0.0111070810043453,0.338686702969655,0.650206216026
9,"Bayern",9577151,"Nennslingen, M",1387,715,672,0.5155010814708,1350,711,639,0.526666666666667,0.0111070810043453,0.338686702969655,0.650206216026
9,"Bayern",9577158,"Pappenheim, St",3995,2002,1993,0.501126408010013,4042,2033,2009,0.502968827313211,0.0111070810043453,0.338686702969655,0.650206216026
9,"Bayern",9577159,"Pfofeld",1484,749,735,0.504716981132076,1505,777,728,0.516279069767442,0.0111070810043453,0.338686702969655,0.650206216026
9,"Bayern",9577161,"Pleinfeld, M",7382,3683,3699,0.498916282850176,7283,3615,3668,0.496361389537279,0.0111070810043453,0.338686702969655,0.650206216026
9,"Bayern",9577162,"Polsingen",1831,954,877,0.521026761332605,1958,1073,885,0.548008171603677,0.0111070810043453,0.338686702969655,0.650206216026
9,"Bayern",9577163,"Raitenbuch",1171,618,553,0.527754056362084,1139,604,535,0.530289727831431,0.0111070810043453,0.338686702969655,0.650206216026
9,"Bayern",9577168,"Solnhofen",1713,872,841,0.509048453006421,1695,853,842,0.503244837758112,0.0111070810043453,0.338686702969655,0.650206216026
9,"Bayern",9577172,"Theilenhofen",1156,582,574,0.503460207612457,1175,599,576,0.509787234042553,0.0111070810043453,0.338686702969655,0.650206216026
9,"Bayern",9577173,"Treuchtlingen, St",12534,6187,6347,0.493617360778682,12695,6282,6413,0.494840488381252,0.0111070810043453,0.338686702969655,0.650206216026
9,"Bayern",9577177,"Weißenburg i.Bay., GKSt",17623,8459,9164,0.479997730238892,17420,8411,9009,0.482835820895522,0.0111070810043453,0.338686702969655,0.650206216026
9,"Bayern",9577179,"Westheim",1174,601,573,0.511925042589438,1141,573,568,0.502191060473269,0.0111070810043453,0.338686702969655,0.650206216026
9,"Bayern",9661000,"Aschaffenburg",67470,32386,35084,0.480005928560842,68808,33104,35704,0.481106848040925,0.0111070810043453,0.338686702969655,0.650206216026
9,"Bayern",9662000,"Schweinfurt",52118,24848,27270,0.476764265704747,53247,25666,27581,0.482017766259132,0.0111070810043453,0.338686702969655,0.650206216026
9,"Bayern",9663000,"Würzburg",124449,58364,66085,0.468979260580639,133808,62513,71295,0.467184323807246,0.0111070810043453,0.338686702969655,0.650206216026
9,"Bayern",9671111,"Alzenau, St",18535,9073,9462,0.489506339357971,18491,9223,9268,0.498783191823049,0.0111070810043453,0.338686702969655,0.650206216026
9,"Bayern",9671112,"Bessenbach",5795,2892,2903,0.499050905953408,5800,2900,2900,0.5,0.0111070810043453,0.338686702969655,0.650206216026
9,"Bayern",9671113,"Blankenbach",1564,790,774,0.505115089514066,1603,819,784,0.510917030567686,0.0111070810043453,0.338686702969655,0.650206216026
9,"Bayern",9671114,"Karlstein a.Main",7941,3881,4060,0.488729379171389,7948,3866,4082,0.486411675893306,0.0111070810043453,0.338686702969655,0.650206216026
9,"Bayern",9671119,"Geiselbach",2119,1039,1080,0.49032562529495,2124,1044,1080,0.491525423728814,0.0111070810043453,0.338686702969655,0.650206216026
9,"Bayern",9671120,"Glattbach",3377,1626,1751,0.481492448919159,3265,1594,1671,0.488208269525268,0.0111070810043453,0.338686702969655,0.650206216026
9,"Bayern",9671121,"Goldbach, M",9812,4852,4960,0.494496534855279,9603,4678,4925,0.487139435593044,0.0111070810043453,0.338686702969655,0.650206216026
9,"Bayern",9671122,"Großostheim, M",16350,8144,8206,0.498103975535168,16402,8241,8161,0.502438726984514,0.0111070810043453,0.338686702969655,0.650206216026
9,"Bayern",9671124,"Haibach",8396,4050,4346,0.482372558361124,8465,4060,4405,0.479621972829297,0.0111070810043453,0.338686702969655,0.650206216026
9,"Bayern",9671126,"Heigenbrücken",2217,1111,1106,0.501127649977447,2215,1112,1103,0.502031602708804,0.0111070810043453,0.338686702969655,0.650206216026
9,"Bayern",9671127,"Heimbuchenthal",2165,1071,1094,0.494688221709007,2150,1073,1077,0.49906976744186,0.0111070810043453,0.338686702969655,0.650206216026
9,"Bayern",9671128,"Heinrichsthal",854,416,438,0.48711943793911,853,411,442,0.481828839390387,0.0111070810043453,0.338686702969655,0.650206216026
9,"Bayern",9671130,"Hösbach, M",13158,6505,6653,0.49437604499164,13188,6546,6642,0.496360327570519,0.0111070810043453,0.338686702969655,0.650206216026
9,"Bayern",9671133,"Johannesberg",3888,1945,1943,0.500257201646091,3869,1914,1955,0.494701473248902,0.0111070810043453,0.338686702969655,0.650206216026
9,"Bayern",9671134,"Kahl a.Main",7434,3618,3816,0.486682808716707,7387,3596,3791,0.486801137132801,0.0111070810043453,0.338686702969655,0.650206216026
9,"Bayern",9671135,"Kleinkahl",1828,930,898,0.508752735229759,1859,949,910,0.510489510489511,0.0111070810043453,0.338686702969655,0.650206216026
9,"Bayern",9671136,"Kleinostheim",8106,4011,4095,0.494818652849741,8104,4028,4076,0.497038499506417,0.0111070810043453,0.338686702969655,0.650206216026
9,"Bayern",9671138,"Krombach",2171,1084,1087,0.499309074159374,2132,1066,1066,0.5,0.0111070810043453,0.338686702969655,0.650206216026
9,"Bayern",9671139,"Laufach",5187,2587,2600,0.49874686716792,5217,2621,2596,0.502396013034311,0.0111070810043453,0.338686702969655,0.650206216026
9,"Bayern",9671140,"Mainaschaff",8567,4195,4372,0.48966966265904,8578,4209,4369,0.490673816740499,0.0111070810043453,0.338686702969655,0.650206216026
9,"Bayern",9671141,"Mespelbrunn",2188,1100,1088,0.502742230347349,2161,1098,1063,0.508098102730217,0.0111070810043453,0.338686702969655,0.650206216026
9,"Bayern",9671143,"Mömbris, M",11911,5910,6001,0.49618000167912,12025,5969,6056,0.496382536382536,0.0111070810043453,0.338686702969655,0.650206216026
9,"Bayern",9671148,"Rothenbuch",1709,866,843,0.506729081334114,1851,956,895,0.516477579686656,0.0111070810043453,0.338686702969655,0.650206216026
9,"Bayern",9671150,"Sailauf",3580,1776,1804,0.49608938547486,3581,1771,1810,0.494554593688914,0.0111070810043453,0.338686702969655,0.650206216026
9,"Bayern",9671152,"Schöllkrippen, M",4085,1999,2086,0.489351285189718,3938,1922,2016,0.48806500761808,0.0111070810043453,0.338686702969655,0.650206216026
9,"Bayern",9671153,"Sommerkahl",1109,529,580,0.477006311992786,1140,544,596,0.47719298245614,0.0111070810043453,0.338686702969655,0.650206216026
9,"Bayern",9671155,"Stockstadt a.Main, M",7582,3838,3744,0.506198892112899,7512,3826,3686,0.509318423855165,0.0111070810043453,0.338686702969655,0.650206216026
9,"Bayern",9671156,"Waldaschaff",3957,1972,1985,0.498357341420268,3947,1954,1993,0.495059538890296,0.0111070810043453,0.338686702969655,0.650206216026
9,"Bayern",9671157,"Weibersbrunn",2003,1006,997,0.502246630054918,2018,1011,1007,0.500991080277502,0.0111070810043453,0.338686702969655,0.650206216026
9,"Bayern",9671159,"Westerngrund",1912,982,930,0.513598326359833,1880,966,914,0.513829787234043,0.0111070810043453,0.338686702969655,0.650206216026
9,"Bayern",9671160,"Dammbach",1806,893,913,0.494462901439646,1816,897,919,0.493942731277533,0.0111070810043453,0.338686702969655,0.650206216026
9,"Bayern",9671162,"Wiesen",1045,514,531,0.491866028708134,1040,503,537,0.483653846153846,0.0111070810043453,0.338686702969655,0.650206216026
9,"Bayern",9672111,"Aura a.d.Saale",862,436,426,0.505800464037123,862,431,431,0.5,0.0111070810043453,0.338686702969655,0.650206216026
9,"Bayern",9672112,"Bad Bocklet, M",4473,2179,2294,0.487145092778896,4476,2182,2294,0.487488829311886,0.0111070810043453,0.338686702969655,0.650206216026
9,"Bayern",9672113,"Bad Brückenau, St",6468,3087,3381,0.477272727272727,6724,3217,3507,0.478435455086258,0.0111070810043453,0.338686702969655,0.650206216026
9,"Bayern",9672114,"Bad Kissingen, GKSt",21113,9543,11570,0.451996400322076,20900,9457,11443,0.452488038277512,0.0111070810043453,0.338686702969655,0.650206216026
9,"Bayern",9672117,"Burkardroth, M",7704,3843,3861,0.498831775700935,7631,3790,3841,0.496658367186476,0.0111070810043453,0.338686702969655,0.650206216026
9,"Bayern",9672121,"Elfershausen, M",2875,1430,1445,0.497391304347826,2821,1400,1421,0.496277915632754,0.0111070810043453,0.338686702969655,0.650206216026
9,"Bayern",9672122,"Euerdorf, M",1551,731,820,0.471308833010961,1541,735,806,0.476963011031798,0.0111070810043453,0.338686702969655,0.650206216026
9,"Bayern",9672124,"Fuchsstadt",1822,934,888,0.512623490669594,1861,949,912,0.509940891993552,0.0111070810043453,0.338686702969655,0.650206216026
9,"Bayern",9672126,"Geroda, M",914,448,466,0.490153172866521,908,454,454,0.5,0.0111070810043453,0.338686702969655,0.650206216026
9,"Bayern",9672127,"Hammelburg, St",11212,5533,5679,0.493489118801284,11446,5748,5698,0.502184169142058,0.0111070810043453,0.338686702969655,0.650206216026
9,"Bayern",9672131,"Maßbach, M",4573,2269,2304,0.496173190465777,4672,2340,2332,0.500856164383562,0.0111070810043453,0.338686702969655,0.650206216026
9,"Bayern",9672134,"Motten",1757,877,880,0.499146272054639,1781,895,886,0.502526670409882,0.0111070810043453,0.338686702969655,0.650206216026
9,"Bayern",9672135,"Münnerstadt, St",7844,3991,3853,0.508796532381438,7593,3868,3725,0.509416567891479,0.0111070810043453,0.338686702969655,0.650206216026
9,"Bayern",9672136,"Nüdlingen",4036,2010,2026,0.498017839444995,4092,2077,2015,0.507575757575758,0.0111070810043453,0.338686702969655,0.650206216026
9,"Bayern",9672138,"Oberleichtersbach",2020,996,1024,0.493069306930693,2021,984,1037,0.48688767936665,0.0111070810043453,0.338686702969655,0.650206216026
9,"Bayern",9672139,"Oberthulba, M",5052,2509,2543,0.496634996041172,5032,2480,2552,0.492845786963434,0.0111070810043453,0.338686702969655,0.650206216026
9,"Bayern",9672140,"Oerlenbach",4961,2447,2514,0.493247329167507,4970,2448,2522,0.492555331991952,0.0111070810043453,0.338686702969655,0.650206216026
9,"Bayern",9672142,"Ramsthal",1158,583,575,0.503454231433506,1166,588,578,0.504288164665523,0.0111070810043453,0.338686702969655,0.650206216026
9,"Bayern",9672143,"Rannungen",1167,587,580,0.502999143101971,1163,590,573,0.507308684436801,0.0111070810043453,0.338686702969655,0.650206216026
9,"Bayern",9672145,"Riedenberg",988,495,493,0.501012145748988,986,504,482,0.511156186612576,0.0111070810043453,0.338686702969655,0.650206216026
9,"Bayern",9672149,"Schondra, M",1730,889,841,0.513872832369942,1727,890,837,0.515344528083382,0.0111070810043453,0.338686702969655,0.650206216026
9,"Bayern",9672155,"Sulzthal, M",878,458,420,0.521640091116173,892,456,436,0.511210762331839,0.0111070810043453,0.338686702969655,0.650206216026
9,"Bayern",9672157,"Thundorf i.UFr.",1091,536,555,0.491292392300642,1116,546,570,0.489247311827957,0.0111070810043453,0.338686702969655,0.650206216026
9,"Bayern",9672161,"Wartmannsroth",2181,1091,1090,0.500229252636405,2203,1109,1094,0.503404448479346,0.0111070810043453,0.338686702969655,0.650206216026
9,"Bayern",9672163,"Wildflecken, M",3112,1542,1570,0.495501285347044,3073,1515,1558,0.493003579563944,0.0111070810043453,0.338686702969655,0.650206216026
9,"Bayern",9672166,"Zeitlofs, M",2111,1045,1066,0.495026054002842,2100,1051,1049,0.500476190476191,0.0111070810043453,0.338686702969655,0.650206216026
9,"Bayern",9673113,"Aubstadt",752,389,363,0.517287234042553,734,370,364,0.50408719346049,0.0111070810043453,0.338686702969655,0.650206216026
9,"Bayern",9673114,"Bad Neustadt a.d.Saale, St",15189,7259,7930,0.477911646586345,15559,7600,7959,0.488463268847612,0.0111070810043453,0.338686702969655,0.650206216026
9,"Bayern",9673116,"Bastheim",2150,1175,975,0.546511627906977,2511,1550,961,0.617283950617284,0.0111070810043453,0.338686702969655,0.650206216026
9,"Bayern",9673117,"Bischofsheim a.d.Rhön, St",4798,2365,2433,0.49291371404752,4722,2338,2384,0.495129182549767,0.0111070810043453,0.338686702969655,0.650206216026
9,"Bayern",9673123,"Fladungen, St",2207,1113,1094,0.504304485727232,2165,1096,1069,0.506235565819861,0.0111070810043453,0.338686702969655,0.650206216026
9,"Bayern",9673126,"Großbardorf",909,470,439,0.517051705170517,909,475,434,0.522552255225523,0.0111070810043453,0.338686702969655,0.650206216026
9,"Bayern",9673127,"Großeibstadt",1185,593,592,0.50042194092827,1148,571,577,0.497386759581882,0.0111070810043453,0.338686702969655,0.650206216026
9,"Bayern",9673129,"Hausen",692,351,341,0.507225433526012,702,371,331,0.528490028490028,0.0111070810043453,0.338686702969655,0.650206216026
9,"Bayern",9673130,"Hendungen",961,496,465,0.516129032258065,962,492,470,0.511434511434511,0.0111070810043453,0.338686702969655,0.650206216026
9,"Bayern",9673131,"Herbstadt",652,325,327,0.498466257668712,642,315,327,0.490654205607477,0.0111070810043453,0.338686702969655,0.650206216026
9,"Bayern",9673133,"Heustreu",1263,640,623,0.506730007917656,1218,618,600,0.507389162561576,0.0111070810043453,0.338686702969655,0.650206216026
9,"Bayern",9673134,"Höchheim",1195,607,588,0.507949790794979,1164,594,570,0.510309278350515,0.0111070810043453,0.338686702969655,0.650206216026
9,"Bayern",9673135,"Hohenroth",3517,1758,1759,0.499857833380722,3568,1787,1781,0.500840807174888,0.0111070810043453,0.338686702969655,0.650206216026
9,"Bayern",9673136,"Hollstadt",1550,758,792,0.489032258064516,1591,774,817,0.486486486486487,0.0111070810043453,0.338686702969655,0.650206216026
9,"Bayern",9673141,"Bad Königshofen i.Grabfeld, St",5931,2843,3088,0.479345810150059,6887,3388,3499,0.491941338754175,0.0111070810043453,0.338686702969655,0.650206216026
9,"Bayern",9673142,"Mellrichstadt, St",5597,2735,2862,0.488654636412364,5734,2852,2882,0.497384025113359,0.0111070810043453,0.338686702969655,0.650206216026
9,"Bayern",9673146,"Niederlauer",1694,849,845,0.501180637544274,1727,869,858,0.503184713375796,0.0111070810043453,0.338686702969655,0.650206216026
9,"Bayern",9673147,"Nordheim v.d.Rhön",1116,551,565,0.493727598566308,1092,542,550,0.496336996336996,0.0111070810043453,0.338686702969655,0.650206216026
9,"Bayern",9673149,"Oberelsbach, M",2773,1402,1371,0.505589614136314,2743,1381,1362,0.503463361283267,0.0111070810043453,0.338686702969655,0.650206216026
9,"Bayern",9673151,"Oberstreu",1554,777,777,0.5,1568,799,769,0.509566326530612,0.0111070810043453,0.338686702969655,0.650206216026
9,"Bayern",9673153,"Ostheim v.d.Rhön, St",3412,1683,1729,0.493259085580305,3477,1780,1697,0.511935576646534,0.0111070810043453,0.338686702969655,0.650206216026
9,"Bayern",9673156,"Rödelmaier",909,457,452,0.502750275027503,919,467,452,0.508161044613711,0.0111070810043453,0.338686702969655,0.650206216026
9,"Bayern",9673160,"Saal a.d.Saale, M",1513,746,767,0.493060145406477,1469,734,735,0.499659632402995,0.0111070810043453,0.338686702969655,0.650206216026
9,"Bayern",9673161,"Salz",2265,1115,1150,0.492273730684327,2347,1161,1186,0.494674051981253,0.0111070810043453,0.338686702969655,0.650206216026
9,"Bayern",9673162,"Sandberg",2573,1281,1292,0.497862417411582,2592,1282,1310,0.494598765432099,0.0111070810043453,0.338686702969655,0.650206216026
9,"Bayern",9673163,"Schönau a.d.Brend",1262,611,651,0.484152139461173,1281,626,655,0.488680718188915,0.0111070810043453,0.338686702969655,0.650206216026
9,"Bayern",9673167,"Sondheim v.d.Rhön",982,480,502,0.488798370672098,995,480,515,0.482412060301508,0.0111070810043453,0.338686702969655,0.650206216026
9,"Bayern",9673170,"Stockheim",1133,542,591,0.4783759929391,1132,545,587,0.481448763250883,0.0111070810043453,0.338686702969655,0.650206216026
9,"Bayern",9673171,"Strahlungen",907,454,453,0.500551267916207,918,467,451,0.508714596949891,0.0111070810043453,0.338686702969655,0.650206216026
9,"Bayern",9673172,"Sulzdorf a.d.Lederhecke",1103,576,527,0.522212148685403,1132,605,527,0.534452296819788,0.0111070810043453,0.338686702969655,0.650206216026
9,"Bayern",9673173,"Sulzfeld",1723,864,859,0.501450957632037,1736,871,865,0.501728110599078,0.0111070810043453,0.338686702969655,0.650206216026
9,"Bayern",9673174,"Trappstadt, M",1048,544,504,0.519083969465649,1011,542,469,0.536102868447082,0.0111070810043453,0.338686702969655,0.650206216026
9,"Bayern",9673175,"Unsleben",954,475,479,0.4979035639413,923,451,472,0.488624052004334,0.0111070810043453,0.338686702969655,0.650206216026
9,"Bayern",9673182,"Willmars",582,285,297,0.489690721649485,639,315,324,0.492957746478873,0.0111070810043453,0.338686702969655,0.650206216026
9,"Bayern",9673183,"Wollbach",1298,637,661,0.49075500770416,1293,631,662,0.488012374323279,0.0111070810043453,0.338686702969655,0.650206216026
9,"Bayern",9673184,"Wülfershausen a.d.Saale",1480,742,738,0.501351351351351,1464,736,728,0.502732240437158,0.0111070810043453,0.338686702969655,0.650206216026
9,"Bayern",9673186,"Burglauer",1640,834,806,0.508536585365854,1650,840,810,0.509090909090909,0.0111070810043453,0.338686702969655,0.650206216026
9,"Bayern",9674111,"Aidhausen",1796,914,882,0.50890868596882,1786,918,868,0.513997760358343,0.0111070810043453,0.338686702969655,0.650206216026
9,"Bayern",9674118,"Breitbrunn",1033,537,496,0.519845111326234,1024,529,495,0.5166015625,0.0111070810043453,0.338686702969655,0.650206216026
9,"Bayern",9674120,"Bundorf",928,476,452,0.512931034482759,897,448,449,0.499442586399108,0.0111070810043453,0.338686702969655,0.650206216026
9,"Bayern",9674121,"Burgpreppach, M",1401,711,690,0.507494646680942,1378,695,683,0.504354136429608,0.0111070810043453,0.338686702969655,0.650206216026
9,"Bayern",9674129,"Ebelsbach",3771,1869,1902,0.495624502784407,3810,1890,1920,0.496062992125984,0.0111070810043453,0.338686702969655,0.650206216026
9,"Bayern",9674130,"Ebern, St",7228,3592,3636,0.496956281128943,7210,3595,3615,0.498613037447989,0.0111070810043453,0.338686702969655,0.650206216026
9,"Bayern",9674133,"Eltmann, St",5330,2639,2691,0.495121951219512,5288,2654,2634,0.501891074130106,0.0111070810043453,0.338686702969655,0.650206216026
9,"Bayern",9674139,"Gädheim",1253,632,621,0.50438946528332,1234,617,617,0.5,0.0111070810043453,0.338686702969655,0.650206216026
9,"Bayern",9674147,"Haßfurt, St",13073,6410,6663,0.490323567658533,13424,6550,6874,0.487932061978546,0.0111070810043453,0.338686702969655,0.650206216026
9,"Bayern",9674149,"Hofheim i.UFr., St",5114,2513,2601,0.491396167383653,4978,2495,2483,0.501205303334673,0.0111070810043453,0.338686702969655,0.650206216026
9,"Bayern",9674153,"Riedbach",1758,881,877,0.501137656427759,1690,853,837,0.504733727810651,0.0111070810043453,0.338686702969655,0.650206216026
9,"Bayern",9674159,"Oberaurach",4032,2033,1999,0.50421626984127,4303,2167,2136,0.503602138043226,0.0111070810043453,0.338686702969655,0.650206216026
9,"Bayern",9674160,"Kirchlauter",1384,700,684,0.505780346820809,1374,690,684,0.502183406113537,0.0111070810043453,0.338686702969655,0.650206216026
9,"Bayern",9674163,"Knetzgau",6368,3232,3136,0.507537688442211,6346,3221,3125,0.507563819728963,0.0111070810043453,0.338686702969655,0.650206216026
9,"Bayern",9674164,"Königsberg i.Bay., St",3713,1829,1884,0.492593590088877,3634,1783,1851,0.490643918547056,0.0111070810043453,0.338686702969655,0.650206216026
9,"Bayern",9674171,"Maroldsweisach, M",3486,1737,1749,0.498278829604131,3532,1838,1694,0.520385050962627,0.0111070810043453,0.338686702969655,0.650206216026
9,"Bayern",9674180,"Theres",2691,1320,1371,0.490523968784838,2662,1317,1345,0.494740796393689,0.0111070810043453,0.338686702969655,0.650206216026
9,"Bayern",9674184,"Pfarrweisach",1513,762,751,0.503635161929941,1537,774,763,0.503578399479506,0.0111070810043453,0.338686702969655,0.650206216026
9,"Bayern",9674187,"Rauhenebrach",2964,1510,1454,0.50944669365722,2970,1536,1434,0.517171717171717,0.0111070810043453,0.338686702969655,0.650206216026
9,"Bayern",9674190,"Rentweinsdorf, M",1556,765,791,0.491645244215938,1571,767,804,0.488224061107575,0.0111070810043453,0.338686702969655,0.650206216026
9,"Bayern",9674195,"Sand a.Main",3085,1559,1526,0.505348460291734,3117,1556,1561,0.499197946743664,0.0111070810043453,0.338686702969655,0.650206216026
9,"Bayern",9674201,"Stettfeld",1141,575,566,0.503943908851884,1180,598,582,0.506779661016949,0.0111070810043453,0.338686702969655,0.650206216026
9,"Bayern",9674210,"Untermerzbach",1716,874,842,0.509324009324009,1706,853,853,0.5,0.0111070810043453,0.338686702969655,0.650206216026
9,"Bayern",9674219,"Wonfurt",1928,976,952,0.506224066390041,1898,971,927,0.51159114857745,0.0111070810043453,0.338686702969655,0.650206216026
9,"Bayern",9674221,"Zeil a.Main, St",5579,2761,2818,0.494891557626815,5574,2802,2772,0.502691065662002,0.0111070810043453,0.338686702969655,0.650206216026
9,"Bayern",9674223,"Ermershausen",599,307,292,0.512520868113522,614,316,298,0.514657980456026,0.0111070810043453,0.338686702969655,0.650206216026
9,"Bayern",9675111,"Abtswind, M",817,402,415,0.492044063647491,803,396,407,0.493150684931507,0.0111070810043453,0.338686702969655,0.650206216026
9,"Bayern",9675112,"Albertshofen",2177,1116,1061,0.512632062471291,1978,1034,944,0.522750252780586,0.0111070810043453,0.338686702969655,0.650206216026
9,"Bayern",9675113,"Biebelried",1229,627,602,0.510170870626526,1193,610,583,0.511316010058676,0.0111070810043453,0.338686702969655,0.650206216026
9,"Bayern",9675114,"Buchbrunn",1090,531,559,0.487155963302752,1033,506,527,0.489835430784124,0.0111070810043453,0.338686702969655,0.650206216026
9,"Bayern",9675116,"Castell",821,413,408,0.503045066991474,818,410,408,0.501222493887531,0.0111070810043453,0.338686702969655,0.650206216026
9,"Bayern",9675117,"Dettelbach, St",6908,3417,3491,0.494643891140706,6946,3437,3509,0.494817160955946,0.0111070810043453,0.338686702969655,0.650206216026
9,"Bayern",9675127,"Geiselwind, M",2356,1185,1171,0.502971137521222,2389,1201,1188,0.50272080368355,0.0111070810043453,0.338686702969655,0.650206216026
9,"Bayern",9675131,"Großlangheim, M",1623,816,807,0.502772643253235,1613,813,800,0.504029758214507,0.0111070810043453,0.338686702969655,0.650206216026
9,"Bayern",9675139,"Iphofen, St",4465,2223,2242,0.497872340425532,4391,2203,2188,0.501708039171032,0.0111070810043453,0.338686702969655,0.650206216026
9,"Bayern",9675141,"Kitzingen, GKSt",20321,9685,10636,0.476600560996014,20839,9940,10899,0.476990258649647,0.0111070810043453,0.338686702969655,0.650206216026
9,"Bayern",9675142,"Kleinlangheim, M",1707,897,810,0.525483304042179,1674,886,788,0.529271206690561,0.0111070810043453,0.338686702969655,0.650206216026
9,"Bayern",9675144,"Mainbernheim, St",2245,1110,1135,0.494432071269488,2255,1114,1141,0.494013303769401,0.0111070810043453,0.338686702969655,0.650206216026
9,"Bayern",9675146,"Mainstockheim",1895,928,967,0.489709762532982,1873,943,930,0.503470368392952,0.0111070810043453,0.338686702969655,0.650206216026
9,"Bayern",9675147,"Marktbreit, St",3671,1922,1749,0.523563061836012,3651,1980,1671,0.542317173377157,0.0111070810043453,0.338686702969655,0.650206216026
9,"Bayern",9675148,"Markt Einersheim, M",1202,590,612,0.490848585690516,1171,585,586,0.499573014517506,0.0111070810043453,0.338686702969655,0.650206216026
9,"Bayern",9675149,"Marktsteft, St",1838,932,906,0.507072905331882,1816,918,898,0.505506607929515,0.0111070810043453,0.338686702969655,0.650206216026
9,"Bayern",9675150,"Martinsheim",997,507,490,0.508525576730191,997,500,497,0.501504513540622,0.0111070810043453,0.338686702969655,0.650206216026
9,"Bayern",9675155,"Nordheim a.Main",1011,512,499,0.506429277942631,1026,533,493,0.519493177387914,0.0111070810043453,0.338686702969655,0.650206216026
9,"Bayern",9675156,"Obernbreit, M",1706,832,874,0.487690504103165,1712,821,891,0.479556074766355,0.0111070810043453,0.338686702969655,0.650206216026
9,"Bayern",9675158,"Prichsenstadt, St",3145,1582,1563,0.50302066772655,3165,1603,1562,0.506477093206951,0.0111070810043453,0.338686702969655,0.650206216026
9,"Bayern",9675161,"Rödelsee",1696,835,861,0.492334905660377,1686,833,853,0.494068801897983,0.0111070810043453,0.338686702969655,0.650206216026
9,"Bayern",9675162,"Rüdenhausen, M",842,415,427,0.492874109263658,810,386,424,0.476543209876543,0.0111070810043453,0.338686702969655,0.650206216026
9,"Bayern",9675165,"Schwarzach a.Main, M",3550,1837,1713,0.517464788732394,3692,1992,1700,0.539544962080173,0.0111070810043453,0.338686702969655,0.650206216026
9,"Bayern",9675166,"Segnitz",830,405,425,0.487951807228916,834,392,442,0.470023980815348,0.0111070810043453,0.338686702969655,0.650206216026
9,"Bayern",9675167,"Seinsheim, M",1066,538,528,0.5046904315197,1036,532,504,0.513513513513513,0.0111070810043453,0.338686702969655,0.650206216026
9,"Bayern",9675169,"Sommerach",1343,664,679,0.494415487714073,1415,700,715,0.49469964664311,0.0111070810043453,0.338686702969655,0.650206216026
9,"Bayern",9675170,"Sulzfeld a.Main",1324,647,677,0.488670694864048,1255,626,629,0.498804780876494,0.0111070810043453,0.338686702969655,0.650206216026
9,"Bayern",9675174,"Volkach, St",8597,4239,4358,0.493078981039898,9014,4518,4496,0.501220323940537,0.0111070810043453,0.338686702969655,0.650206216026
9,"Bayern",9675177,"Wiesenbronn",968,491,477,0.507231404958678,961,481,480,0.500520291363163,0.0111070810043453,0.338686702969655,0.650206216026
9,"Bayern",9675178,"Wiesentheid, M",4690,2306,2384,0.491684434968017,4785,2418,2367,0.505329153605016,0.0111070810043453,0.338686702969655,0.650206216026
9,"Bayern",9675179,"Willanzheim, M",1601,843,758,0.526545908806996,1575,822,753,0.521904761904762,0.0111070810043453,0.338686702969655,0.650206216026
9,"Bayern",9676111,"Altenbuch",1268,627,641,0.494479495268139,1257,633,624,0.503579952267303,0.0111070810043453,0.338686702969655,0.650206216026
9,"Bayern",9676112,"Amorbach, St",4011,1943,2068,0.484417850909998,3914,1900,2014,0.485436893203884,0.0111070810043453,0.338686702969655,0.650206216026
9,"Bayern",9676116,"Bürgstadt, M",4302,2145,2157,0.49860529986053,4202,2117,2085,0.503807710613993,0.0111070810043453,0.338686702969655,0.650206216026
9,"Bayern",9676117,"Collenberg",2447,1240,1207,0.506742950551696,2488,1274,1214,0.512057877813505,0.0111070810043453,0.338686702969655,0.650206216026
9,"Bayern",9676118,"Dorfprozelten",1797,919,878,0.511407902058987,1782,904,878,0.507295173961841,0.0111070810043453,0.338686702969655,0.650206216026
9,"Bayern",9676119,"Eichenbühl",2605,1292,1313,0.495969289827255,2602,1295,1307,0.497694081475788,0.0111070810043453,0.338686702969655,0.650206216026
9,"Bayern",9676121,"Elsenfeld, M",8983,4478,4505,0.498497161304687,8847,4390,4457,0.49621340567424,0.0111070810043453,0.338686702969655,0.650206216026
9,"Bayern",9676122,"Erlenbach a.Main, St",9922,4876,5046,0.491433178794598,9883,4892,4991,0.49499139937266,0.0111070810043453,0.338686702969655,0.650206216026
9,"Bayern",9676123,"Eschau, M",3803,1936,1867,0.509071785432553,3850,1976,1874,0.513246753246753,0.0111070810043453,0.338686702969655,0.650206216026
9,"Bayern",9676124,"Faulbach",2666,1345,1321,0.50450112528132,2694,1363,1331,0.505939123979213,0.0111070810043453,0.338686702969655,0.650206216026
9,"Bayern",9676125,"Großheubach, M",5085,2502,2583,0.492035398230089,5033,2472,2561,0.491158354857938,0.0111070810043453,0.338686702969655,0.650206216026
9,"Bayern",9676126,"Großwallstadt",4071,2009,2062,0.493490542864161,4086,2043,2043,0.5,0.0111070810043453,0.338686702969655,0.650206216026
9,"Bayern",9676128,"Hausen",1900,941,959,0.495263157894737,1947,964,983,0.495120698510529,0.0111070810043453,0.338686702969655,0.650206216026
9,"Bayern",9676131,"Kirchzell, M",2292,1167,1125,0.509162303664921,2291,1175,1116,0.512876473155827,0.0111070810043453,0.338686702969655,0.650206216026
9,"Bayern",9676132,"Kleinheubach, M",3625,1798,1827,0.496,3534,1774,1760,0.501980758347482,0.0111070810043453,0.338686702969655,0.650206216026
9,"Bayern",9676133,"Kleinwallstadt, M",5717,2809,2908,0.491341612733951,5763,2872,2891,0.498351553010585,0.0111070810043453,0.338686702969655,0.650206216026
9,"Bayern",9676134,"Klingenberg a.Main, St",6084,3021,3063,0.4965483234714,6102,3058,3044,0.501147164863979,0.0111070810043453,0.338686702969655,0.650206216026
9,"Bayern",9676135,"Laudenbach",1396,708,688,0.507163323782235,1366,689,677,0.504392386530015,0.0111070810043453,0.338686702969655,0.650206216026
9,"Bayern",9676136,"Leidersbach",4828,2423,2405,0.501864125932063,4801,2398,2403,0.49947927515101,0.0111070810043453,0.338686702969655,0.650206216026
9,"Bayern",9676139,"Miltenberg, St",9102,4434,4668,0.487145682267633,9201,4526,4675,0.491903054015868,0.0111070810043453,0.338686702969655,0.650206216026
9,"Bayern",9676140,"Mömlingen",4896,2424,2472,0.495098039215686,4925,2411,2514,0.489543147208122,0.0111070810043453,0.338686702969655,0.650206216026
9,"Bayern",9676141,"Mönchberg, M",2536,1266,1270,0.499211356466877,2521,1244,1277,0.493454978183261,0.0111070810043453,0.338686702969655,0.650206216026
9,"Bayern",9676143,"Neunkirchen",1531,770,761,0.502939255388635,1477,742,735,0.502369668246445,0.0111070810043453,0.338686702969655,0.650206216026
9,"Bayern",9676144,"Niedernberg",4909,2449,2460,0.498879608881646,4944,2482,2462,0.502022653721683,0.0111070810043453,0.338686702969655,0.650206216026
9,"Bayern",9676145,"Obernburg a.Main, St",8543,4256,4287,0.498185649069414,8463,4208,4255,0.497223206900626,0.0111070810043453,0.338686702969655,0.650206216026
9,"Bayern",9676151,"Röllbach",1710,868,842,0.507602339181286,1729,867,862,0.501445922498554,0.0111070810043453,0.338686702969655,0.650206216026
9,"Bayern",9676153,"Rüdenau",767,378,389,0.492829204693611,786,388,398,0.493638676844784,0.0111070810043453,0.338686702969655,0.650206216026
9,"Bayern",9676156,"Schneeberg, M",1788,892,896,0.498881431767338,1787,915,872,0.512031337437045,0.0111070810043453,0.338686702969655,0.650206216026
9,"Bayern",9676158,"Stadtprozelten, St",1583,820,763,0.518003790271636,1598,842,756,0.526908635794743,0.0111070810043453,0.338686702969655,0.650206216026
9,"Bayern",9676160,"Sulzbach a.Main, M",6902,3462,3440,0.501593740944654,6871,3443,3428,0.501091544171154,0.0111070810043453,0.338686702969655,0.650206216026
9,"Bayern",9676165,"Weilbach, M",2290,1159,1131,0.506113537117904,2241,1127,1114,0.502900490852298,0.0111070810043453,0.338686702969655,0.650206216026
9,"Bayern",9676169,"Wörth a.Main, St",4763,2362,2401,0.495905941633424,4838,2403,2435,0.496692848284415,0.0111070810043453,0.338686702969655,0.650206216026
9,"Bayern",9677114,"Arnstein, St",8124,4044,4080,0.497784342688331,8030,4021,4009,0.500747198007472,0.0111070810043453,0.338686702969655,0.650206216026
9,"Bayern",9677116,"Aura i.Sinngrund",1025,507,518,0.494634146341463,1021,501,520,0.490695396669931,0.0111070810043453,0.338686702969655,0.650206216026
9,"Bayern",9677119,"Birkenfeld",2158,1102,1056,0.510658016682113,2166,1110,1056,0.512465373961219,0.0111070810043453,0.338686702969655,0.650206216026
9,"Bayern",9677120,"Bischbrunn",1820,920,900,0.505494505494505,1793,900,893,0.501952035694367,0.0111070810043453,0.338686702969655,0.650206216026
9,"Bayern",9677122,"Burgsinn, M",2537,1279,1258,0.504138746551045,2533,1303,1230,0.514409790761942,0.0111070810043453,0.338686702969655,0.650206216026
9,"Bayern",9677125,"Erlenbach b.Marktheidenfeld",2453,1248,1205,0.508764777823074,2426,1238,1188,0.510305028854081,0.0111070810043453,0.338686702969655,0.650206216026
9,"Bayern",9677126,"Esselbach",2005,956,1049,0.476807980049875,1986,949,1037,0.477844914400806,0.0111070810043453,0.338686702969655,0.650206216026
9,"Bayern",9677127,"Eußenheim",3186,1620,1566,0.508474576271186,3192,1618,1574,0.506892230576441,0.0111070810043453,0.338686702969655,0.650206216026
9,"Bayern",9677128,"Fellen",863,435,428,0.504055619930475,868,445,423,0.512672811059908,0.0111070810043453,0.338686702969655,0.650206216026
9,"Bayern",9677129,"Frammersbach, M",4547,2271,2276,0.499450186936442,4462,2232,2230,0.50022411474675,0.0111070810043453,0.338686702969655,0.650206216026
9,"Bayern",9677131,"Gemünden a.Main, St",10411,5193,5218,0.498799346844684,10597,5216,5381,0.492214777767293,0.0111070810043453,0.338686702969655,0.650206216026
9,"Bayern",9677132,"Gössenheim",1235,623,612,0.504453441295547,1238,623,615,0.503231017770598,0.0111070810043453,0.338686702969655,0.650206216026
9,"Bayern",9677133,"Gräfendorf",1405,712,693,0.506761565836299,1350,673,677,0.498518518518519,0.0111070810043453,0.338686702969655,0.650206216026
9,"Bayern",9677135,"Hafenlohr",1880,967,913,0.51436170212766,1851,933,918,0.504051863857374,0.0111070810043453,0.338686702969655,0.650206216026
9,"Bayern",9677137,"Hasloch",1403,738,665,0.526015680684248,1400,734,666,0.524285714285714,0.0111070810043453,0.338686702969655,0.650206216026
9,"Bayern",9677142,"Himmelstadt",1640,825,815,0.503048780487805,1683,841,842,0.499702911467617,0.0111070810043453,0.338686702969655,0.650206216026
9,"Bayern",9677146,"Karbach, M",1443,727,716,0.503811503811504,1412,722,690,0.511331444759207,0.0111070810043453,0.338686702969655,0.650206216026
9,"Bayern",9677148,"Karlstadt, St",14893,7289,7604,0.489424561874706,14835,7383,7452,0.497674418604651,0.0111070810043453,0.338686702969655,0.650206216026
9,"Bayern",9677149,"Karsbach",1772,876,896,0.494356659142212,1785,887,898,0.496918767507003,0.0111070810043453,0.338686702969655,0.650206216026
9,"Bayern",9677151,"Kreuzwertheim, M",3810,1859,1951,0.487926509186352,3729,1833,1896,0.491552695092518,0.0111070810043453,0.338686702969655,0.650206216026
9,"Bayern",9677154,"Triefenstein, M",4266,2117,2149,0.496249413970933,4331,2154,2177,0.497344724082198,0.0111070810043453,0.338686702969655,0.650206216026
9,"Bayern",9677155,"Lohr a.Main, St",15222,7464,7758,0.490342924714229,15598,7809,7789,0.500641107834338,0.0111070810043453,0.338686702969655,0.650206216026
9,"Bayern",9677157,"Marktheidenfeld, St",10830,5186,5644,0.478855032317636,10867,5231,5636,0.481365602282139,0.0111070810043453,0.338686702969655,0.650206216026
9,"Bayern",9677159,"Mittelsinn",841,419,422,0.498216409036861,847,417,430,0.49232585596222,0.0111070810043453,0.338686702969655,0.650206216026
9,"Bayern",9677164,"Neuendorf",841,437,404,0.51961950059453,830,430,400,0.518072289156627,0.0111070810043453,0.338686702969655,0.650206216026
9,"Bayern",9677165,"Neuhütten",1199,583,616,0.486238532110092,1189,590,599,0.496215306980656,0.0111070810043453,0.338686702969655,0.650206216026
9,"Bayern",9677166,"Neustadt a.Main",1251,592,659,0.473221422861711,1249,588,661,0.470776621297038,0.0111070810043453,0.338686702969655,0.650206216026
9,"Bayern",9677169,"Obersinn, M",989,497,492,0.50252780586451,989,490,499,0.495449949443883,0.0111070810043453,0.338686702969655,0.650206216026
9,"Bayern",9677170,"Partenstein",2838,1409,1429,0.496476391825229,2805,1389,1416,0.495187165775401,0.0111070810043453,0.338686702969655,0.650206216026
9,"Bayern",9677172,"Rechtenbach",1006,503,503,0.5,993,506,487,0.50956696878147,0.0111070810043453,0.338686702969655,0.650206216026
9,"Bayern",9677175,"Retzstadt",1580,805,775,0.509493670886076,1562,784,778,0.501920614596671,0.0111070810043453,0.338686702969655,0.650206216026
9,"Bayern",9677177,"Rieneck, St",2078,1024,1054,0.492781520692974,2031,992,1039,0.488429345150172,0.0111070810043453,0.338686702969655,0.650206216026
9,"Bayern",9677178,"Roden",990,504,486,0.509090909090909,989,506,483,0.511627906976744,0.0111070810043453,0.338686702969655,0.650206216026
9,"Bayern",9677181,"Rothenfels, St",1009,524,485,0.519326065411298,1000,515,485,0.515,0.0111070810043453,0.338686702969655,0.650206216026
9,"Bayern",9677182,"Schollbrunn",928,489,439,0.526939655172414,919,477,442,0.519042437431991,0.0111070810043453,0.338686702969655,0.650206216026
9,"Bayern",9677186,"Steinfeld",2212,1113,1099,0.503164556962025,2233,1129,1104,0.505597850425437,0.0111070810043453,0.338686702969655,0.650206216026
9,"Bayern",9677189,"Thüngen, M",1353,671,682,0.495934959349593,1324,667,657,0.503776435045317,0.0111070810043453,0.338686702969655,0.650206216026
9,"Bayern",9677193,"Urspringen",1369,683,686,0.498904309715121,1355,685,670,0.505535055350554,0.0111070810043453,0.338686702969655,0.650206216026
9,"Bayern",9677200,"Wiesthal",1360,680,680,0.5,1372,677,695,0.493440233236152,0.0111070810043453,0.338686702969655,0.650206216026
9,"Bayern",9677203,"Zellingen, M",6382,3163,3219,0.49561266060796,6374,3139,3235,0.492469406965799,0.0111070810043453,0.338686702969655,0.650206216026
9,"Bayern",9678115,"Bergrheinfeld",5141,2543,2598,0.494650846138883,5129,2556,2573,0.498342756872685,0.0111070810043453,0.338686702969655,0.650206216026
9,"Bayern",9678122,"Dingolshausen",1269,640,629,0.504334121355398,1247,632,615,0.506816359262229,0.0111070810043453,0.338686702969655,0.650206216026
9,"Bayern",9678123,"Dittelbrunn",7123,3511,3612,0.49291029060789,7173,3572,3601,0.497978530600864,0.0111070810043453,0.338686702969655,0.650206216026
9,"Bayern",9678124,"Donnersdorf",1955,1003,952,0.51304347826087,1978,1004,974,0.507583417593529,0.0111070810043453,0.338686702969655,0.650206216026
9,"Bayern",9678128,"Euerbach",2986,1483,1503,0.496651038178165,2955,1469,1486,0.497123519458545,0.0111070810043453,0.338686702969655,0.650206216026
9,"Bayern",9678130,"Frankenwinheim",1009,509,500,0.504459861248761,1003,505,498,0.503489531405783,0.0111070810043453,0.338686702969655,0.650206216026
9,"Bayern",9678132,"Geldersheim",2492,1203,1289,0.482744783306581,2483,1213,1270,0.488521949254934,0.0111070810043453,0.338686702969655,0.650206216026
9,"Bayern",9678134,"Gerolzhofen, St",6674,3273,3401,0.490410548396764,6537,3203,3334,0.489980113201775,0.0111070810043453,0.338686702969655,0.650206216026
9,"Bayern",9678135,"Gochsheim",6171,3044,3127,0.493274995948793,6152,3022,3130,0.491222366710013,0.0111070810043453,0.338686702969655,0.650206216026
9,"Bayern",9678136,"Grafenrheinfeld",3396,1685,1711,0.496171967020024,3347,1684,1663,0.503137137735285,0.0111070810043453,0.338686702969655,0.650206216026
9,"Bayern",9678138,"Grettstadt",4151,2068,2083,0.498193206456276,4123,2056,2067,0.498666019888431,0.0111070810043453,0.338686702969655,0.650206216026
9,"Bayern",9678150,"Kolitzheim",5427,2736,2691,0.504145936981758,5380,2720,2660,0.505576208178439,0.0111070810043453,0.338686702969655,0.650206216026
9,"Bayern",9678153,"Lülsfeld",814,405,409,0.497542997542998,807,408,399,0.505576208178439,0.0111070810043453,0.338686702969655,0.650206216026
9,"Bayern",9678157,"Michelau i.Steigerwald",1138,578,560,0.507908611599297,1119,574,545,0.51295799821269,0.0111070810043453,0.338686702969655,0.650206216026
9,"Bayern",9678160,"Niederwerrn",7904,3856,4048,0.487854251012146,7840,3789,4051,0.483290816326531,0.0111070810043453,0.338686702969655,0.650206216026
9,"Bayern",9678164,"Oberschwarzach, M",1385,710,675,0.512635379061372,1376,705,671,0.512354651162791,0.0111070810043453,0.338686702969655,0.650206216026
9,"Bayern",9678168,"Poppenhausen",4190,2074,2116,0.494988066825776,4046,1990,2056,0.491843796342066,0.0111070810043453,0.338686702969655,0.650206216026
9,"Bayern",9678170,"Röthlein",4573,2227,2346,0.486988847583643,4758,2358,2400,0.495586380832282,0.0111070810043453,0.338686702969655,0.650206216026
9,"Bayern",9678174,"Schonungen",7714,3872,3842,0.501944516463573,7806,3924,3882,0.502690238278248,0.0111070810043453,0.338686702969655,0.650206216026
9,"Bayern",9678175,"Schwanfeld",1875,931,944,0.496533333333333,1918,965,953,0.503128258602711,0.0111070810043453,0.338686702969655,0.650206216026
9,"Bayern",9678176,"Schwebheim",3923,1922,2001,0.489931175121081,4091,2040,2051,0.498655585431435,0.0111070810043453,0.338686702969655,0.650206216026
9,"Bayern",9678178,"Sennfeld",4147,2050,2097,0.494333252953943,4012,1972,2040,0.491525423728814,0.0111070810043453,0.338686702969655,0.650206216026
9,"Bayern",9678181,"Stadtlauringen, M",4129,2063,2066,0.499636715911843,4198,2099,2099,0.5,0.0111070810043453,0.338686702969655,0.650206216026
9,"Bayern",9678183,"Sulzheim",1976,1005,971,0.508603238866397,1964,990,974,0.504073319755601,0.0111070810043453,0.338686702969655,0.650206216026
9,"Bayern",9678186,"Üchtelhausen",3863,1948,1915,0.504271291742169,3828,1943,1885,0.507575757575758,0.0111070810043453,0.338686702969655,0.650206216026
9,"Bayern",9678190,"Waigolshausen",2822,1458,1364,0.51665485471297,2788,1448,1340,0.519368723098996,0.0111070810043453,0.338686702969655,0.650206216026
9,"Bayern",9678192,"Wasserlosen",3418,1743,1675,0.509947337624342,3353,1714,1639,0.511184014315538,0.0111070810043453,0.338686702969655,0.650206216026
9,"Bayern",9678193,"Werneck, M",10242,5083,5159,0.496289787150947,10317,5156,5161,0.499757681496559,0.0111070810043453,0.338686702969655,0.650206216026
9,"Bayern",9678196,"Wipfeld",1084,538,546,0.496309963099631,1094,539,555,0.492687385740402,0.0111070810043453,0.338686702969655,0.650206216026
9,"Bayern",9679114,"Aub, St",1545,792,753,0.512621359223301,1545,791,754,0.511974110032362,0.0111070810043453,0.338686702969655,0.650206216026
9,"Bayern",9679117,"Bergtheim",3468,1700,1768,0.490196078431373,3408,1677,1731,0.492077464788732,0.0111070810043453,0.338686702969655,0.650206216026
9,"Bayern",9679118,"Bieberehren",952,476,476,0.5,937,465,472,0.496264674493063,0.0111070810043453,0.338686702969655,0.650206216026
9,"Bayern",9679122,"Bütthard, M",1278,646,632,0.50547730829421,1272,642,630,0.504716981132076,0.0111070810043453,0.338686702969655,0.650206216026
9,"Bayern",9679124,"Eibelstadt, St",2786,1339,1447,0.480617372577172,2803,1354,1449,0.483053870852658,0.0111070810043453,0.338686702969655,0.650206216026
9,"Bayern",9679126,"Eisingen",3410,1694,1716,0.496774193548387,3582,1778,1804,0.496370742601898,0.0111070810043453,0.338686702969655,0.650206216026
9,"Bayern",9679128,"Erlabrunn",1684,832,852,0.494061757719715,1702,853,849,0.50117508813161,0.0111070810043453,0.338686702969655,0.650206216026
9,"Bayern",9679130,"Estenfeld",4810,2341,2469,0.486694386694387,4820,2373,2447,0.492323651452282,0.0111070810043453,0.338686702969655,0.650206216026
9,"Bayern",9679131,"Frickenhausen a.Main, M",1258,625,633,0.496820349761526,1228,620,608,0.504885993485342,0.0111070810043453,0.338686702969655,0.650206216026
9,"Bayern",9679134,"Gaukönigshofen",2482,1286,1196,0.518130539887188,2455,1263,1192,0.514460285132383,0.0111070810043453,0.338686702969655,0.650206216026
9,"Bayern",9679135,"Gelchsheim, M",819,430,389,0.525030525030525,798,420,378,0.526315789473684,0.0111070810043453,0.338686702969655,0.650206216026
9,"Bayern",9679136,"Gerbrunn",6138,2960,3178,0.482241772564353,6480,3142,3338,0.484876543209877,0.0111070810043453,0.338686702969655,0.650206216026
9,"Bayern",9679137,"Geroldshausen",1272,654,618,0.514150943396226,1325,677,648,0.510943396226415,0.0111070810043453,0.338686702969655,0.650206216026
9,"Bayern",9679138,"Giebelstadt, M",5138,2620,2518,0.509926041261191,5031,2576,2455,0.512025442258,0.0111070810043453,0.338686702969655,0.650206216026
9,"Bayern",9679141,"Greußenheim",1591,806,785,0.506599622878693,1591,808,783,0.507856693903206,0.0111070810043453,0.338686702969655,0.650206216026
9,"Bayern",9679142,"Güntersleben",4326,2137,2189,0.493989828941285,4397,2175,2222,0.494655446895611,0.0111070810043453,0.338686702969655,0.650206216026
9,"Bayern",9679143,"Hausen b.Würzburg",2400,1214,1186,0.505833333333333,2399,1209,1190,0.503959983326386,0.0111070810043453,0.338686702969655,0.650206216026
9,"Bayern",9679144,"Helmstadt, M",2579,1335,1244,0.517642497091896,2570,1324,1246,0.515175097276265,0.0111070810043453,0.338686702969655,0.650206216026
9,"Bayern",9679146,"Hettstadt",3720,1840,1880,0.494623655913978,3655,1802,1853,0.493023255813954,0.0111070810043453,0.338686702969655,0.650206216026
9,"Bayern",9679147,"Höchberg, M",9090,4357,4733,0.479317931793179,9490,4538,4952,0.478187565858799,0.0111070810043453,0.338686702969655,0.650206216026
9,"Bayern",9679149,"Holzkirchen",1000,500,500,0.5,930,457,473,0.491397849462366,0.0111070810043453,0.338686702969655,0.650206216026
9,"Bayern",9679153,"Kirchheim",2146,1092,1054,0.508853681267474,2177,1107,1070,0.508497932935232,0.0111070810043453,0.338686702969655,0.650206216026
9,"Bayern",9679154,"Kist",2479,1208,1271,0.487293263412666,2447,1192,1255,0.487127094401308,0.0111070810043453,0.338686702969655,0.650206216026
9,"Bayern",9679155,"Kleinrinderfeld",2066,1057,1009,0.51161665053243,2100,1073,1027,0.510952380952381,0.0111070810043453,0.338686702969655,0.650206216026
9,"Bayern",9679156,"Kürnach",4509,2191,2318,0.48591705477933,4542,2208,2334,0.486129458388375,0.0111070810043453,0.338686702969655,0.650206216026
9,"Bayern",9679161,"Margetshöchheim",3162,1565,1597,0.49493991144845,3203,1589,1614,0.496097408679363,0.0111070810043453,0.338686702969655,0.650206216026
9,"Bayern",9679164,"Neubrunn, M",2204,1107,1097,0.502268602540835,2166,1079,1087,0.498153277931671,0.0111070810043453,0.338686702969655,0.650206216026
9,"Bayern",9679165,"Altertheim",2017,1018,999,0.504709965294993,2057,1030,1027,0.500729217306757,0.0111070810043453,0.338686702969655,0.650206216026
9,"Bayern",9679167,"Eisenheim, M",1279,641,638,0.501172791243159,1326,672,654,0.506787330316742,0.0111070810043453,0.338686702969655,0.650206216026
9,"Bayern",9679169,"Oberpleichfeld",1080,568,512,0.525925925925926,1089,577,512,0.529843893480257,0.0111070810043453,0.338686702969655,0.650206216026
9,"Bayern",9679170,"Ochsenfurt, St",11097,5474,5623,0.493286473821754,11304,5555,5749,0.491418966737438,0.0111070810043453,0.338686702969655,0.650206216026
9,"Bayern",9679174,"Prosselsheim",1167,600,567,0.51413881748072,1179,613,566,0.519932145886344,0.0111070810043453,0.338686702969655,0.650206216026
9,"Bayern",9679175,"Randersacker, M",3337,1634,1703,0.489661372490261,3435,1687,1748,0.491120815138282,0.0111070810043453,0.338686702969655,0.650206216026
9,"Bayern",9679176,"Reichenberg, M",3974,1969,2005,0.495470558631102,3967,1973,1994,0.497353163599698,0.0111070810043453,0.338686702969655,0.650206216026
9,"Bayern",9679177,"Remlingen, M",1478,736,742,0.497970230040595,1477,750,727,0.50778605280975,0.0111070810043453,0.338686702969655,0.650206216026
9,"Bayern",9679179,"Riedenheim",765,408,357,0.533333333333333,745,405,340,0.543624161073825,0.0111070810043453,0.338686702969655,0.650206216026
9,"Bayern",9679180,"Rimpar, M",7635,3737,3898,0.489456450556647,7752,3818,3934,0.492518059855521,0.0111070810043453,0.338686702969655,0.650206216026
9,"Bayern",9679182,"Röttingen, St",1700,842,858,0.495294117647059,1642,821,821,0.5,0.0111070810043453,0.338686702969655,0.650206216026
9,"Bayern",9679185,"Rottendorf",5358,2585,2773,0.482456140350877,5255,2528,2727,0.481065651760228,0.0111070810043453,0.338686702969655,0.650206216026
9,"Bayern",9679187,"Sommerhausen, M",1679,813,866,0.484216795711733,1662,792,870,0.476534296028881,0.0111070810043453,0.338686702969655,0.650206216026
9,"Bayern",9679188,"Sonderhofen",822,433,389,0.52676399026764,824,432,392,0.524271844660194,0.0111070810043453,0.338686702969655,0.650206216026
9,"Bayern",9679192,"Tauberrettersheim",864,429,435,0.496527777777778,853,415,438,0.48651817116061,0.0111070810043453,0.338686702969655,0.650206216026
9,"Bayern",9679193,"Theilheim",2344,1146,1198,0.488907849829352,2348,1160,1188,0.494037478705281,0.0111070810043453,0.338686702969655,0.650206216026
9,"Bayern",9679194,"Thüngersheim",2615,1310,1305,0.500956022944551,2661,1308,1353,0.491544532130778,0.0111070810043453,0.338686702969655,0.650206216026
9,"Bayern",9679196,"Uettingen",1830,930,900,0.508196721311475,1902,974,928,0.512092534174553,0.0111070810043453,0.338686702969655,0.650206216026
9,"Bayern",9679200,"Leinach",3089,1562,1527,0.50566526383943,3131,1594,1537,0.509102523155541,0.0111070810043453,0.338686702969655,0.650206216026
9,"Bayern",9679201,"Unterpleichfeld",2823,1408,1415,0.498760184201204,2861,1437,1424,0.502271932890598,0.0111070810043453,0.338686702969655,0.650206216026
9,"Bayern",9679202,"Veitshöchheim",9691,4700,4991,0.484986069549066,9917,4901,5016,0.494201875567208,0.0111070810043453,0.338686702969655,0.650206216026
9,"Bayern",9679204,"Waldbrunn",2595,1274,1321,0.490944123314066,2601,1274,1327,0.489811610918877,0.0111070810043453,0.338686702969655,0.650206216026
9,"Bayern",9679205,"Waldbüttelbrunn",4851,2431,2420,0.501133786848073,5015,2514,2501,0.501296111665005,0.0111070810043453,0.338686702969655,0.650206216026
9,"Bayern",9679206,"Winterhausen, M",1455,721,734,0.49553264604811,1460,727,733,0.497945205479452,0.0111070810043453,0.338686702969655,0.650206216026
9,"Bayern",9679209,"Zell a.Main, M",4271,2027,2244,0.474596113322407,4286,2005,2281,0.467802146523565,0.0111070810043453,0.338686702969655,0.650206216026
9,"Bayern",9761000,"Augsburg",269402,129806,139596,0.481830127467502,266647,129743,136904,0.486572134694934,0.0111070810043453,0.338686702969655,0.650206216026
9,"Bayern",9762000,"Kaufbeuren",41460,20005,21455,0.48251326579836,41745,20087,21658,0.481183375254521,0.0111070810043453,0.338686702969655,0.650206216026
9,"Bayern",9763000,"Kempten (Allgäu)",64300,31396,32904,0.488273716951789,62240,29861,32379,0.479771850899743,0.0111070810043453,0.338686702969655,0.650206216026
9,"Bayern",9764000,"Memmingen",41242,19994,21248,0.484797051549391,41030,19950,21080,0.486229588106264,0.0111070810043453,0.338686702969655,0.650206216026
9,"Bayern",9771111,"Adelzhausen",1573,815,758,0.518118245390973,1606,836,770,0.520547945205479,0.0111070810043453,0.338686702969655,0.650206216026
9,"Bayern",9771112,"Affing",5262,2661,2601,0.505701254275941,5333,2701,2632,0.506469154322145,0.0111070810043453,0.338686702969655,0.650206216026
9,"Bayern",9771113,"Aichach, St",20205,9809,10396,0.485473892600841,20888,10157,10731,0.486260053619303,0.0111070810043453,0.338686702969655,0.650206216026
9,"Bayern",9771114,"Aindling, M",4303,2154,2149,0.500580990006972,4316,2193,2123,0.508109360518999,0.0111070810043453,0.338686702969655,0.650206216026
9,"Bayern",9771122,"Dasing",5413,2739,2674,0.506004064289673,5423,2777,2646,0.512078185506177,0.0111070810043453,0.338686702969655,0.650206216026
9,"Bayern",9771129,"Eurasburg",1658,856,802,0.516284680337756,1669,843,826,0.505092869982025,0.0111070810043453,0.338686702969655,0.650206216026
9,"Bayern",9771130,"Friedberg, St",28653,13968,14685,0.487488221128678,28950,14127,14823,0.487979274611399,0.0111070810043453,0.338686702969655,0.650206216026
9,"Bayern",9771140,"Hollenbach",2301,1204,1097,0.523250760538896,2307,1209,1098,0.52405721716515,0.0111070810043453,0.338686702969655,0.650206216026
9,"Bayern",9771141,"Inchenhofen, M",2482,1237,1245,0.498388396454472,2499,1268,1231,0.507402961184474,0.0111070810043453,0.338686702969655,0.650206216026
9,"Bayern",9771142,"Kissing",11067,5409,5658,0.488750338845216,11278,5551,5727,0.492197198084767,0.0111070810043453,0.338686702969655,0.650206216026
9,"Bayern",9771144,"Kühbach, M",4095,2017,2078,0.492551892551893,4086,1996,2090,0.488497307880568,0.0111070810043453,0.338686702969655,0.650206216026
9,"Bayern",9771145,"Merching",3038,1511,1527,0.497366688610928,3081,1534,1547,0.49789029535865,0.0111070810043453,0.338686702969655,0.650206216026
9,"Bayern",9771146,"Mering, M",13357,6485,6872,0.48551321404507,13624,6710,6914,0.492513211978861,0.0111070810043453,0.338686702969655,0.650206216026
9,"Bayern",9771149,"Obergriesbach",1987,992,995,0.499245093105184,1986,989,997,0.497985901309164,0.0111070810043453,0.338686702969655,0.650206216026
9,"Bayern",9771155,"Petersdorf",1653,837,816,0.506352087114338,1652,834,818,0.504842615012107,0.0111070810043453,0.338686702969655,0.650206216026
9,"Bayern",9771156,"Pöttmes, M",6274,3149,3125,0.501912655403251,6324,3173,3151,0.501739405439595,0.0111070810043453,0.338686702969655,0.650206216026
9,"Bayern",9771158,"Rehling",2434,1223,1211,0.502465078060805,2454,1250,1204,0.509372453137734,0.0111070810043453,0.338686702969655,0.650206216026
9,"Bayern",9771160,"Ried",2940,1474,1466,0.501360544217687,2943,1469,1474,0.499150526673462,0.0111070810043453,0.338686702969655,0.650206216026
9,"Bayern",9771162,"Schiltberg",1869,951,918,0.508828250401284,1883,968,915,0.514073287307488,0.0111070810043453,0.338686702969655,0.650206216026
9,"Bayern",9771163,"Schmiechen",1215,612,603,0.503703703703704,1180,597,583,0.50593220338983,0.0111070810043453,0.338686702969655,0.650206216026
9,"Bayern",9771165,"Sielenbach",1576,800,776,0.50761421319797,1578,801,777,0.507604562737643,0.0111070810043453,0.338686702969655,0.650206216026
9,"Bayern",9771168,"Steindorf",898,465,433,0.517817371937639,880,458,422,0.520454545454546,0.0111070810043453,0.338686702969655,0.650206216026
9,"Bayern",9771169,"Todtenweis",1338,680,658,0.508221225710015,1370,693,677,0.505839416058394,0.0111070810043453,0.338686702969655,0.650206216026
9,"Bayern",9771176,"Baar (Schwaben)",1129,560,569,0.496014171833481,1142,571,571,0.5,0.0111070810043453,0.338686702969655,0.650206216026
9,"Bayern",9772111,"Adelsried",2198,1088,1110,0.494995450409463,2229,1088,1141,0.488111260655002,0.0111070810043453,0.338686702969655,0.650206216026
9,"Bayern",9772114,"Allmannshofen",805,424,381,0.526708074534161,821,428,393,0.521315468940317,0.0111070810043453,0.338686702969655,0.650206216026
9,"Bayern",9772115,"Altenmünster",3753,1880,1873,0.500932587263523,3728,1878,1850,0.503755364806867,0.0111070810043453,0.338686702969655,0.650206216026
9,"Bayern",9772117,"Aystetten",2932,1414,1518,0.482264665757162,2954,1436,1518,0.486120514556533,0.0111070810043453,0.338686702969655,0.650206216026
9,"Bayern",9772121,"Biberbach, M",3399,1680,1719,0.494263018534863,3408,1679,1729,0.492664319248826,0.0111070810043453,0.338686702969655,0.650206216026
9,"Bayern",9772125,"Bobingen, St",16409,8075,8334,0.492107989517947,16475,8061,8414,0.489286798179059,0.0111070810043453,0.338686702969655,0.650206216026
9,"Bayern",9772126,"Bonstetten",1219,604,615,0.495488105004102,1231,606,625,0.492282696994314,0.0111070810043453,0.338686702969655,0.650206216026
9,"Bayern",9772130,"Diedorf, M",9699,4682,5017,0.482730178368904,9843,4756,5087,0.483186020522199,0.0111070810043453,0.338686702969655,0.650206216026
9,"Bayern",9772131,"Dinkelscherben, M",6445,3203,3242,0.496974398758728,6458,3221,3237,0.498761226385878,0.0111070810043453,0.338686702969655,0.650206216026
9,"Bayern",9772134,"Ehingen",977,510,467,0.522006141248721,987,511,476,0.517730496453901,0.0111070810043453,0.338686702969655,0.650206216026
9,"Bayern",9772136,"Ellgau",1014,516,498,0.50887573964497,1016,519,497,0.510826771653543,0.0111070810043453,0.338686702969655,0.650206216026
9,"Bayern",9772137,"Emersacker",1349,681,668,0.504818383988139,1392,706,686,0.507183908045977,0.0111070810043453,0.338686702969655,0.650206216026
9,"Bayern",9772141,"Fischach, M",4551,2256,2295,0.495715227422544,4603,2281,2322,0.49554638279383,0.0111070810043453,0.338686702969655,0.650206216026
9,"Bayern",9772145,"Gablingen",4473,2243,2230,0.501453163424994,4616,2342,2274,0.50736568457539,0.0111070810043453,0.338686702969655,0.650206216026
9,"Bayern",9772147,"Gersthofen, St",20962,10175,10787,0.485402156282797,21045,10247,10798,0.486909004514136,0.0111070810043453,0.338686702969655,0.650206216026
9,"Bayern",9772148,"Gessertshausen",4090,2002,2088,0.489486552567237,4217,2078,2139,0.492767370168366,0.0111070810043453,0.338686702969655,0.650206216026
9,"Bayern",9772149,"Graben",3492,1743,1749,0.49914089347079,3449,1735,1714,0.503044360684256,0.0111070810043453,0.338686702969655,0.650206216026
9,"Bayern",9772151,"Großaitingen",4866,2429,2437,0.499177969584875,4854,2435,2419,0.50164812525752,0.0111070810043453,0.338686702969655,0.650206216026
9,"Bayern",9772156,"Heretsried",964,485,479,0.503112033195021,988,495,493,0.501012145748988,0.0111070810043453,0.338686702969655,0.650206216026
9,"Bayern",9772157,"Hiltenfingen",1454,736,718,0.506189821182944,1474,739,735,0.501356852103121,0.0111070810043453,0.338686702969655,0.650206216026
9,"Bayern",9772159,"Horgau",2515,1284,1231,0.510536779324056,2583,1309,1274,0.506775067750677,0.0111070810043453,0.338686702969655,0.650206216026
9,"Bayern",9772160,"Kleinaitingen",1166,595,571,0.510291595197256,1255,666,589,0.530677290836653,0.0111070810043453,0.338686702969655,0.650206216026
9,"Bayern",9772162,"Klosterlechfeld",2714,1376,1338,0.507000736919676,2656,1330,1326,0.500753012048193,0.0111070810043453,0.338686702969655,0.650206216026
9,"Bayern",9772163,"Königsbrunn, St",27103,13316,13787,0.491310924989854,27509,13593,13916,0.494129194081937,0.0111070810043453,0.338686702969655,0.650206216026
9,"Bayern",9772166,"Kühlenthal",838,421,417,0.502386634844869,838,424,414,0.505966587112172,0.0111070810043453,0.338686702969655,0.650206216026
9,"Bayern",9772167,"Kutzenhausen",2459,1220,1239,0.496136640910939,2469,1212,1257,0.490886998784933,0.0111070810043453,0.338686702969655,0.650206216026
9,"Bayern",9772168,"Langenneufnach",1653,820,833,0.496067755595886,1630,817,813,0.501226993865031,0.0111070810043453,0.338686702969655,0.650206216026
9,"Bayern",9772170,"Langerringen",3715,1885,1830,0.507402422611036,3765,1896,1869,0.503585657370518,0.0111070810043453,0.338686702969655,0.650206216026
9,"Bayern",9772171,"Langweid a.Lech",7316,3672,3644,0.50191361399672,7431,3737,3694,0.502893284887633,0.0111070810043453,0.338686702969655,0.650206216026
9,"Bayern",9772177,"Meitingen, M",10779,5333,5446,0.494758326375359,11032,5444,5588,0.493473531544598,0.0111070810043453,0.338686702969655,0.650206216026
9,"Bayern",9772178,"Mickhausen",1344,680,664,0.505952380952381,1359,681,678,0.501103752759382,0.0111070810043453,0.338686702969655,0.650206216026
9,"Bayern",9772179,"Mittelneufnach",1073,544,529,0.506989748369059,1064,547,517,0.514097744360902,0.0111070810043453,0.338686702969655,0.650206216026
9,"Bayern",9772184,"Neusäß, St",21087,10148,10939,0.481244368568312,21616,10524,11092,0.486861584011843,0.0111070810043453,0.338686702969655,0.650206216026
9,"Bayern",9772185,"Nordendorf",2288,1167,1121,0.510052447552448,2268,1154,1114,0.508818342151676,0.0111070810043453,0.338686702969655,0.650206216026
9,"Bayern",9772186,"Oberottmarshausen",1634,815,819,0.498776009791922,1661,811,850,0.488260084286574,0.0111070810043453,0.338686702969655,0.650206216026
9,"Bayern",9772197,"Scherstetten",1001,495,506,0.494505494505495,997,500,497,0.501504513540622,0.0111070810043453,0.338686702969655,0.650206216026
9,"Bayern",9772200,"Schwabmünchen, St",13214,6418,6796,0.485696988042985,13435,6571,6864,0.489095645701526,0.0111070810043453,0.338686702969655,0.650206216026
9,"Bayern",9772202,"Stadtbergen, St",14431,6911,7520,0.478899591157924,14854,7114,7740,0.478928234818904,0.0111070810043453,0.338686702969655,0.650206216026
9,"Bayern",9772207,"Thierhaupten, M",3893,1977,1916,0.507834574877986,3845,1954,1891,0.508192457737321,0.0111070810043453,0.338686702969655,0.650206216026
9,"Bayern",9772209,"Untermeitingen",6296,3087,3209,0.490311308767471,6468,3174,3294,0.490723562152134,0.0111070810043453,0.338686702969655,0.650206216026
9,"Bayern",9772211,"Ustersbach",1088,542,546,0.498161764705882,1132,551,581,0.486749116607774,0.0111070810043453,0.338686702969655,0.650206216026
9,"Bayern",9772214,"Walkertshofen",1145,565,580,0.493449781659389,1133,545,588,0.481023830538394,0.0111070810043453,0.338686702969655,0.650206216026
9,"Bayern",9772215,"Wehringen",2918,1464,1454,0.501713502398903,2959,1492,1467,0.504224400135181,0.0111070810043453,0.338686702969655,0.650206216026
9,"Bayern",9772216,"Welden, M",3557,1785,1772,0.501827382625808,3578,1788,1790,0.499720514253773,0.0111070810043453,0.338686702969655,0.650206216026
9,"Bayern",9772217,"Westendorf",1507,749,758,0.497013934970139,1519,763,756,0.502304147465438,0.0111070810043453,0.338686702969655,0.650206216026
9,"Bayern",9772223,"Zusmarshausen, M",6054,2968,3086,0.490254377271226,6106,3035,3071,0.497052079921389,0.0111070810043453,0.338686702969655,0.650206216026
9,"Bayern",9773111,"Aislingen, M",1352,692,660,0.511834319526627,1351,691,660,0.511472982975574,0.0111070810043453,0.338686702969655,0.650206216026
9,"Bayern",9773112,"Bachhagel",2231,1118,1113,0.501120573733752,2257,1130,1127,0.500664599025255,0.0111070810043453,0.338686702969655,0.650206216026
9,"Bayern",9773113,"Bächingen a.d.Brenz",1300,657,643,0.505384615384615,1297,661,636,0.509637625289129,0.0111070810043453,0.338686702969655,0.650206216026
9,"Bayern",9773116,"Binswangen",1315,680,635,0.517110266159696,1343,708,635,0.527177959791511,0.0111070810043453,0.338686702969655,0.650206216026
9,"Bayern",9773117,"Bissingen, M",3552,1797,1755,0.505912162162162,3496,1772,1724,0.506864988558352,0.0111070810043453,0.338686702969655,0.650206216026
9,"Bayern",9773119,"Blindheim",1732,874,858,0.504618937644342,1710,872,838,0.509941520467836,0.0111070810043453,0.338686702969655,0.650206216026
9,"Bayern",9773122,"Buttenwiesen",5678,2914,2764,0.513208876364917,5703,2939,2764,0.515342802034017,0.0111070810043453,0.338686702969655,0.650206216026
9,"Bayern",9773125,"Dillingen a.d.Donau, GKSt",18090,8806,9284,0.486788280818132,18120,8908,9212,0.491611479028698,0.0111070810043453,0.338686702969655,0.650206216026
9,"Bayern",9773133,"Glött",1100,556,544,0.505454545454545,1087,536,551,0.49310027598896,0.0111070810043453,0.338686702969655,0.650206216026
9,"Bayern",9773136,"Gundelfingen a.d.Donau, St",7694,3794,3900,0.493111515466597,7732,3828,3904,0.495085359544749,0.0111070810043453,0.338686702969655,0.650206216026
9,"Bayern",9773137,"Haunsheim",1570,757,813,0.482165605095541,1581,759,822,0.480075901328273,0.0111070810043453,0.338686702969655,0.650206216026
9,"Bayern",9773139,"Höchstädt a.d.Donau, St",6527,3219,3308,0.493182166385782,6486,3208,3278,0.494603761948813,0.0111070810043453,0.338686702969655,0.650206216026
9,"Bayern",9773140,"Holzheim",3759,1870,1889,0.497472732109604,3722,1875,1847,0.503761418592155,0.0111070810043453,0.338686702969655,0.650206216026
9,"Bayern",9773143,"Laugna",1546,804,742,0.520051746442432,1547,823,724,0.531997414350356,0.0111070810043453,0.338686702969655,0.650206216026
9,"Bayern",9773144,"Lauingen (Donau), St",10602,5130,5472,0.483870967741935,10675,5186,5489,0.485807962529274,0.0111070810043453,0.338686702969655,0.650206216026
9,"Bayern",9773146,"Lutzingen",978,483,495,0.493865030674847,979,481,498,0.491317671092952,0.0111070810043453,0.338686702969655,0.650206216026
9,"Bayern",9773147,"Mödingen",1319,638,681,0.483699772554966,1334,655,679,0.491004497751124,0.0111070810043453,0.338686702969655,0.650206216026
9,"Bayern",9773150,"Finningen",1649,853,796,0.51728320194057,1637,859,778,0.524740378741601,0.0111070810043453,0.338686702969655,0.650206216026
9,"Bayern",9773153,"Medlingen",992,512,480,0.516129032258065,992,513,479,0.517137096774194,0.0111070810043453,0.338686702969655,0.650206216026
9,"Bayern",9773164,"Schwenningen",1416,728,688,0.514124293785311,1404,722,682,0.514245014245014,0.0111070810043453,0.338686702969655,0.650206216026
9,"Bayern",9773170,"Syrgenstein",3550,1735,1815,0.488732394366197,3545,1729,1816,0.487729196050776,0.0111070810043453,0.338686702969655,0.650206216026
9,"Bayern",9773179,"Villenbach",1197,602,595,0.502923976608187,1222,614,608,0.502454991816694,0.0111070810043453,0.338686702969655,0.650206216026
9,"Bayern",9773182,"Wertingen, St",8821,4319,4502,0.489627026414239,8744,4311,4433,0.493023787740165,0.0111070810043453,0.338686702969655,0.650206216026
9,"Bayern",9773183,"Wittislingen, M",2282,1109,1173,0.485977212971078,2242,1097,1145,0.489295272078501,0.0111070810043453,0.338686702969655,0.650206216026
9,"Bayern",9773186,"Ziertheim",1004,496,508,0.49402390438247,999,498,501,0.498498498498498,0.0111070810043453,0.338686702969655,0.650206216026
9,"Bayern",9773187,"Zöschingen",739,349,390,0.472259810554804,736,349,387,0.474184782608696,0.0111070810043453,0.338686702969655,0.650206216026
9,"Bayern",9773188,"Zusamaltheim",1217,626,591,0.514379622021364,1280,662,618,0.5171875,0.0111070810043453,0.338686702969655,0.650206216026
9,"Bayern",9774111,"Aletshausen",1102,576,526,0.522686025408348,1097,572,525,0.521422060164084,0.0111070810043453,0.338686702969655,0.650206216026
9,"Bayern",9774115,"Balzhausen",1184,618,566,0.521959459459459,1180,606,574,0.513559322033898,0.0111070810043453,0.338686702969655,0.650206216026
9,"Bayern",9774116,"Ursberg",3245,1598,1647,0.492449922958398,3271,1587,1684,0.485172730051972,0.0111070810043453,0.338686702969655,0.650206216026
9,"Bayern",9774117,"Breitenthal",1226,606,620,0.494290375203915,1210,585,625,0.483471074380165,0.0111070810043453,0.338686702969655,0.650206216026
9,"Bayern",9774118,"Bubesheim",1441,725,716,0.503122831367106,1482,750,732,0.506072874493927,0.0111070810043453,0.338686702969655,0.650206216026
9,"Bayern",9774119,"Bibertal",4710,2359,2351,0.500849256900212,4700,2348,2352,0.499574468085106,0.0111070810043453,0.338686702969655,0.650206216026
9,"Bayern",9774121,"Burgau, St",9327,4634,4693,0.496837139487509,9299,4625,4674,0.497365308097645,0.0111070810043453,0.338686702969655,0.650206216026
9,"Bayern",9774122,"Burtenbach, M",3274,1625,1649,0.496334758704948,3157,1556,1601,0.492872980677859,0.0111070810043453,0.338686702969655,0.650206216026
9,"Bayern",9774124,"Deisenhausen",1482,738,744,0.497975708502024,1503,742,761,0.493679308050566,0.0111070810043453,0.338686702969655,0.650206216026
9,"Bayern",9774127,"Dürrlauingen",1571,851,720,0.541693189051559,1614,911,703,0.564436183395291,0.0111070810043453,0.338686702969655,0.650206216026
9,"Bayern",9774129,"Ebershausen",610,316,294,0.518032786885246,613,316,297,0.515497553017945,0.0111070810043453,0.338686702969655,0.650206216026
9,"Bayern",9774133,"Ellzee",1151,581,570,0.504778453518679,1141,572,569,0.501314636283961,0.0111070810043453,0.338686702969655,0.650206216026
9,"Bayern",9774135,"Günzburg, GKSt",19454,9351,10103,0.480672355299681,19517,9449,10068,0.484142030025106,0.0111070810043453,0.338686702969655,0.650206216026
9,"Bayern",9774136,"Gundremmingen",1568,872,696,0.556122448979592,1593,901,692,0.565599497802888,0.0111070810043453,0.338686702969655,0.650206216026
9,"Bayern",9774140,"Haldenwang",1836,911,925,0.496187363834423,1784,885,899,0.496076233183857,0.0111070810043453,0.338686702969655,0.650206216026
9,"Bayern",9774143,"Ichenhausen, St",8420,4213,4207,0.500356294536817,8400,4194,4206,0.499285714285714,0.0111070810043453,0.338686702969655,0.650206216026
9,"Bayern",9774144,"Jettingen-Scheppach, M",6754,3341,3413,0.494669825288718,6669,3316,3353,0.497225970910181,0.0111070810043453,0.338686702969655,0.650206216026
9,"Bayern",9774145,"Kammeltal",3307,1663,1644,0.50287269428485,3345,1670,1675,0.499252615844544,0.0111070810043453,0.338686702969655,0.650206216026
9,"Bayern",9774148,"Kötz",3238,1658,1580,0.512044471896232,3178,1620,1558,0.509754562617999,0.0111070810043453,0.338686702969655,0.650206216026
9,"Bayern",9774150,"Krumbach (Schwaben), St",12404,5999,6405,0.483634311512415,12455,6039,6416,0.484865515857085,0.0111070810043453,0.338686702969655,0.650206216026
9,"Bayern",9774151,"Landensberg",683,343,340,0.502196193265007,679,344,335,0.506627393225331,0.0111070810043453,0.338686702969655,0.650206216026
9,"Bayern",9774155,"Leipheim, St",6568,3299,3269,0.502283800243605,6656,3379,3277,0.507662259615385,0.0111070810043453,0.338686702969655,0.650206216026
9,"Bayern",9774160,"Münsterhausen, M",1949,1014,935,0.520266803488969,1942,1009,933,0.51956745623069,0.0111070810043453,0.338686702969655,0.650206216026
9,"Bayern",9774162,"Neuburg a.d.Kammel, M",3125,1591,1534,0.50912,3167,1610,1557,0.50836754025892,0.0111070810043453,0.338686702969655,0.650206216026
9,"Bayern",9774166,"Aichen",1140,566,574,0.496491228070175,1159,581,578,0.501294219154443,0.0111070810043453,0.338686702969655,0.650206216026
9,"Bayern",9774171,"Offingen, M",4124,2113,2011,0.512366634335596,4123,2124,1999,0.515158864904196,0.0111070810043453,0.338686702969655,0.650206216026
9,"Bayern",9774174,"Rettenbach",1636,832,804,0.508557457212714,1608,824,784,0.512437810945274,0.0111070810043453,0.338686702969655,0.650206216026
9,"Bayern",9774178,"Röfingen",1070,547,523,0.511214953271028,1096,558,538,0.509124087591241,0.0111070810043453,0.338686702969655,0.650206216026
9,"Bayern",9774185,"Thannhausen, St",5934,2888,3046,0.486686889113583,5936,2927,3009,0.493092991913747,0.0111070810043453,0.338686702969655,0.650206216026
9,"Bayern",9774189,"Wiesenbach",968,491,477,0.507231404958678,984,490,494,0.497967479674797,0.0111070810043453,0.338686702969655,0.650206216026
9,"Bayern",9774191,"Waldstetten, M",1228,633,595,0.515472312703583,1212,626,586,0.516501650165016,0.0111070810043453,0.338686702969655,0.650206216026
9,"Bayern",9774192,"Waltenhausen",699,358,341,0.512160228898426,680,355,325,0.522058823529412,0.0111070810043453,0.338686702969655,0.650206216026
9,"Bayern",9774196,"Winterbach",763,379,384,0.496723460026212,798,400,398,0.50125313283208,0.0111070810043453,0.338686702969655,0.650206216026
9,"Bayern",9774198,"Ziemetshausen, M",2943,1484,1459,0.504247366632688,2936,1488,1448,0.506811989100817,0.0111070810043453,0.338686702969655,0.650206216026
9,"Bayern",9775111,"Altenstadt, M",4935,2485,2450,0.50354609929078,4804,2410,2394,0.501665278934222,0.0111070810043453,0.338686702969655,0.650206216026
9,"Bayern",9775115,"Bellenberg",4509,2211,2298,0.490352628077179,4604,2272,2332,0.493483927019983,0.0111070810043453,0.338686702969655,0.650206216026
9,"Bayern",9775118,"Buch, M",3742,1862,1880,0.497594869053982,3667,1821,1846,0.496591218980093,0.0111070810043453,0.338686702969655,0.650206216026
9,"Bayern",9775126,"Holzheim",1751,879,872,0.501998857795545,1752,877,875,0.500570776255708,0.0111070810043453,0.338686702969655,0.650206216026
9,"Bayern",9775129,"Illertissen, St",16455,7982,8473,0.485080522637496,16327,8015,8312,0.490904636491701,0.0111070810043453,0.338686702969655,0.650206216026
9,"Bayern",9775132,"Kellmünz a.d.Iller, M",1349,676,673,0.501111934766494,1332,671,661,0.503753753753754,0.0111070810043453,0.338686702969655,0.650206216026
9,"Bayern",9775134,"Nersingen",9252,4612,4640,0.498486813661911,9175,4564,4611,0.497438692098093,0.0111070810043453,0.338686702969655,0.650206216026
9,"Bayern",9775135,"Neu-Ulm, GKSt",53300,25985,27315,0.487523452157599,54314,27029,27285,0.49764333321059,0.0111070810043453,0.338686702969655,0.650206216026
9,"Bayern",9775139,"Elchingen",9112,4464,4648,0.48990342405619,9164,4485,4679,0.489415102575295,0.0111070810043453,0.338686702969655,0.650206216026
9,"Bayern",9775141,"Oberroth",864,452,412,0.523148148148148,842,444,398,0.527315914489311,0.0111070810043453,0.338686702969655,0.650206216026
9,"Bayern",9775142,"Osterberg",835,419,416,0.501796407185629,835,428,407,0.512574850299401,0.0111070810043453,0.338686702969655,0.650206216026
9,"Bayern",9775143,"Pfaffenhofen a.d.Roth, M",7057,3596,3461,0.509564970950829,7003,3597,3406,0.513637012708839,0.0111070810043453,0.338686702969655,0.650206216026
9,"Bayern",9775149,"Roggenburg",2645,1322,1323,0.499810964083176,2700,1374,1326,0.508888888888889,0.0111070810043453,0.338686702969655,0.650206216026
9,"Bayern",9775152,"Senden, St",21536,10502,11034,0.487648588410104,22332,11050,11282,0.494805660039405,0.0111070810043453,0.338686702969655,0.650206216026
9,"Bayern",9775161,"Unterroth",971,517,454,0.532440782698249,963,515,448,0.53478712357217,0.0111070810043453,0.338686702969655,0.650206216026
9,"Bayern",9775162,"Vöhringen, St",12935,6341,6594,0.490220332431388,13084,6466,6618,0.494191378783247,0.0111070810043453,0.338686702969655,0.650206216026
9,"Bayern",9775164,"Weißenhorn, St",13140,6509,6631,0.495357686453577,13248,6589,6659,0.49735809178744,0.0111070810043453,0.338686702969655,0.650206216026
9,"Bayern",9776111,"Bodolz",2922,1415,1507,0.48425735797399,3188,1526,1662,0.478670012547051,0.0111070810043453,0.338686702969655,0.650206216026
9,"Bayern",9776112,"Gestratz",1224,635,589,0.518790849673203,1196,618,578,0.516722408026756,0.0111070810043453,0.338686702969655,0.650206216026
9,"Bayern",9776113,"Grünenbach",1429,718,711,0.502449265220434,1411,710,701,0.503189227498228,0.0111070810043453,0.338686702969655,0.650206216026
9,"Bayern",9776114,"Heimenkirch, M",3671,1846,1825,0.502860256061019,3673,1840,1833,0.500952899537163,0.0111070810043453,0.338686702969655,0.650206216026
9,"Bayern",9776115,"Hergensweiler",1808,935,873,0.517146017699115,1783,908,875,0.509254066180595,0.0111070810043453,0.338686702969655,0.650206216026
9,"Bayern",9776116,"Lindau (Bodensee), GKSt",24487,11581,12906,0.472944827867848,24813,11787,13026,0.475033248700278,0.0111070810043453,0.338686702969655,0.650206216026
9,"Bayern",9776117,"Lindenberg i.Allgäu, St",10886,5289,5597,0.485853389674812,11110,5370,5740,0.483348334833483,0.0111070810043453,0.338686702969655,0.650206216026
9,"Bayern",9776118,"Maierhöfen",1550,812,738,0.523870967741936,1610,837,773,0.519875776397515,0.0111070810043453,0.338686702969655,0.650206216026
9,"Bayern",9776120,"Nonnenhorn",1681,793,888,0.471743010113028,1669,784,885,0.469742360695027,0.0111070810043453,0.338686702969655,0.650206216026
9,"Bayern",9776121,"Oberreute",1611,801,810,0.497206703910615,1623,803,820,0.494762784966112,0.0111070810043453,0.338686702969655,0.650206216026
9,"Bayern",9776122,"Opfenbach",2331,1201,1130,0.515229515229515,2309,1203,1106,0.521004763967085,0.0111070810043453,0.338686702969655,0.650206216026
9,"Bayern",9776124,"Röthenbach (Allgäu)",1679,821,858,0.488981536628946,1699,846,853,0.497939964685109,0.0111070810043453,0.338686702969655,0.650206216026
9,"Bayern",9776125,"Scheidegg, M",4048,1975,2073,0.487895256916996,4252,2080,2172,0.489181561618062,0.0111070810043453,0.338686702969655,0.650206216026
9,"Bayern",9776126,"Sigmarszell",2845,1428,1417,0.501933216168717,2816,1406,1410,0.499289772727273,0.0111070810043453,0.338686702969655,0.650206216026
9,"Bayern",9776127,"Stiefenhofen",1775,871,904,0.490704225352113,1774,860,914,0.4847801578354,0.0111070810043453,0.338686702969655,0.650206216026
9,"Bayern",9776128,"Wasserburg (Bodensee)",3557,1687,1870,0.474276075344391,3527,1707,1820,0.483980720158775,0.0111070810043453,0.338686702969655,0.650206216026
9,"Bayern",9776129,"Weiler-Simmerberg, M",5940,2968,2972,0.4996632996633,6426,3229,3197,0.502489884842826,0.0111070810043453,0.338686702969655,0.650206216026
9,"Bayern",9776130,"Weißensberg",2590,1296,1294,0.5003861003861,2679,1374,1305,0.512877939529675,0.0111070810043453,0.338686702969655,0.650206216026
9,"Bayern",9776131,"Hergatz",2421,1224,1197,0.505576208178439,2337,1188,1149,0.508344030808729,0.0111070810043453,0.338686702969655,0.650206216026
9,"Bayern",9777111,"Aitrang",2000,1008,992,0.504,2010,1019,991,0.506965174129353,0.0111070810043453,0.338686702969655,0.650206216026
9,"Bayern",9777112,"Biessenhofen",4007,2018,1989,0.503618667332169,3944,1988,1956,0.504056795131846,0.0111070810043453,0.338686702969655,0.650206216026
9,"Bayern",9777114,"Baisweil",1298,646,652,0.49768875192604,1307,655,652,0.50114766641163,0.0111070810043453,0.338686702969655,0.650206216026
9,"Bayern",9777118,"Bidingen",1629,846,783,0.519337016574586,1648,857,791,0.52002427184466,0.0111070810043453,0.338686702969655,0.650206216026
9,"Bayern",9777121,"Buchloe, St",12014,5874,6140,0.488929582154153,12167,5938,6229,0.488041423522643,0.0111070810043453,0.338686702969655,0.650206216026
9,"Bayern",9777124,"Eggenthal",1293,679,614,0.525135344160866,1293,683,610,0.528228924980665,0.0111070810043453,0.338686702969655,0.650206216026
9,"Bayern",9777125,"Eisenberg",1176,597,579,0.50765306122449,1174,596,578,0.507666098807496,0.0111070810043453,0.338686702969655,0.650206216026
9,"Bayern",9777128,"Friesenried",1518,755,763,0.497364953886693,1500,748,752,0.498666666666667,0.0111070810043453,0.338686702969655,0.650206216026
9,"Bayern",9777129,"Füssen, St",14288,6710,7578,0.469624860022396,14222,6789,7433,0.477359021234707,0.0111070810043453,0.338686702969655,0.650206216026
9,"Bayern",9777130,"Germaringen",3739,1887,1852,0.504680395827761,3793,1926,1867,0.507777484840496,0.0111070810043453,0.338686702969655,0.650206216026
9,"Bayern",9777131,"Görisried",1292,659,633,0.510061919504644,1298,655,643,0.50462249614792,0.0111070810043453,0.338686702969655,0.650206216026
9,"Bayern",9777135,"Hopferau",1115,575,540,0.515695067264574,1106,574,532,0.518987341772152,0.0111070810043453,0.338686702969655,0.650206216026
9,"Bayern",9777138,"Günzach",1449,723,726,0.498964803312629,1488,746,742,0.501344086021505,0.0111070810043453,0.338686702969655,0.650206216026
9,"Bayern",9777139,"Irsee, M",1420,683,737,0.480985915492958,1424,681,743,0.478230337078652,0.0111070810043453,0.338686702969655,0.650206216026
9,"Bayern",9777140,"Jengen",2380,1203,1177,0.50546218487395,2363,1206,1157,0.510368176047397,0.0111070810043453,0.338686702969655,0.650206216026
9,"Bayern",9777141,"Kaltental, M",1653,850,803,0.514216575922565,1611,808,803,0.50155183116077,0.0111070810043453,0.338686702969655,0.650206216026
9,"Bayern",9777144,"Kraftisried",733,367,366,0.500682128240109,750,381,369,0.508,0.0111070810043453,0.338686702969655,0.650206216026
9,"Bayern",9777145,"Lamerdingen",1817,907,910,0.499174463401211,1787,898,889,0.502518186905428,0.0111070810043453,0.338686702969655,0.650206216026
9,"Bayern",9777147,"Lechbruck am See",2589,1263,1326,0.487833140208575,2533,1243,1290,0.490722463482037,0.0111070810043453,0.338686702969655,0.650206216026
9,"Bayern",9777149,"Lengenwang",1381,714,667,0.517016654598117,1362,713,649,0.523494860499266,0.0111070810043453,0.338686702969655,0.650206216026
9,"Bayern",9777151,"Marktoberdorf, St",18072,8874,9198,0.491035856573705,18151,8900,9251,0.490331111233541,0.0111070810043453,0.338686702969655,0.650206216026
9,"Bayern",9777152,"Mauerstetten",3033,1489,1544,0.490933069568084,3001,1477,1524,0.492169276907697,0.0111070810043453,0.338686702969655,0.650206216026
9,"Bayern",9777153,"Nesselwang, M",3407,1613,1794,0.473437041385383,3516,1666,1850,0.473833902161547,0.0111070810043453,0.338686702969655,0.650206216026
9,"Bayern",9777154,"Obergünzburg, M",6210,3071,3139,0.494524959742351,6267,3097,3170,0.494175841710547,0.0111070810043453,0.338686702969655,0.650206216026
9,"Bayern",9777155,"Oberostendorf",1304,658,646,0.504601226993865,1302,652,650,0.500768049155146,0.0111070810043453,0.338686702969655,0.650206216026
9,"Bayern",9777157,"Osterzell",657,355,302,0.540334855403349,656,352,304,0.536585365853659,0.0111070810043453,0.338686702969655,0.650206216026
9,"Bayern",9777158,"Pforzen",2163,1074,1089,0.496532593619972,2136,1062,1074,0.497191011235955,0.0111070810043453,0.338686702969655,0.650206216026
9,"Bayern",9777159,"Pfronten",7994,3858,4136,0.482611958969227,7951,3832,4119,0.481951955728839,0.0111070810043453,0.338686702969655,0.650206216026
9,"Bayern",9777163,"Rieden am Forggensee",1230,616,614,0.500813008130081,1275,632,643,0.495686274509804,0.0111070810043453,0.338686702969655,0.650206216026
9,"Bayern",9777164,"Rieden",1338,658,680,0.491778774289985,1333,664,669,0.498124531132783,0.0111070810043453,0.338686702969655,0.650206216026
9,"Bayern",9777165,"Ronsberg, M",1669,851,818,0.509886159376872,1631,847,784,0.51931330472103,0.0111070810043453,0.338686702969655,0.650206216026
9,"Bayern",9777166,"Roßhaupten",2164,1060,1104,0.489833641404806,2125,1040,1085,0.489411764705882,0.0111070810043453,0.338686702969655,0.650206216026
9,"Bayern",9777167,"Ruderatshofen",1746,874,872,0.50057273768614,1746,875,871,0.501145475372279,0.0111070810043453,0.338686702969655,0.650206216026
9,"Bayern",9777168,"Rückholz",790,414,376,0.524050632911392,793,414,379,0.522068095838588,0.0111070810043453,0.338686702969655,0.650206216026
9,"Bayern",9777169,"Schwangau",3127,1501,1626,0.48001279181324,3396,1667,1729,0.490871613663133,0.0111070810043453,0.338686702969655,0.650206216026
9,"Bayern",9777170,"Seeg",2807,1382,1425,0.492340577128607,2811,1395,1416,0.496264674493063,0.0111070810043453,0.338686702969655,0.650206216026
9,"Bayern",9777171,"Stötten a.Auerberg",1829,913,916,0.499179879715692,1827,916,911,0.501368363437329,0.0111070810043453,0.338686702969655,0.650206216026
9,"Bayern",9777172,"Stöttwang",1811,912,899,0.503589177250138,1795,921,874,0.513091922005571,0.0111070810043453,0.338686702969655,0.650206216026
9,"Bayern",9777173,"Halblech",3396,1688,1708,0.497055359246172,3395,1685,1710,0.496318114874816,0.0111070810043453,0.338686702969655,0.650206216026
9,"Bayern",9777175,"Unterthingau, M",2707,1388,1319,0.512744735869967,2720,1405,1315,0.516544117647059,0.0111070810043453,0.338686702969655,0.650206216026
9,"Bayern",9777176,"Untrasried",1504,786,718,0.522606382978723,1521,798,723,0.52465483234714,0.0111070810043453,0.338686702969655,0.650206216026
9,"Bayern",9777177,"Waal, M",2178,1102,1076,0.505968778696051,2191,1103,1088,0.503423094477408,0.0111070810043453,0.338686702969655,0.650206216026
9,"Bayern",9777179,"Wald",1078,557,521,0.51669758812616,1046,549,497,0.524856596558317,0.0111070810043453,0.338686702969655,0.650206216026
9,"Bayern",9777182,"Westendorf",1794,887,907,0.494425863991081,1788,903,885,0.50503355704698,0.0111070810043453,0.338686702969655,0.650206216026
9,"Bayern",9777183,"Rettenbach a.Auerberg",808,422,386,0.522277227722772,826,430,396,0.520581113801453,0.0111070810043453,0.338686702969655,0.650206216026
9,"Bayern",9778111,"Amberg",1439,723,716,0.502432244614315,1392,684,708,0.491379310344828,0.0111070810043453,0.338686702969655,0.650206216026
9,"Bayern",9778113,"Apfeltrach",908,463,445,0.509911894273128,947,494,453,0.521647307286167,0.0111070810043453,0.338686702969655,0.650206216026
9,"Bayern",9778115,"Babenhausen, M",5247,2616,2631,0.498570611778159,5205,2601,2604,0.49971181556196,0.0111070810043453,0.338686702969655,0.650206216026
9,"Bayern",9778116,"Bad Wörishofen, St",14186,6434,7752,0.453545749330326,14333,6530,7803,0.455591990511407,0.0111070810043453,0.338686702969655,0.650206216026
9,"Bayern",9778118,"Benningen",2033,995,1038,0.489424495818987,2017,997,1020,0.494298463063956,0.0111070810043453,0.338686702969655,0.650206216026
9,"Bayern",9778119,"Böhen",749,414,335,0.552736982643525,728,408,320,0.56043956043956,0.0111070810043453,0.338686702969655,0.650206216026
9,"Bayern",9778120,"Boos",1940,957,983,0.493298969072165,1894,931,963,0.49155227032735,0.0111070810043453,0.338686702969655,0.650206216026
9,"Bayern",9778121,"Breitenbrunn",2356,1212,1144,0.514431239388795,2310,1203,1107,0.520779220779221,0.0111070810043453,0.338686702969655,0.650206216026
9,"Bayern",9778123,"Buxheim",3051,1557,1494,0.510324483775811,3042,1540,1502,0.506245890861275,0.0111070810043453,0.338686702969655,0.650206216026
9,"Bayern",9778127,"Dirlewang, M",2064,1028,1036,0.498062015503876,2104,1055,1049,0.501425855513308,0.0111070810043453,0.338686702969655,0.650206216026
9,"Bayern",9778130,"Egg a.d.Günz",1151,581,570,0.504778453518679,1140,576,564,0.505263157894737,0.0111070810043453,0.338686702969655,0.650206216026
9,"Bayern",9778134,"Eppishausen",1782,911,871,0.511223344556678,1756,899,857,0.511958997722096,0.0111070810043453,0.338686702969655,0.650206216026
9,"Bayern",9778136,"Erkheim, M",2908,1454,1454,0.5,2891,1432,1459,0.49533033552404,0.0111070810043453,0.338686702969655,0.650206216026
9,"Bayern",9778137,"Ettringen",3286,1682,1604,0.511868533171029,3307,1693,1614,0.511944360447536,0.0111070810043453,0.338686702969655,0.650206216026
9,"Bayern",9778139,"Fellheim",1042,528,514,0.506717850287908,1108,552,556,0.498194945848375,0.0111070810043453,0.338686702969655,0.650206216026
9,"Bayern",9778144,"Bad Grönenbach, M",5265,2595,2670,0.492877492877493,5273,2573,2700,0.48795751943865,0.0111070810043453,0.338686702969655,0.650206216026
9,"Bayern",9778149,"Hawangen",1273,645,628,0.506677140612726,1254,634,620,0.505582137161085,0.0111070810043453,0.338686702969655,0.650206216026
9,"Bayern",9778150,"Heimertingen",1687,845,842,0.500889152341434,1685,826,859,0.490207715133531,0.0111070810043453,0.338686702969655,0.650206216026
9,"Bayern",9778151,"Holzgünz",1218,590,628,0.48440065681445,1202,579,623,0.481697171381032,0.0111070810043453,0.338686702969655,0.650206216026
9,"Bayern",9778157,"Kirchhaslach",1309,686,623,0.524064171122995,1303,691,612,0.53031465848043,0.0111070810043453,0.338686702969655,0.650206216026
9,"Bayern",9778158,"Kirchheim i.Schw., M",2548,1266,1282,0.496860282574568,2467,1216,1251,0.492906364004864,0.0111070810043453,0.338686702969655,0.650206216026
9,"Bayern",9778161,"Kronburg",1765,870,895,0.492917847025496,1772,879,893,0.496049661399549,0.0111070810043453,0.338686702969655,0.650206216026
9,"Bayern",9778162,"Lachen",1455,738,717,0.507216494845361,1421,714,707,0.502463054187192,0.0111070810043453,0.338686702969655,0.650206216026
9,"Bayern",9778163,"Lauben",1347,678,669,0.503340757238307,1311,656,655,0.500381388253242,0.0111070810043453,0.338686702969655,0.650206216026
9,"Bayern",9778164,"Lautrach",1169,541,628,0.46278870829769,1186,548,638,0.462057335581788,0.0111070810043453,0.338686702969655,0.650206216026
9,"Bayern",9778165,"Legau, M",3116,1565,1551,0.502246469833119,3084,1564,1520,0.507133592736706,0.0111070810043453,0.338686702969655,0.650206216026
9,"Bayern",9778168,"Markt Rettenbach, M",3680,1836,1844,0.498913043478261,3635,1827,1808,0.502613480055021,0.0111070810043453,0.338686702969655,0.650206216026
9,"Bayern",9778169,"Markt Wald, M",2173,1126,1047,0.518177634606535,2273,1178,1095,0.518257809062912,0.0111070810043453,0.338686702969655,0.650206216026
9,"Bayern",9778171,"Memmingerberg",2631,1270,1361,0.48270619536298,2625,1273,1352,0.484952380952381,0.0111070810043453,0.338686702969655,0.650206216026
9,"Bayern",9778173,"Mindelheim, St",13989,6872,7117,0.491243119593967,14205,7021,7184,0.494262583597325,0.0111070810043453,0.338686702969655,0.650206216026
9,"Bayern",9778177,"Niederrieden",1380,718,662,0.520289855072464,1362,712,650,0.522760646108664,0.0111070810043453,0.338686702969655,0.650206216026
9,"Bayern",9778180,"Kammlach",1785,920,865,0.515406162464986,1777,907,870,0.510410804727068,0.0111070810043453,0.338686702969655,0.650206216026
9,"Bayern",9778183,"Oberrieden",1241,661,580,0.532634971796938,1237,659,578,0.532740501212611,0.0111070810043453,0.338686702969655,0.650206216026
9,"Bayern",9778184,"Oberschönegg",934,493,441,0.527837259100642,936,492,444,0.525641025641026,0.0111070810043453,0.338686702969655,0.650206216026
9,"Bayern",9778186,"Ottobeuren, M",7900,3892,4008,0.492658227848101,7888,3898,3990,0.494168356997972,0.0111070810043453,0.338686702969655,0.650206216026
9,"Bayern",9778187,"Pfaffenhausen, M",2415,1209,1206,0.500621118012422,2383,1195,1188,0.501468736886278,0.0111070810043453,0.338686702969655,0.650206216026
9,"Bayern",9778188,"Pleß",843,440,403,0.521945432977461,851,442,409,0.519388954171563,0.0111070810043453,0.338686702969655,0.650206216026
9,"Bayern",9778190,"Salgen",1407,736,671,0.523098791755508,1403,740,663,0.52744119743407,0.0111070810043453,0.338686702969655,0.650206216026
9,"Bayern",9778196,"Sontheim",2558,1280,1278,0.500390930414386,2511,1265,1246,0.503783353245719,0.0111070810043453,0.338686702969655,0.650206216026
9,"Bayern",9778199,"Stetten",1366,675,691,0.494143484626647,1387,690,697,0.49747656813266,0.0111070810043453,0.338686702969655,0.650206216026
9,"Bayern",9778202,"Trunkelsberg",1699,841,858,0.494997057092407,1757,876,881,0.498577120091064,0.0111070810043453,0.338686702969655,0.650206216026
9,"Bayern",9778203,"Türkheim, M",6666,3298,3368,0.494749474947495,6683,3301,3382,0.493939847373934,0.0111070810043453,0.338686702969655,0.650206216026
9,"Bayern",9778204,"Tussenhausen, M",2941,1526,1415,0.518871132267936,2950,1545,1405,0.523728813559322,0.0111070810043453,0.338686702969655,0.650206216026
9,"Bayern",9778205,"Ungerhausen",1024,521,503,0.5087890625,1010,512,498,0.506930693069307,0.0111070810043453,0.338686702969655,0.650206216026
9,"Bayern",9778207,"Unteregg",1368,677,691,0.494883040935673,1387,703,684,0.506849315068493,0.0111070810043453,0.338686702969655,0.650206216026
9,"Bayern",9778209,"Rammingen",1469,757,712,0.515316541865214,1429,727,702,0.508747375787264,0.0111070810043453,0.338686702969655,0.650206216026
9,"Bayern",9778214,"Westerheim",2106,1082,1024,0.513770180436847,2127,1100,1027,0.517160319699107,0.0111070810043453,0.338686702969655,0.650206216026
9,"Bayern",9778216,"Wiedergeltingen",1370,681,689,0.497080291970803,1373,687,686,0.500364166059723,0.0111070810043453,0.338686702969655,0.650206216026
9,"Bayern",9778217,"Winterrieden",896,456,440,0.508928571428571,893,461,432,0.516237402015677,0.0111070810043453,0.338686702969655,0.650206216026
9,"Bayern",9778218,"Wolfertschwenden",1867,939,928,0.502945902517408,1875,946,929,0.504533333333333,0.0111070810043453,0.338686702969655,0.650206216026
9,"Bayern",9778219,"Woringen",1863,924,939,0.49597423510467,1895,966,929,0.50976253298153,0.0111070810043453,0.338686702969655,0.650206216026
9,"Bayern",9778221,"Kettershausen",1732,891,841,0.514434180138568,1752,906,846,0.517123287671233,0.0111070810043453,0.338686702969655,0.650206216026
9,"Bayern",9779111,"Alerheim",1631,836,795,0.512568976088289,1645,853,792,0.51854103343465,0.0111070810043453,0.338686702969655,0.650206216026
9,"Bayern",9779112,"Amerdingen",851,409,442,0.480611045828437,849,405,444,0.477031802120141,0.0111070810043453,0.338686702969655,0.650206216026
9,"Bayern",9779115,"Asbach-Bäumenheim",4262,2150,2112,0.504458000938527,4306,2199,2107,0.510682768230376,0.0111070810043453,0.338686702969655,0.650206216026
9,"Bayern",9779117,"Auhausen",1036,528,508,0.50965250965251,1031,541,490,0.524733268671193,0.0111070810043453,0.338686702969655,0.650206216026
9,"Bayern",9779126,"Buchdorf",1627,836,791,0.513829133374309,1609,819,790,0.509011808576756,0.0111070810043453,0.338686702969655,0.650206216026
9,"Bayern",9779129,"Daiting",778,415,363,0.533419023136247,792,423,369,0.534090909090909,0.0111070810043453,0.338686702969655,0.650206216026
9,"Bayern",9779130,"Deiningen",1935,959,976,0.495607235142119,1997,988,1009,0.494742113169755,0.0111070810043453,0.338686702969655,0.650206216026
9,"Bayern",9779131,"Donauwörth, GKSt",18040,8798,9242,0.487694013303769,18297,8998,9299,0.491774607859212,0.0111070810043453,0.338686702969655,0.650206216026
9,"Bayern",9779136,"Ederheim",1069,541,528,0.506080449017774,1112,559,553,0.502697841726619,0.0111070810043453,0.338686702969655,0.650206216026
9,"Bayern",9779138,"Ehingen a.Ries",818,415,403,0.507334963325183,779,396,383,0.508344030808729,0.0111070810043453,0.338686702969655,0.650206216026
9,"Bayern",9779146,"Forheim",574,292,282,0.508710801393728,572,289,283,0.505244755244755,0.0111070810043453,0.338686702969655,0.650206216026
9,"Bayern",9779147,"Fremdingen",2049,1017,1032,0.496339677891654,2039,1019,1020,0.499754781755763,0.0111070810043453,0.338686702969655,0.650206216026
9,"Bayern",9779148,"Fünfstetten",1332,657,675,0.493243243243243,1346,669,677,0.49702823179792,0.0111070810043453,0.338686702969655,0.650206216026
9,"Bayern",9779149,"Genderkingen",1156,585,571,0.506055363321799,1168,591,577,0.505993150684932,0.0111070810043453,0.338686702969655,0.650206216026
9,"Bayern",9779154,"Hainsfarth",1465,729,736,0.497610921501706,1442,713,729,0.494452149791956,0.0111070810043453,0.338686702969655,0.650206216026
9,"Bayern",9779155,"Harburg (Schwaben), St",5439,2731,2708,0.502114359257216,5406,2724,2682,0.503884572697003,0.0111070810043453,0.338686702969655,0.650206216026
9,"Bayern",9779162,"Hohenaltheim",593,303,290,0.510961214165261,585,295,290,0.504273504273504,0.0111070810043453,0.338686702969655,0.650206216026
9,"Bayern",9779163,"Holzheim",1118,571,547,0.510733452593918,1126,575,551,0.510657193605684,0.0111070810043453,0.338686702969655,0.650206216026
9,"Bayern",9779167,"Huisheim",1583,806,777,0.509159823120657,1626,833,793,0.51230012300123,0.0111070810043453,0.338686702969655,0.650206216026
9,"Bayern",9779169,"Kaisheim, M",3870,2244,1626,0.57984496124031,4349,2717,1632,0.624741319843642,0.0111070810043453,0.338686702969655,0.650206216026
9,"Bayern",9779176,"Maihingen",1216,639,577,0.525493421052632,1235,643,592,0.520647773279352,0.0111070810043453,0.338686702969655,0.650206216026
9,"Bayern",9779177,"Marktoffingen",1323,691,632,0.522297808012094,1326,692,634,0.521870286576169,0.0111070810043453,0.338686702969655,0.650206216026
9,"Bayern",9779178,"Marxheim",2559,1358,1201,0.530676045330207,2579,1371,1208,0.53160139588988,0.0111070810043453,0.338686702969655,0.650206216026
9,"Bayern",9779180,"Megesheim",860,427,433,0.496511627906977,867,428,439,0.493656286043829,0.0111070810043453,0.338686702969655,0.650206216026
9,"Bayern",9779181,"Mertingen",3771,1916,1855,0.508088040307611,3846,1948,1898,0.5065002600104,0.0111070810043453,0.338686702969655,0.650206216026
9,"Bayern",9779184,"Mönchsdeggingen",1415,703,712,0.496819787985866,1363,672,691,0.493030080704329,0.0111070810043453,0.338686702969655,0.650206216026
9,"Bayern",9779185,"Möttingen",2439,1257,1182,0.515375153751538,2451,1251,1200,0.510403916768666,0.0111070810043453,0.338686702969655,0.650206216026
9,"Bayern",9779186,"Monheim, St",4941,2538,2403,0.513661202185792,4824,2495,2329,0.517205638474295,0.0111070810043453,0.338686702969655,0.650206216026
9,"Bayern",9779187,"Münster",1094,565,529,0.516453382084095,1079,562,517,0.520852641334569,0.0111070810043453,0.338686702969655,0.650206216026
9,"Bayern",9779188,"Munningen",1781,924,857,0.518809657495789,1757,921,836,0.524188958451907,0.0111070810043453,0.338686702969655,0.650206216026
9,"Bayern",9779192,"Niederschönenfeld",1356,785,571,0.578908554572271,1391,814,577,0.585190510424155,0.0111070810043453,0.338686702969655,0.650206216026
9,"Bayern",9779194,"Nördlingen, GKSt",19062,9221,9841,0.483737278354842,19048,9283,9765,0.487347753044939,0.0111070810043453,0.338686702969655,0.650206216026
9,"Bayern",9779196,"Oberndorf a.Lech",2350,1192,1158,0.507234042553191,2384,1209,1175,0.507130872483222,0.0111070810043453,0.338686702969655,0.650206216026
9,"Bayern",9779197,"Oettingen i.Bay., St",5074,2476,2598,0.487977926685061,5024,2482,2542,0.494028662420382,0.0111070810043453,0.338686702969655,0.650206216026
9,"Bayern",9779198,"Otting",760,368,392,0.484210526315789,779,380,399,0.48780487804878,0.0111070810043453,0.338686702969655,0.650206216026
9,"Bayern",9779201,"Rain, St",8398,4160,4238,0.495356037151703,8503,4213,4290,0.495472186287193,0.0111070810043453,0.338686702969655,0.650206216026
9,"Bayern",9779203,"Reimlingen",1328,699,629,0.526355421686747,1340,706,634,0.526865671641791,0.0111070810043453,0.338686702969655,0.650206216026
9,"Bayern",9779206,"Rögling",644,329,315,0.510869565217391,641,325,316,0.507020280811232,0.0111070810043453,0.338686702969655,0.650206216026
9,"Bayern",9779217,"Tagmersheim",1050,542,508,0.516190476190476,1041,548,493,0.526416906820365,0.0111070810043453,0.338686702969655,0.650206216026
9,"Bayern",9779218,"Tapfheim",3943,1975,1968,0.500887648998225,4005,2000,2005,0.499375780274657,0.0111070810043453,0.338686702969655,0.650206216026
9,"Bayern",9779224,"Wallerstein, M",3289,1621,1668,0.492854971115841,3409,1654,1755,0.48518627163391,0.0111070810043453,0.338686702969655,0.650206216026
9,"Bayern",9779226,"Wechingen",1418,718,700,0.506346967559944,1385,707,678,0.510469314079422,0.0111070810043453,0.338686702969655,0.650206216026
9,"Bayern",9779228,"Wemding, St",5683,2774,2909,0.488122470526131,5661,2767,2894,0.488782900547606,0.0111070810043453,0.338686702969655,0.650206216026
9,"Bayern",9779231,"Wolferstadt",1092,568,524,0.52014652014652,1109,577,532,0.520288548241659,0.0111070810043453,0.338686702969655,0.650206216026
9,"Bayern",9780112,"Altusried, M",9874,4964,4910,0.502734454121936,9954,4962,4992,0.498493068113321,0.0111070810043453,0.338686702969655,0.650206216026
9,"Bayern",9780113,"Balderschwang",289,147,142,0.508650519031142,259,142,117,0.548262548262548,0.0111070810043453,0.338686702969655,0.650206216026
9,"Bayern",9780114,"Betzigau",2781,1408,1373,0.506292700467458,2786,1399,1387,0.502153625269203,0.0111070810043453,0.338686702969655,0.650206216026
9,"Bayern",9780115,"Blaichach",5638,2786,2852,0.494146860588861,5604,2776,2828,0.49536045681656,0.0111070810043453,0.338686702969655,0.650206216026
9,"Bayern",9780116,"Bolsterlang",1026,501,525,0.488304093567251,1081,550,531,0.508788159111933,0.0111070810043453,0.338686702969655,0.650206216026
9,"Bayern",9780117,"Buchenberg, M",3897,1960,1937,0.502950987939441,3935,1982,1953,0.503684879288437,0.0111070810043453,0.338686702969655,0.650206216026
9,"Bayern",9780118,"Burgberg i.Allgäu",3173,1539,1634,0.48502994011976,3109,1511,1598,0.486008362817626,0.0111070810043453,0.338686702969655,0.650206216026
9,"Bayern",9780119,"Dietmannsried, M",7755,3861,3894,0.497872340425532,7847,3892,3955,0.495985727029438,0.0111070810043453,0.338686702969655,0.650206216026
9,"Bayern",9780120,"Durach",6766,3318,3448,0.490393142181496,6787,3337,3450,0.491675261529394,0.0111070810043453,0.338686702969655,0.650206216026
9,"Bayern",9780121,"Fischen i.Allgäu",2971,1422,1549,0.478626725008415,3033,1435,1598,0.473128915265414,0.0111070810043453,0.338686702969655,0.650206216026
9,"Bayern",9780122,"Haldenwang",3671,1826,1845,0.497412149278126,3727,1855,1872,0.49771934531795,0.0111070810043453,0.338686702969655,0.650206216026
9,"Bayern",9780123,"Bad Hindelang, M",4835,2342,2493,0.484384694932782,4827,2331,2496,0.482908638906153,0.0111070810043453,0.338686702969655,0.650206216026
9,"Bayern",9780124,"Immenstadt i.Allgäu, St",13858,6689,7169,0.48268148361957,13974,6690,7284,0.478746243022757,0.0111070810043453,0.338686702969655,0.650206216026
9,"Bayern",9780125,"Lauben",3304,1603,1701,0.485169491525424,3342,1634,1708,0.488928785158588,0.0111070810043453,0.338686702969655,0.650206216026
9,"Bayern",9780127,"Missen-Wilhams",1403,738,665,0.526015680684248,1447,752,695,0.51969592259848,0.0111070810043453,0.338686702969655,0.650206216026
9,"Bayern",9780128,"Oy-Mittelberg",4346,2162,2184,0.49746893695352,4359,2193,2166,0.503097040605644,0.0111070810043453,0.338686702969655,0.650206216026
9,"Bayern",9780131,"Obermaiselstein",947,490,457,0.517423442449842,970,519,451,0.535051546391753,0.0111070810043453,0.338686702969655,0.650206216026
9,"Bayern",9780132,"Oberstaufen, M",7196,3439,3757,0.477904391328516,7196,3407,3789,0.473457476375764,0.0111070810043453,0.338686702969655,0.650206216026
9,"Bayern",9780133,"Oberstdorf, M",9488,4439,5049,0.46785413153457,9923,4625,5298,0.466088884409957,0.0111070810043453,0.338686702969655,0.650206216026
9,"Bayern",9780134,"Ofterschwang",1936,974,962,0.503099173553719,2094,1045,1049,0.499044890162369,0.0111070810043453,0.338686702969655,0.650206216026
9,"Bayern",9780137,"Rettenberg",4179,2110,2069,0.504905479779852,4253,2151,2102,0.505760639548554,0.0111070810043453,0.338686702969655,0.650206216026
9,"Bayern",9780139,"Sonthofen, St",21126,10036,11090,0.475054435293004,20910,9924,10986,0.474605451936872,0.0111070810043453,0.338686702969655,0.650206216026
9,"Bayern",9780140,"Sulzberg, M",4698,2370,2328,0.504469987228608,4685,2379,2306,0.507790821771612,0.0111070810043453,0.338686702969655,0.650206216026
9,"Bayern",9780143,"Waltenhofen",8892,4379,4513,0.492465137201979,8942,4442,4500,0.496756877656005,0.0111070810043453,0.338686702969655,0.650206216026
9,"Bayern",9780144,"Weitnau, M",5013,2502,2511,0.499102333931777,5108,2548,2560,0.498825371965544,0.0111070810043453,0.338686702969655,0.650206216026
9,"Bayern",9780145,"Wertach, M",2392,1175,1217,0.491220735785953,2444,1209,1235,0.49468085106383,0.0111070810043453,0.338686702969655,0.650206216026
9,"Bayern",9780146,"Wiggensbach, M",4822,2396,2426,0.496889257569473,4831,2381,2450,0.492858621403436,0.0111070810043453,0.338686702969655,0.650206216026
9,"Bayern",9780147,"Wildpoldsried",2415,1193,1222,0.493995859213251,2519,1246,1273,0.494640730448591,0.0111070810043453,0.338686702969655,0.650206216026
10,"Saarland",10041100,"Saarbrücken, Landeshauptstadt",176497,86205,90292,0.488421899522371,176135,85020,91115,0.482697930564624,0.00260949291205304,0.36095634388885,0.636434163199097
10,"Saarland",10041511,"Friedrichsthal, Stadt",10404,4982,5422,0.478854286812764,10710,5191,5519,0.48468720821662,0.00260949291205304,0.36095634388885,0.636434163199097
10,"Saarland",10041512,"Großrosseln",8342,3985,4357,0.477703188683769,8365,3948,4417,0.471966527196653,0.00260949291205304,0.36095634388885,0.636434163199097
10,"Saarland",10041513,"Heusweiler",18084,8650,9434,0.478323379783234,19292,9330,9962,0.483620153431474,0.00260949291205304,0.36095634388885,0.636434163199097
10,"Saarland",10041514,"Kleinblittersdorf",11342,5406,5936,0.476635514018692,12257,5871,6386,0.478991596638655,0.00260949291205304,0.36095634388885,0.636434163199097
10,"Saarland",10041515,"Püttlingen, Stadt",19049,9183,9866,0.482072549740144,19674,9436,10238,0.479617769645217,0.00260949291205304,0.36095634388885,0.636434163199097
10,"Saarland",10041516,"Quierschied",13386,6416,6970,0.479306738383386,13454,6476,6978,0.481343838263713,0.00260949291205304,0.36095634388885,0.636434163199097
10,"Saarland",10041517,"Riegelsberg",14720,7033,7687,0.477785326086957,14834,7045,7789,0.474922475394364,0.00260949291205304,0.36095634388885,0.636434163199097
10,"Saarland",10041518,"Sulzbach/ Saar, Stadt",16502,7914,8588,0.479578232941462,17270,8416,8854,0.487319050376375,0.00260949291205304,0.36095634388885,0.636434163199097
10,"Saarland",10041519,"Völklingen, Stadt",38670,18585,20085,0.480605120248254,39538,19286,20252,0.487783904092266,0.00260949291205304,0.36095634388885,0.636434163199097
10,"Saarland",10042111,"Beckingen",15328,7472,7856,0.487473903966597,15280,7513,7767,0.491688481675393,0.00260949291205304,0.36095634388885,0.636434163199097
10,"Saarland",10042112,"Losheim am See",15880,7836,8044,0.493450881612091,16290,8177,8113,0.501964395334561,0.00260949291205304,0.36095634388885,0.636434163199097
10,"Saarland",10042113,"Merzig, Kreisstadt",29720,14569,15151,0.490208613728129,30303,14834,15469,0.48952248952249,0.00260949291205304,0.36095634388885,0.636434163199097
10,"Saarland",10042114,"Mettlach",12196,5899,6297,0.483683174811414,12309,5996,6313,0.487123243155415,0.00260949291205304,0.36095634388885,0.636434163199097
10,"Saarland",10042115,"Perl",7900,3908,3992,0.494683544303797,7738,3833,3905,0.495347635047816,0.00260949291205304,0.36095634388885,0.636434163199097
10,"Saarland",10042116,"Wadern, Stadt",16128,7948,8180,0.49280753968254,16272,7988,8284,0.490904621435595,0.00260949291205304,0.36095634388885,0.636434163199097
10,"Saarland",10042117,"Weiskirchen",6487,3202,3285,0.493602589794975,6397,3135,3262,0.490073471939972,0.00260949291205304,0.36095634388885,0.636434163199097
10,"Saarland",10043111,"Eppelborn",17697,8735,8962,0.493586483584788,17057,8359,8698,0.490062730843642,0.00260949291205304,0.36095634388885,0.636434163199097
10,"Saarland",10043112,"Illingen",16940,8124,8816,0.479574970484061,17204,8487,8717,0.49331550802139,0.00260949291205304,0.36095634388885,0.636434163199097
10,"Saarland",10043113,"Merchweiler",10135,4903,5232,0.483769116921559,10287,5021,5266,0.488091766306989,0.00260949291205304,0.36095634388885,0.636434163199097
10,"Saarland",10043114,"Neunkirchen, Kreisstadt",45970,22286,23684,0.48479443115075,47201,23001,24200,0.487298997902587,0.00260949291205304,0.36095634388885,0.636434163199097
10,"Saarland",10043115,"Ottweiler, Stadt",14810,7367,7443,0.497434166103984,14662,7118,7544,0.48547265038876,0.00260949291205304,0.36095634388885,0.636434163199097
10,"Saarland",10043116,"Schiffweiler",15972,7702,8270,0.482218883045329,16392,8040,8352,0.490483162518302,0.00260949291205304,0.36095634388885,0.636434163199097
10,"Saarland",10043117,"Spiesen-Elversberg",13433,6452,6981,0.480309685103849,13578,6509,7069,0.479378406245397,0.00260949291205304,0.36095634388885,0.636434163199097
10,"Saarland",10044111,"Dillingen/ Saar, Stadt",20263,9741,10522,0.480728421260425,20736,10089,10647,0.486545138888889,0.00260949291205304,0.36095634388885,0.636434163199097
10,"Saarland",10044112,"Lebach, Stadt",19494,9845,9649,0.505027187852673,19692,10323,9369,0.524223034734918,0.00260949291205304,0.36095634388885,0.636434163199097
10,"Saarland",10044113,"Nalbach",9255,4501,4754,0.48633171258779,9149,4446,4703,0.485954749152913,0.00260949291205304,0.36095634388885,0.636434163199097
10,"Saarland",10044114,"Rehlingen-Siersburg",14562,7083,7479,0.486402966625464,15451,7581,7870,0.490647854507799,0.00260949291205304,0.36095634388885,0.636434163199097
10,"Saarland",10044115,"Saarlouis, Kreisstadt",34356,16500,17856,0.480265455815578,36910,17934,18976,0.485884584123544,0.00260949291205304,0.36095634388885,0.636434163199097
10,"Saarland",10044116,"Saarwellingen",13329,6446,6883,0.483607172331008,13378,6505,6873,0.486246075646584,0.00260949291205304,0.36095634388885,0.636434163199097
10,"Saarland",10044117,"Schmelz",16419,8065,8354,0.491199220415372,16622,8149,8473,0.490253880399471,0.00260949291205304,0.36095634388885,0.636434163199097
10,"Saarland",10044118,"Schwalbach",17276,8286,8990,0.479624913174346,17593,8469,9124,0.481384641618826,0.00260949291205304,0.36095634388885,0.636434163199097
10,"Saarland",10044119,"Überherrn",11601,5565,6036,0.47970002585984,11564,5552,6012,0.480110688343134,0.00260949291205304,0.36095634388885,0.636434163199097
10,"Saarland",10044120,"Wadgassen",17848,8636,9212,0.483863738233976,18153,8833,9320,0.486586239189115,0.00260949291205304,0.36095634388885,0.636434163199097
10,"Saarland",10044121,"Wallerfangen",9438,4638,4800,0.491417673235855,9430,4625,4805,0.490455991516437,0.00260949291205304,0.36095634388885,0.636434163199097
10,"Saarland",10044122,"Bous",7086,3437,3649,0.485040925769122,7117,3442,3675,0.483630743290712,0.00260949291205304,0.36095634388885,0.636434163199097
10,"Saarland",10044123,"Ensdorf",6525,3151,3374,0.482911877394636,6557,3154,3403,0.481012658227848,0.00260949291205304,0.36095634388885,0.636434163199097
10,"Saarland",10045111,"Bexbach, Stadt",18001,8752,9249,0.486195211377146,17971,8751,9220,0.486951199154193,0.00260949291205304,0.36095634388885,0.636434163199097
10,"Saarland",10045112,"Blieskastel, Stadt",21191,10465,10726,0.493841725260724,21717,10718,10999,0.493530413961413,0.00260949291205304,0.36095634388885,0.636434163199097
10,"Saarland",10045113,"Gersheim",6760,3315,3445,0.490384615384615,6781,3351,3430,0.49417490045716,0.00260949291205304,0.36095634388885,0.636434163199097
10,"Saarland",10045114,"Homburg, Kreisstadt",41494,20030,21464,0.482720393309876,43724,21287,22437,0.486849327600403,0.00260949291205304,0.36095634388885,0.636434163199097
10,"Saarland",10045115,"Kirkel",9973,4885,5088,0.489822520806177,9994,4872,5122,0.487492495497298,0.00260949291205304,0.36095634388885,0.636434163199097
10,"Saarland",10045116,"Mandelbachtal",11088,5342,5746,0.481782106782107,11328,5489,5839,0.484551553672316,0.00260949291205304,0.36095634388885,0.636434163199097
10,"Saarland",10045117,"St. Ingbert, Stadt",36592,17419,19173,0.476033012680367,37104,17762,19342,0.478708495040966,0.00260949291205304,0.36095634388885,0.636434163199097
10,"Saarland",10046111,"Freisen",8203,4020,4183,0.490064610508351,8230,4084,4146,0.496233292831106,0.00260949291205304,0.36095634388885,0.636434163199097
10,"Saarland",10046112,"Marpingen",10559,5232,5327,0.49550146794204,10724,5303,5421,0.49449832152182,0.00260949291205304,0.36095634388885,0.636434163199097
10,"Saarland",10046113,"Namborn",7347,3649,3698,0.496665305566898,7242,3577,3665,0.493924330295498,0.00260949291205304,0.36095634388885,0.636434163199097
10,"Saarland",10046114,"Nohfelden",10149,5015,5134,0.494137353433836,9965,5006,4959,0.50235825388861,0.00260949291205304,0.36095634388885,0.636434163199097
10,"Saarland",10046115,"Nonnweiler",8813,4393,4420,0.498468172018609,8821,4448,4373,0.504251218682689,0.00260949291205304,0.36095634388885,0.636434163199097
10,"Saarland",10046116,"Oberthal",6097,2960,3137,0.485484664589142,6156,3002,3154,0.487654320987654,0.00260949291205304,0.36095634388885,0.636434163199097
10,"Saarland",10046117,"St. Wendel, Kreisstadt",26174,12717,13457,0.485863834339421,26074,12709,13365,0.487420418808008,0.00260949291205304,0.36095634388885,0.636434163199097
10,"Saarland",10046118,"Tholey",12370,6058,6312,0.489733225545675,12670,6223,6447,0.491160220994475,0.00260949291205304,0.36095634388885,0.636434163199097
11,"Berlin",11000000,"Berlin, Stadt",3326002,1618007,1707995,0.486472046619335,3501872,1717645,1784227,0.49049337040303,9.71345313258863e-05,0.174011116507474,0.825902541686903
12,"Brandenburg",12051000,"Brandenburg an der Havel, Stadt",71381,35015,36366,0.490536697440495,71534,35127,36407,0.491053205468728,0.0231860496622733,0.277303605643616,0.699510344694111
12,"Brandenburg",12052000,"Cottbus, Stadt",99974,48984,50990,0.489967391521796,102129,50338,51791,0.492886447532043,0.0231860496622733,0.277303605643616,0.699510344694111
12,"Brandenburg",12053000,"Frankfurt (Oder), Stadt",59063,28282,30781,0.478844623537579,60002,29133,30869,0.485533815539482,0.0231860496622733,0.277303605643616,0.699510344694111
12,"Brandenburg",12054000,"Potsdam, Stadt",157603,75380,82223,0.478290387873327,158902,77074,81828,0.485041094511082,0.0231860496622733,0.277303605643616,0.699510344694111
12,"Brandenburg",12060005,"Ahrensfelde",12727,6380,6347,0.501296456352636,13002,6501,6501,0.5,0.0231860496622733,0.277303605643616,0.699510344694111
12,"Brandenburg",12060012,"Althüttendorf",690,373,317,0.540579710144928,743,417,326,0.561238223418573,0.0231860496622733,0.277303605643616,0.699510344694111
12,"Brandenburg",12060020,"Bernau bei Berlin, Stadt",35843,17375,18468,0.484752950366878,36624,17982,18642,0.490989515072084,0.0231860496622733,0.277303605643616,0.699510344694111
12,"Brandenburg",12060024,"Biesenthal, Stadt",5498,2707,2791,0.492360858493998,5545,2757,2788,0.497204688908927,0.0231860496622733,0.277303605643616,0.699510344694111
12,"Brandenburg",12060034,"Breydin",815,422,393,0.517791411042945,824,429,395,0.520631067961165,0.0231860496622733,0.277303605643616,0.699510344694111
12,"Brandenburg",12060036,"Britz",2145,1053,1092,0.490909090909091,2138,1052,1086,0.492048643592142,0.0231860496622733,0.277303605643616,0.699510344694111
12,"Brandenburg",12060045,"Chorin",2326,1150,1176,0.494411006018917,2356,1177,1179,0.499575551782683,0.0231860496622733,0.277303605643616,0.699510344694111
12,"Brandenburg",12060052,"Eberswalde, Stadt",39121,19119,20002,0.488714501163058,40745,19943,20802,0.489458829304209,0.0231860496622733,0.277303605643616,0.699510344694111
12,"Brandenburg",12060068,"Friedrichswalde",839,423,416,0.504171632896305,856,430,426,0.502336448598131,0.0231860496622733,0.277303605643616,0.699510344694111
12,"Brandenburg",12060092,"Hohenfinow",519,271,248,0.522157996146435,507,264,243,0.520710059171598,0.0231860496622733,0.277303605643616,0.699510344694111
12,"Brandenburg",12060100,"Joachimsthal, Stadt",3297,1614,1683,0.489535941765241,3305,1603,1702,0.485022692889561,0.0231860496622733,0.277303605643616,0.699510344694111
12,"Brandenburg",12060128,"Liepe",693,356,337,0.513708513708514,735,377,358,0.512925170068027,0.0231860496622733,0.277303605643616,0.699510344694111
12,"Brandenburg",12060149,"Lunow-Stolzenhagen",1219,597,622,0.48974569319114,1201,584,617,0.486261448792673,0.0231860496622733,0.277303605643616,0.699510344694111
12,"Brandenburg",12060154,"Marienwerder",1768,895,873,0.506221719457014,1785,903,882,0.505882352941176,0.0231860496622733,0.277303605643616,0.699510344694111
12,"Brandenburg",12060161,"Melchow",930,477,453,0.512903225806452,900,448,452,0.497777777777778,0.0231860496622733,0.277303605643616,0.699510344694111
12,"Brandenburg",12060172,"Niederfinow",595,291,304,0.489075630252101,635,305,330,0.480314960629921,0.0231860496622733,0.277303605643616,0.699510344694111
12,"Brandenburg",12060176,"Oderberg, Stadt",2190,1092,1098,0.498630136986301,2133,1084,1049,0.508204406938584,0.0231860496622733,0.277303605643616,0.699510344694111
12,"Brandenburg",12060181,"Panketal",19032,9385,9647,0.493116855821774,19291,9577,9714,0.496449121351926,0.0231860496622733,0.277303605643616,0.699510344694111
12,"Brandenburg",12060185,"Parsteinsee",556,294,262,0.528776978417266,575,299,276,0.52,0.0231860496622733,0.277303605643616,0.699510344694111
12,"Brandenburg",12060192,"Rüdnitz",1927,983,944,0.510119356512714,1889,958,931,0.507146638433033,0.0231860496622733,0.277303605643616,0.699510344694111
12,"Brandenburg",12060198,"Schorfheide",9858,4881,4977,0.495130858186245,10167,5135,5032,0.505065407691551,0.0231860496622733,0.277303605643616,0.699510344694111
12,"Brandenburg",12060250,"Sydower Fließ",846,424,422,0.501182033096927,865,443,422,0.512138728323699,0.0231860496622733,0.277303605643616,0.699510344694111
12,"Brandenburg",12060269,"Wandlitz",20775,10379,10396,0.499590854392298,21801,11039,10762,0.506352919590844,0.0231860496622733,0.277303605643616,0.699510344694111
12,"Brandenburg",12060280,"Werneuchen, Stadt",7908,3994,3914,0.505058168942843,7876,3968,3908,0.503809040121889,0.0231860496622733,0.277303605643616,0.699510344694111
12,"Brandenburg",12060296,"Ziethen",455,226,229,0.496703296703297,455,234,221,0.514285714285714,0.0231860496622733,0.277303605643616,0.699510344694111
12,"Brandenburg",12061005,"Alt Zauche-Wußwerk",523,255,268,0.487571701720841,528,265,263,0.501893939393939,0.0231860496622733,0.277303605643616,0.699510344694111
12,"Brandenburg",12061017,"Bersteland",915,468,447,0.511475409836066,913,462,451,0.506024096385542,0.0231860496622733,0.277303605643616,0.699510344694111
12,"Brandenburg",12061020,"Bestensee",6597,3302,3295,0.500530544186752,6772,3388,3384,0.500295333727112,0.0231860496622733,0.277303605643616,0.699510344694111
12,"Brandenburg",12061061,"Byhleguhre-Byhlen",770,399,371,0.518181818181818,779,404,375,0.518613607188703,0.0231860496622733,0.277303605643616,0.699510344694111
12,"Brandenburg",12061097,"Drahnsdorf",592,304,288,0.513513513513513,594,311,283,0.523569023569024,0.0231860496622733,0.277303605643616,0.699510344694111
12,"Brandenburg",12061112,"Eichwalde",6252,3015,3237,0.482245681381958,6206,3007,3199,0.484531098936513,0.0231860496622733,0.277303605643616,0.699510344694111
12,"Brandenburg",12061164,"Golßen, Stadt",2554,1287,1267,0.503915426781519,2564,1294,1270,0.504680187207488,0.0231860496622733,0.277303605643616,0.699510344694111
12,"Brandenburg",12061192,"Groß Köris",2294,1129,1165,0.492153443766347,2223,1117,1106,0.502474134053081,0.0231860496622733,0.277303605643616,0.699510344694111
12,"Brandenburg",12061216,"Halbe",2124,1038,1086,0.488700564971751,2193,1073,1120,0.489284085727314,0.0231860496622733,0.277303605643616,0.699510344694111
12,"Brandenburg",12061217,"Heidesee",6946,3486,3460,0.501871580765908,6937,3488,3449,0.502811013406372,0.0231860496622733,0.277303605643616,0.699510344694111
12,"Brandenburg",12061219,"Heideblick",3834,1936,1898,0.504955659885237,3917,1980,1937,0.505488894562165,0.0231860496622733,0.277303605643616,0.699510344694111
12,"Brandenburg",12061224,"Jamlitz",583,306,277,0.524871355060034,590,312,278,0.528813559322034,0.0231860496622733,0.277303605643616,0.699510344694111
12,"Brandenburg",12061244,"Kasel-Golzig",748,394,354,0.526737967914438,737,381,356,0.516960651289009,0.0231860496622733,0.277303605643616,0.699510344694111
12,"Brandenburg",12061260,"Königs Wusterhausen, Stadt",33747,16397,17350,0.485880226390494,34083,16635,17448,0.488073232990054,0.0231860496622733,0.277303605643616,0.699510344694111
12,"Brandenburg",12061265,"Krausnick-Groß Wasserburg",616,324,292,0.525974025974026,620,321,299,0.517741935483871,0.0231860496622733,0.277303605643616,0.699510344694111
12,"Brandenburg",12061308,"Lieberose, Stadt",1472,731,741,0.496603260869565,1464,731,733,0.49931693989071,0.0231860496622733,0.277303605643616,0.699510344694111
12,"Brandenburg",12061316,"Lübben (Spreewald), Stadt",13869,6646,7223,0.479198211839354,14047,6849,7198,0.487577418665907,0.0231860496622733,0.277303605643616,0.699510344694111
12,"Brandenburg",12061320,"Luckau, Stadt",9818,4841,4977,0.493073945813811,9952,4925,5027,0.49487540192926,0.0231860496622733,0.277303605643616,0.699510344694111
12,"Brandenburg",12061328,"Märkisch Buchholz, Stadt",759,378,381,0.49802371541502,774,381,393,0.492248062015504,0.0231860496622733,0.277303605643616,0.699510344694111
12,"Brandenburg",12061329,"Märkische Heide",4137,2066,2071,0.499395697365241,4278,2147,2131,0.501870032725573,0.0231860496622733,0.277303605643616,0.699510344694111
12,"Brandenburg",12061332,"Mittenwalde, Stadt",8658,4381,4277,0.506006006006006,8758,4470,4288,0.510390500114181,0.0231860496622733,0.277303605643616,0.699510344694111
12,"Brandenburg",12061344,"Münchehofe",482,232,250,0.481327800829876,489,234,255,0.478527607361963,0.0231860496622733,0.277303605643616,0.699510344694111
12,"Brandenburg",12061352,"Neu Zauche",1142,576,566,0.504378283712785,1144,582,562,0.508741258741259,0.0231860496622733,0.277303605643616,0.699510344694111
12,"Brandenburg",12061405,"Rietzneuendorf-Staakow",610,305,305,0.5,618,311,307,0.503236245954693,0.0231860496622733,0.277303605643616,0.699510344694111
12,"Brandenburg",12061428,"Schlepzig",599,266,333,0.444073455759599,601,274,327,0.455906821963394,0.0231860496622733,0.277303605643616,0.699510344694111
12,"Brandenburg",12061433,"Schönefeld",13317,6683,6634,0.50183975369828,13618,6862,6756,0.503891907769129,0.0231860496622733,0.277303605643616,0.699510344694111
12,"Brandenburg",12061435,"Schönwald",1170,587,583,0.501709401709402,1163,580,583,0.498710232158212,0.0231860496622733,0.277303605643616,0.699510344694111
12,"Brandenburg",12061444,"Schulzendorf",7575,3741,3834,0.493861386138614,7639,3810,3829,0.498756381725357,0.0231860496622733,0.277303605643616,0.699510344694111
12,"Brandenburg",12061448,"Schwerin",780,392,388,0.502564102564103,627,311,316,0.496012759170654,0.0231860496622733,0.277303605643616,0.699510344694111
12,"Brandenburg",12061450,"Schwielochsee",1600,823,777,0.514375,1588,827,761,0.520780856423174,0.0231860496622733,0.277303605643616,0.699510344694111
12,"Brandenburg",12061470,"Spreewaldheide",499,258,241,0.517034068136273,537,271,266,0.504655493482309,0.0231860496622733,0.277303605643616,0.699510344694111
12,"Brandenburg",12061471,"Steinreich",544,298,246,0.547794117647059,563,308,255,0.547069271758437,0.0231860496622733,0.277303605643616,0.699510344694111
12,"Brandenburg",12061476,"Straupitz",1015,511,504,0.503448275862069,985,484,501,0.491370558375635,0.0231860496622733,0.277303605643616,0.699510344694111
12,"Brandenburg",12061492,"Teupitz, Stadt",1802,932,870,0.517203107658158,1831,952,879,0.5199344620426,0.0231860496622733,0.277303605643616,0.699510344694111
12,"Brandenburg",12061510,"Unterspreewald",860,433,427,0.503488372093023,867,439,428,0.506343713956171,0.0231860496622733,0.277303605643616,0.699510344694111
12,"Brandenburg",12061540,"Wildau",9731,4760,4971,0.489158359880793,9849,4835,5014,0.490912783023657,0.0231860496622733,0.277303605643616,0.699510344694111
12,"Brandenburg",12061572,"Zeuthen",10574,5139,5435,0.486003404577265,10508,5132,5376,0.488389798248953,0.0231860496622733,0.277303605643616,0.699510344694111
12,"Brandenburg",12062024,"Bad Liebenwerda, Stadt",9764,4772,4992,0.48873412535846,9775,4798,4977,0.490843989769821,0.0231860496622733,0.277303605643616,0.699510344694111
12,"Brandenburg",12062088,"Crinitz",1257,630,627,0.501193317422434,1257,635,622,0.505171042163882,0.0231860496622733,0.277303605643616,0.699510344694111
12,"Brandenburg",12062092,"Doberlug-Kirchhain, Stadt",8982,4433,4549,0.49354264083723,8931,4385,4546,0.490986451685142,0.0231860496622733,0.277303605643616,0.699510344694111
12,"Brandenburg",12062124,"Elsterwerda, Stadt",8498,4129,4369,0.485879030360085,8562,4194,4368,0.489838822704975,0.0231860496622733,0.277303605643616,0.699510344694111
12,"Brandenburg",12062128,"Falkenberg/Elster, Stadt",6812,3370,3442,0.494715208455666,6947,3452,3495,0.496905138908882,0.0231860496622733,0.277303605643616,0.699510344694111
12,"Brandenburg",12062134,"Fichtwald",660,333,327,0.504545454545455,648,331,317,0.510802469135803,0.0231860496622733,0.277303605643616,0.699510344694111
12,"Brandenburg",12062140,"Finsterwalde, Stadt",16873,8065,8808,0.477982575712677,17254,8337,8917,0.483192303234033,0.0231860496622733,0.277303605643616,0.699510344694111
12,"Brandenburg",12062177,"Gorden-Staupitz",1044,509,535,0.487547892720307,1049,517,532,0.492850333651096,0.0231860496622733,0.277303605643616,0.699510344694111
12,"Brandenburg",12062196,"Gröden",1477,745,732,0.504400812457685,1506,760,746,0.50464807436919,0.0231860496622733,0.277303605643616,0.699510344694111
12,"Brandenburg",12062208,"Großthiemig",1129,569,560,0.503985828166519,1141,575,566,0.503943908851884,0.0231860496622733,0.277303605643616,0.699510344694111
12,"Brandenburg",12062219,"Heideland",554,283,271,0.510830324909747,553,279,274,0.504520795660036,0.0231860496622733,0.277303605643616,0.699510344694111
12,"Brandenburg",12062224,"Herzberg (Elster), Stadt",9461,4522,4939,0.477962160448156,9890,4876,5014,0.493023255813954,0.0231860496622733,0.277303605643616,0.699510344694111
12,"Brandenburg",12062232,"Hirschfeld",1344,686,658,0.510416666666667,1350,697,653,0.516296296296296,0.0231860496622733,0.277303605643616,0.699510344694111
12,"Brandenburg",12062237,"Hohenbucko",683,349,334,0.510980966325037,692,341,351,0.492774566473988,0.0231860496622733,0.277303605643616,0.699510344694111
12,"Brandenburg",12062240,"Hohenleipisch",2188,1137,1051,0.519652650822669,2178,1128,1050,0.517906336088154,0.0231860496622733,0.277303605643616,0.699510344694111
12,"Brandenburg",12062282,"Kremitzaue",876,442,434,0.504566210045662,901,456,445,0.506104328523862,0.0231860496622733,0.277303605643616,0.699510344694111
12,"Brandenburg",12062289,"Lebusa",823,423,400,0.513973268529769,828,421,407,0.508454106280193,0.0231860496622733,0.277303605643616,0.699510344694111
12,"Brandenburg",12062293,"Lichterfeld-Schacksdorf",1053,558,495,0.52991452991453,1085,569,516,0.524423963133641,0.0231860496622733,0.277303605643616,0.699510344694111
12,"Brandenburg",12062333,"Massen-Niederlausitz",2066,1041,1025,0.503872216844143,2062,1034,1028,0.501454898157129,0.0231860496622733,0.277303605643616,0.699510344694111
12,"Brandenburg",12062336,"Merzdorf",878,442,436,0.503416856492027,889,438,451,0.492688413948256,0.0231860496622733,0.277303605643616,0.699510344694111
12,"Brandenburg",12062341,"Mühlberg/Elbe, Stadt",4128,2085,2043,0.505087209302326,4149,2091,2058,0.503976861894432,0.0231860496622733,0.277303605643616,0.699510344694111
12,"Brandenburg",12062372,"Plessa",2864,1431,1433,0.499650837988827,2835,1413,1422,0.498412698412698,0.0231860496622733,0.277303605643616,0.699510344694111
12,"Brandenburg",12062410,"Röderland",4208,2108,2100,0.500950570342205,4263,2132,2131,0.500117288294628,0.0231860496622733,0.277303605643616,0.699510344694111
12,"Brandenburg",12062417,"Rückersdorf",1520,778,742,0.511842105263158,1587,816,771,0.514177693761815,0.0231860496622733,0.277303605643616,0.699510344694111
12,"Brandenburg",12062425,"Sallgast",1495,755,740,0.505016722408027,1598,810,788,0.506883604505632,0.0231860496622733,0.277303605643616,0.699510344694111
12,"Brandenburg",12062440,"Schilda",507,263,244,0.518737672583826,500,253,247,0.506,0.0231860496622733,0.277303605643616,0.699510344694111
12,"Brandenburg",12062445,"Schlieben, Stadt",2609,1265,1344,0.48486009965504,2620,1279,1341,0.488167938931298,0.0231860496622733,0.277303605643616,0.699510344694111
12,"Brandenburg",12062453,"Schönborn",1606,805,801,0.501245330012453,1604,815,789,0.508104738154613,0.0231860496622733,0.277303605643616,0.699510344694111
12,"Brandenburg",12062461,"Schönewalde, Stadt",3236,1686,1550,0.521013597033375,3226,1668,1558,0.517048977061376,0.0231860496622733,0.277303605643616,0.699510344694111
12,"Brandenburg",12062464,"Schraden",547,271,276,0.495429616087751,542,273,269,0.503690036900369,0.0231860496622733,0.277303605643616,0.699510344694111
12,"Brandenburg",12062469,"Sonnewalde, Stadt",3446,1750,1696,0.507835171213001,3401,1744,1657,0.512790355777712,0.0231860496622733,0.277303605643616,0.699510344694111
12,"Brandenburg",12062492,"Tröbitz",744,376,368,0.505376344086022,755,382,373,0.505960264900662,0.0231860496622733,0.277303605643616,0.699510344694111
12,"Brandenburg",12062500,"Uebigau-Wahrenbrück, Stadt",5755,2903,2852,0.504430929626412,5713,2882,2831,0.504463504288465,0.0231860496622733,0.277303605643616,0.699510344694111
12,"Brandenburg",12063036,"Brieselang",10795,5473,5322,0.50699397869384,10947,5525,5422,0.5047044852471,0.0231860496622733,0.277303605643616,0.699510344694111
12,"Brandenburg",12063056,"Dallgow-Döberitz",8616,4296,4320,0.498607242339833,8754,4408,4346,0.503541238291067,0.0231860496622733,0.277303605643616,0.699510344694111
12,"Brandenburg",12063080,"Falkensee, Stadt",40465,19762,20703,0.488372667737551,40900,20031,20869,0.489755501222494,0.0231860496622733,0.277303605643616,0.699510344694111
12,"Brandenburg",12063088,"Friesack, Stadt",2522,1267,1255,0.502379064234734,2518,1271,1247,0.504765687053217,0.0231860496622733,0.277303605643616,0.699510344694111
12,"Brandenburg",12063094,"Gollenberg",432,215,217,0.497685185185185,421,194,227,0.460807600950119,0.0231860496622733,0.277303605643616,0.699510344694111
12,"Brandenburg",12063112,"Großderschau",467,257,210,0.550321199143469,490,268,222,0.546938775510204,0.0231860496622733,0.277303605643616,0.699510344694111
12,"Brandenburg",12063134,"Havelaue",926,477,449,0.51511879049676,950,477,473,0.502105263157895,0.0231860496622733,0.277303605643616,0.699510344694111
12,"Brandenburg",12063142,"Wiesenaue",759,387,372,0.509881422924901,777,389,388,0.500643500643501,0.0231860496622733,0.277303605643616,0.699510344694111
12,"Brandenburg",12063148,"Ketzin/Havel, Stadt",6379,3172,3207,0.497256623295187,6441,3230,3211,0.501474926253687,0.0231860496622733,0.277303605643616,0.699510344694111
12,"Brandenburg",12063161,"Kleßen-Görne",367,198,169,0.539509536784741,367,194,173,0.528610354223433,0.0231860496622733,0.277303605643616,0.699510344694111
12,"Brandenburg",12063165,"Kotzen",588,302,286,0.513605442176871,618,324,294,0.524271844660194,0.0231860496622733,0.277303605643616,0.699510344694111
12,"Brandenburg",12063186,"Märkisch Luch",1287,664,623,0.515928515928516,1317,685,632,0.520121488230828,0.0231860496622733,0.277303605643616,0.699510344694111
12,"Brandenburg",12063189,"Milower Land",4403,2244,2159,0.50965250965251,4492,2286,2206,0.508904719501336,0.0231860496622733,0.277303605643616,0.699510344694111
12,"Brandenburg",12063202,"Mühlenberge",729,376,353,0.515775034293553,747,389,358,0.520749665327979,0.0231860496622733,0.277303605643616,0.699510344694111
12,"Brandenburg",12063208,"Nauen, Stadt",16475,8112,8363,0.492382397572079,16804,8370,8434,0.498095691502023,0.0231860496622733,0.277303605643616,0.699510344694111
12,"Brandenburg",12063212,"Nennhausen",1927,968,959,0.502335236118319,1902,946,956,0.497371188222923,0.0231860496622733,0.277303605643616,0.699510344694111
12,"Brandenburg",12063228,"Paulinenaue",1214,613,601,0.50494233937397,1225,612,613,0.499591836734694,0.0231860496622733,0.277303605643616,0.699510344694111
12,"Brandenburg",12063240,"Pessin",669,328,341,0.490284005979073,655,319,336,0.487022900763359,0.0231860496622733,0.277303605643616,0.699510344694111
12,"Brandenburg",12063244,"Premnitz, Stadt",8552,4102,4450,0.479653882132834,8715,4202,4513,0.482157200229489,0.0231860496622733,0.277303605643616,0.699510344694111
12,"Brandenburg",12063252,"Rathenow, Stadt",24348,11707,12641,0.480819779858715,25061,12149,12912,0.484777143769203,0.0231860496622733,0.277303605643616,0.699510344694111
12,"Brandenburg",12063256,"Retzow",552,261,291,0.472826086956522,554,259,295,0.467509025270758,0.0231860496622733,0.277303605643616,0.699510344694111
12,"Brandenburg",12063260,"Rhinow, Stadt",1695,856,839,0.505014749262537,1706,849,857,0.497655334114889,0.0231860496622733,0.277303605643616,0.699510344694111
12,"Brandenburg",12063273,"Schönwalde-Glien",8975,4448,4527,0.495598885793872,9096,4507,4589,0.495492524186456,0.0231860496622733,0.277303605643616,0.699510344694111
12,"Brandenburg",12063274,"Seeblick",928,472,456,0.508620689655172,939,481,458,0.512247071352503,0.0231860496622733,0.277303605643616,0.699510344694111
12,"Brandenburg",12063293,"Stechow-Ferchesar",904,453,451,0.501106194690266,919,464,455,0.504896626768226,0.0231860496622733,0.277303605643616,0.699510344694111
12,"Brandenburg",12063357,"Wustermark",7941,3957,3984,0.498299962221383,7911,3955,3956,0.499936796865124,0.0231860496622733,0.277303605643616,0.699510344694111
12,"Brandenburg",12064009,"Alt Tucheband",846,435,411,0.514184397163121,869,447,422,0.514384349827388,0.0231860496622733,0.277303605643616,0.699510344694111
12,"Brandenburg",12064029,"Altlandsberg, Stadt",8723,4395,4328,0.503840421873209,8798,4397,4401,0.499772675608093,0.0231860496622733,0.277303605643616,0.699510344694111
12,"Brandenburg",12064044,"Bad Freienwalde (Oder), Stadt",12656,6211,6445,0.490755372945638,12718,6264,6454,0.492530272055355,0.0231860496622733,0.277303605643616,0.699510344694111
12,"Brandenburg",12064053,"Beiersdorf-Freudenberg",569,279,290,0.490333919156415,562,275,287,0.48932384341637,0.0231860496622733,0.277303605643616,0.699510344694111
12,"Brandenburg",12064057,"Bleyen-Genschmar",489,254,235,0.519427402862986,474,244,230,0.514767932489452,0.0231860496622733,0.277303605643616,0.699510344694111
12,"Brandenburg",12064061,"Bliesdorf",983,517,466,0.525940996948118,983,484,499,0.492370295015259,0.0231860496622733,0.277303605643616,0.699510344694111
12,"Brandenburg",12064084,"Buckow (Märkische Schweiz), Stadt",1508,747,761,0.495358090185676,1580,786,794,0.49746835443038,0.0231860496622733,0.277303605643616,0.699510344694111
12,"Brandenburg",12064125,"Falkenberg",2298,1177,1121,0.512184508268059,2293,1176,1117,0.512865242040994,0.0231860496622733,0.277303605643616,0.699510344694111
12,"Brandenburg",12064128,"Falkenhagen (Mark)",729,368,361,0.50480109739369,730,376,354,0.515068493150685,0.0231860496622733,0.277303605643616,0.699510344694111
12,"Brandenburg",12064130,"Fichtenhöhe",547,278,269,0.508226691042048,551,284,267,0.515426497277677,0.0231860496622733,0.277303605643616,0.699510344694111
12,"Brandenburg",12064136,"Fredersdorf-Vogelsdorf",12532,6162,6370,0.491701244813278,12849,6364,6485,0.495291462370613,0.0231860496622733,0.277303605643616,0.699510344694111
12,"Brandenburg",12064153,"Garzau-Garzin",712,399,313,0.560393258426966,727,415,312,0.570839064649243,0.0231860496622733,0.277303605643616,0.699510344694111
12,"Brandenburg",12064172,"Golzow",904,467,437,0.516592920353982,855,435,420,0.508771929824561,0.0231860496622733,0.277303605643616,0.699510344694111
12,"Brandenburg",12064190,"Gusow-Platkow",1233,624,609,0.506082725060827,1256,632,624,0.503184713375796,0.0231860496622733,0.277303605643616,0.699510344694111
12,"Brandenburg",12064205,"Heckelberg-Brunow",697,377,320,0.540889526542324,734,405,329,0.551771117166213,0.0231860496622733,0.277303605643616,0.699510344694111
12,"Brandenburg",12064222,"Höhenland",1018,527,491,0.517681728880157,1022,530,492,0.518590998043053,0.0231860496622733,0.277303605643616,0.699510344694111
12,"Brandenburg",12064227,"Hoppegarten",16651,8145,8506,0.489159810221608,16808,8297,8511,0.49363398381723,0.0231860496622733,0.277303605643616,0.699510344694111
12,"Brandenburg",12064266,"Küstriner Vorland",2640,1368,1272,0.518181818181818,2713,1401,1312,0.516402506450424,0.0231860496622733,0.277303605643616,0.699510344694111
12,"Brandenburg",12064268,"Lebus, Stadt",3205,1607,1598,0.501404056162246,3200,1608,1592,0.5025,0.0231860496622733,0.277303605643616,0.699510344694111
12,"Brandenburg",12064274,"Letschin",4215,2149,2066,0.509845788849348,4196,2143,2053,0.510724499523356,0.0231860496622733,0.277303605643616,0.699510344694111
12,"Brandenburg",12064288,"Lietzen",682,354,328,0.519061583577713,692,362,330,0.523121387283237,0.0231860496622733,0.277303605643616,0.699510344694111
12,"Brandenburg",12064290,"Lindendorf",1418,721,697,0.508462623413258,1426,728,698,0.510518934081346,0.0231860496622733,0.277303605643616,0.699510344694111
12,"Brandenburg",12064303,"Märkische Höhe",590,300,290,0.508474576271186,605,315,290,0.520661157024793,0.0231860496622733,0.277303605643616,0.699510344694111
12,"Brandenburg",12064317,"Müncheberg, Stadt",6818,3417,3401,0.501173364623057,7098,3631,3467,0.511552550014089,0.0231860496622733,0.277303605643616,0.699510344694111
12,"Brandenburg",12064336,"Neuenhagen bei Berlin",16812,8204,8608,0.487984772781347,16972,8325,8647,0.490513787414565,0.0231860496622733,0.277303605643616,0.699510344694111
12,"Brandenburg",12064340,"Neuhardenberg",2464,1247,1217,0.506087662337662,2628,1331,1297,0.506468797564688,0.0231860496622733,0.277303605643616,0.699510344694111
12,"Brandenburg",12064349,"Neulewin",941,484,457,0.514346439957492,962,498,464,0.517671517671518,0.0231860496622733,0.277303605643616,0.699510344694111
12,"Brandenburg",12064365,"Neutrebbin",1497,742,755,0.495657982631931,1477,739,738,0.500338524035207,0.0231860496622733,0.277303605643616,0.699510344694111
12,"Brandenburg",12064370,"Oberbarnim",1422,717,705,0.5042194092827,1448,739,709,0.510359116022099,0.0231860496622733,0.277303605643616,0.699510344694111
12,"Brandenburg",12064371,"Oderaue",1714,869,845,0.507001166861143,1713,864,849,0.504378283712785,0.0231860496622733,0.277303605643616,0.699510344694111
12,"Brandenburg",12064380,"Petershagen/Eggersdorf",13971,6929,7042,0.495955908667955,13917,6890,7027,0.495077962204498,0.0231860496622733,0.277303605643616,0.699510344694111
12,"Brandenburg",12064388,"Podelzig",908,459,449,0.505506607929515,928,467,461,0.50323275862069,0.0231860496622733,0.277303605643616,0.699510344694111
12,"Brandenburg",12064393,"Prötzel",1000,525,475,0.525,1126,631,495,0.560390763765542,0.0231860496622733,0.277303605643616,0.699510344694111
12,"Brandenburg",12064408,"Rehfelde",4507,2280,2227,0.505879742622587,4416,2230,2186,0.504981884057971,0.0231860496622733,0.277303605643616,0.699510344694111
12,"Brandenburg",12064417,"Reichenow-Möglin",569,277,292,0.486818980667838,572,278,294,0.486013986013986,0.0231860496622733,0.277303605643616,0.699510344694111
12,"Brandenburg",12064420,"Reitwein",482,244,238,0.506224066390041,494,248,246,0.502024291497976,0.0231860496622733,0.277303605643616,0.699510344694111
12,"Brandenburg",12064428,"Rüdersdorf bei Berlin",14916,7441,7475,0.498860284258514,15317,7730,7587,0.504668015930012,0.0231860496622733,0.277303605643616,0.699510344694111
12,"Brandenburg",12064448,"Seelow, Stadt",5445,2590,2855,0.475665748393021,5392,2564,2828,0.475519287833828,0.0231860496622733,0.277303605643616,0.699510344694111
12,"Brandenburg",12064472,"Strausberg, Stadt",25611,12350,13261,0.482214673382531,26156,12821,13335,0.490174338583881,0.0231860496622733,0.277303605643616,0.699510344694111
12,"Brandenburg",12064480,"Treplin",389,205,184,0.526992287917738,404,205,199,0.507425742574257,0.0231860496622733,0.277303605643616,0.699510344694111
12,"Brandenburg",12064482,"Vierlinden",1502,781,721,0.519973368841545,1503,793,710,0.527611443779108,0.0231860496622733,0.277303605643616,0.699510344694111
12,"Brandenburg",12064484,"Waldsieversdorf",840,423,417,0.503571428571429,901,484,417,0.537180910099889,0.0231860496622733,0.277303605643616,0.699510344694111
12,"Brandenburg",12064512,"Wriezen, Stadt",7487,3730,3757,0.49819687458261,7615,3830,3785,0.50295469468155,0.0231860496622733,0.277303605643616,0.699510344694111
12,"Brandenburg",12064538,"Zechin",678,352,326,0.519174041297935,696,366,330,0.525862068965517,0.0231860496622733,0.277303605643616,0.699510344694111
12,"Brandenburg",12064539,"Zeschdorf",1267,655,612,0.516969218626677,1297,666,631,0.51349267540478,0.0231860496622733,0.277303605643616,0.699510344694111
12,"Brandenburg",12065036,"Birkenwerder",7748,3844,3904,0.496128033040785,7832,3910,3922,0.49923391215526,0.0231860496622733,0.277303605643616,0.699510344694111
12,"Brandenburg",12065084,"Fürstenberg/Havel, Stadt",6054,2969,3085,0.490419557317476,6101,2998,3103,0.491394853302737,0.0231860496622733,0.277303605643616,0.699510344694111
12,"Brandenburg",12065096,"Glienicke/Nordbahn",11085,5365,5720,0.483987370320253,11143,5442,5701,0.488378354123665,0.0231860496622733,0.277303605643616,0.699510344694111
12,"Brandenburg",12065100,"Gransee, Stadt",5926,2949,2977,0.497637529530881,5951,2983,2968,0.501260292387834,0.0231860496622733,0.277303605643616,0.699510344694111
12,"Brandenburg",12065117,"Großwoltersdorf",811,417,394,0.514180024660913,865,448,417,0.517919075144509,0.0231860496622733,0.277303605643616,0.699510344694111
12,"Brandenburg",12065136,"Hennigsdorf, Stadt",25597,12377,13220,0.483533226549986,25988,12641,13347,0.486416807757427,0.0231860496622733,0.277303605643616,0.699510344694111
12,"Brandenburg",12065144,"Hohen Neuendorf, Stadt",24585,11929,12656,0.485214561724629,24551,11897,12654,0.484583112704167,0.0231860496622733,0.277303605643616,0.699510344694111
12,"Brandenburg",12065165,"Kremmen, Stadt",7121,3580,3541,0.50273837944109,7074,3562,3512,0.503534068419565,0.0231860496622733,0.277303605643616,0.699510344694111
12,"Brandenburg",12065180,"Leegebruch",6599,3247,3352,0.492044249128656,6640,3269,3371,0.492319277108434,0.0231860496622733,0.277303605643616,0.699510344694111
12,"Brandenburg",12065193,"Liebenwalde, Stadt",4275,2179,2096,0.509707602339181,4312,2189,2123,0.50765306122449,0.0231860496622733,0.277303605643616,0.699510344694111
12,"Brandenburg",12065198,"Löwenberger Land",8016,4027,3989,0.502370259481038,8034,4051,3983,0.504232013940752,0.0231860496622733,0.277303605643616,0.699510344694111
12,"Brandenburg",12065225,"Mühlenbecker Land",14075,7036,7039,0.499893428063943,14205,7091,7114,0.499190425906371,0.0231860496622733,0.277303605643616,0.699510344694111
12,"Brandenburg",12065251,"Oberkrämer",10399,5237,5162,0.50360611597269,10689,5437,5252,0.50865375619796,0.0231860496622733,0.277303605643616,0.699510344694111
12,"Brandenburg",12065256,"Oranienburg, Stadt",41370,20179,21191,0.487768914672468,41966,20733,21233,0.494042796549588,0.0231860496622733,0.277303605643616,0.699510344694111
12,"Brandenburg",12065276,"Schönermark",432,217,215,0.502314814814815,413,198,215,0.479418886198547,0.0231860496622733,0.277303605643616,0.699510344694111
12,"Brandenburg",12065301,"Sonnenberg",855,438,417,0.512280701754386,877,458,419,0.522234891676169,0.0231860496622733,0.277303605643616,0.699510344694111
12,"Brandenburg",12065310,"Stechlin",1213,613,600,0.505358615004122,1232,616,616,0.5,0.0231860496622733,0.277303605643616,0.699510344694111
12,"Brandenburg",12065332,"Velten, Stadt",11527,5725,5802,0.496660015615511,11951,5950,6001,0.497866287339972,0.0231860496622733,0.277303605643616,0.699510344694111
12,"Brandenburg",12065356,"Zehdenick, Stadt",13511,6720,6791,0.497372511287099,13684,6828,6856,0.498976907337036,0.0231860496622733,0.277303605643616,0.699510344694111
12,"Brandenburg",12066008,"Altdöbern",2660,1329,1331,0.499624060150376,2634,1312,1322,0.498101746393318,0.0231860496622733,0.277303605643616,0.699510344694111
12,"Brandenburg",12066041,"Bronkow",638,326,312,0.510971786833856,628,322,306,0.512738853503185,0.0231860496622733,0.277303605643616,0.699510344694111
12,"Brandenburg",12066052,"Calau, Stadt",8315,4112,4203,0.494527961515334,8414,4158,4256,0.494176372712146,0.0231860496622733,0.277303605643616,0.699510344694111
12,"Brandenburg",12066064,"Frauendorf",724,366,358,0.505524861878453,752,374,378,0.497340425531915,0.0231860496622733,0.277303605643616,0.699510344694111
12,"Brandenburg",12066104,"Großkmehlen",1097,553,544,0.504102096627165,1169,617,552,0.527801539777588,0.0231860496622733,0.277303605643616,0.699510344694111
12,"Brandenburg",12066112,"Großräschen, Stadt",9200,4481,4719,0.487065217391304,10062,5141,4921,0.510932220234546,0.0231860496622733,0.277303605643616,0.699510344694111
12,"Brandenburg",12066116,"Grünewald",572,284,288,0.496503496503497,568,281,287,0.494718309859155,0.0231860496622733,0.277303605643616,0.699510344694111
12,"Brandenburg",12066120,"Guteborn",552,281,271,0.509057971014493,576,290,286,0.503472222222222,0.0231860496622733,0.277303605643616,0.699510344694111
12,"Brandenburg",12066124,"Hermsdorf",813,400,413,0.4920049200492,817,405,412,0.495716034271726,0.0231860496622733,0.277303605643616,0.699510344694111
12,"Brandenburg",12066132,"Hohenbocka",1041,515,526,0.494716618635927,1073,520,553,0.484622553588071,0.0231860496622733,0.277303605643616,0.699510344694111
12,"Brandenburg",12066168,"Kroppen",710,365,345,0.514084507042254,712,373,339,0.523876404494382,0.0231860496622733,0.277303605643616,0.699510344694111
12,"Brandenburg",12066176,"Lauchhammer, Stadt",15877,7718,8159,0.486111985891541,16659,8216,8443,0.493186865958341,0.0231860496622733,0.277303605643616,0.699510344694111
12,"Brandenburg",12066188,"Lindenau",709,363,346,0.511988716502116,726,366,360,0.504132231404959,0.0231860496622733,0.277303605643616,0.699510344694111
12,"Brandenburg",12066196,"Lübbenau/Spreewald, Stadt",16438,8002,8436,0.486798880642414,16713,8164,8549,0.488482019984443,0.0231860496622733,0.277303605643616,0.699510344694111
12,"Brandenburg",12066202,"Luckaitztal",876,446,430,0.509132420091324,864,443,421,0.512731481481482,0.0231860496622733,0.277303605643616,0.699510344694111
12,"Brandenburg",12066226,"Neu-Seeland",630,313,317,0.496825396825397,555,213,342,0.383783783783784,0.0231860496622733,0.277303605643616,0.699510344694111
12,"Brandenburg",12066228,"Neupetershain",1372,670,702,0.488338192419825,1437,705,732,0.490605427974948,0.0231860496622733,0.277303605643616,0.699510344694111
12,"Brandenburg",12066240,"Ortrand, Stadt",2257,1082,1175,0.479397430217102,2220,1078,1142,0.485585585585586,0.0231860496622733,0.277303605643616,0.699510344694111
12,"Brandenburg",12066272,"Ruhland, Stadt",3819,1890,1929,0.494893951296151,3847,1888,1959,0.490772030153366,0.0231860496622733,0.277303605643616,0.699510344694111
12,"Brandenburg",12066285,"Schipkau",7088,3519,3569,0.496472911963883,7219,3603,3616,0.499099598282311,0.0231860496622733,0.277303605643616,0.699510344694111
12,"Brandenburg",12066292,"Schwarzbach",701,352,349,0.502139800285307,715,365,350,0.510489510489511,0.0231860496622733,0.277303605643616,0.699510344694111
12,"Brandenburg",12066296,"Schwarzheide, Stadt",5893,2914,2979,0.49448498218225,5982,2990,2992,0.49983283182882,0.0231860496622733,0.277303605643616,0.699510344694111
12,"Brandenburg",12066304,"Senftenberg, Stadt",25388,12247,13141,0.482393256656688,26177,12710,13467,0.485540741872636,0.0231860496622733,0.277303605643616,0.699510344694111
12,"Brandenburg",12066316,"Tettau",826,403,423,0.487893462469734,807,391,416,0.48451053283767,0.0231860496622733,0.277303605643616,0.699510344694111
12,"Brandenburg",12066320,"Vetschau/Spreewald, Stadt",8702,4331,4371,0.497701677775224,8697,4316,4381,0.496263079222721,0.0231860496622733,0.277303605643616,0.699510344694111
12,"Brandenburg",12067024,"Bad Saarow",4929,2329,2600,0.472509636843173,5015,2415,2600,0.481555333998006,0.0231860496622733,0.277303605643616,0.699510344694111
12,"Brandenburg",12067036,"Beeskow, Stadt",8030,3865,4165,0.4813200498132,8069,3917,4152,0.485438096418391,0.0231860496622733,0.277303605643616,0.699510344694111
12,"Brandenburg",12067040,"Berkenbrück",999,485,514,0.485485485485485,1018,491,527,0.482318271119843,0.0231860496622733,0.277303605643616,0.699510344694111
12,"Brandenburg",12067072,"Briesen (Mark)",2181,1095,1086,0.502063273727648,2182,1113,1069,0.510082493125573,0.0231860496622733,0.277303605643616,0.699510344694111
12,"Brandenburg",12067076,"Brieskow-Finkenheerd",2388,1195,1193,0.500418760469012,2403,1208,1195,0.502704952143154,0.0231860496622733,0.277303605643616,0.699510344694111
12,"Brandenburg",12067112,"Diensdorf-Radlow",565,291,274,0.515044247787611,562,287,275,0.51067615658363,0.0231860496622733,0.277303605643616,0.699510344694111
12,"Brandenburg",12067120,"Eisenhüttenstadt, Stadt",27795,13363,14432,0.480769922647958,30390,15323,15067,0.504211911813096,0.0231860496622733,0.277303605643616,0.699510344694111
12,"Brandenburg",12067124,"Erkner, Stadt",11405,5409,5996,0.47426567295046,11613,5523,6090,0.475587703435805,0.0231860496622733,0.277303605643616,0.699510344694111
12,"Brandenburg",12067137,"Friedland, Stadt",3153,1622,1531,0.514430700919759,3106,1587,1519,0.510946555054733,0.0231860496622733,0.277303605643616,0.699510344694111
12,"Brandenburg",12067144,"Fürstenwalde/Spree, Stadt",30910,15093,15817,0.488288579747654,32456,16066,16390,0.495008627064333,0.0231860496622733,0.277303605643616,0.699510344694111
12,"Brandenburg",12067173,"Gosen-Neu Zittau",3020,1606,1414,0.531788079470199,3022,1616,1406,0.534745201853077,0.0231860496622733,0.277303605643616,0.699510344694111
12,"Brandenburg",12067180,"Groß Lindow",1779,886,893,0.498032602585722,1801,894,907,0.496390893947807,0.0231860496622733,0.277303605643616,0.699510344694111
12,"Brandenburg",12067201,"Grünheide (Mark)",8034,3947,4087,0.491287030121982,8001,3920,4081,0.489938757655293,0.0231860496622733,0.277303605643616,0.699510344694111
12,"Brandenburg",12067205,"Grunow-Dammendorf",532,279,253,0.524436090225564,543,286,257,0.52670349907919,0.0231860496622733,0.277303605643616,0.699510344694111
12,"Brandenburg",12067237,"Jacobsdorf",1870,910,960,0.486631016042781,1875,900,975,0.48,0.0231860496622733,0.277303605643616,0.699510344694111
12,"Brandenburg",12067288,"Langewahl",812,409,403,0.503694581280788,811,405,406,0.499383477188656,0.0231860496622733,0.277303605643616,0.699510344694111
12,"Brandenburg",12067292,"Lawitz",604,310,294,0.513245033112583,618,320,298,0.517799352750809,0.0231860496622733,0.277303605643616,0.699510344694111
12,"Brandenburg",12067310,"Madlitz-Wilmersdorf",682,344,338,0.504398826979472,706,361,345,0.511331444759207,0.0231860496622733,0.277303605643616,0.699510344694111
12,"Brandenburg",12067324,"Mixdorf",940,463,477,0.492553191489362,955,462,493,0.483769633507853,0.0231860496622733,0.277303605643616,0.699510344694111
12,"Brandenburg",12067336,"Müllrose, Stadt",4367,2132,2235,0.488207007098695,4445,2177,2268,0.489763779527559,0.0231860496622733,0.277303605643616,0.699510344694111
12,"Brandenburg",12067338,"Neißemünde",1747,850,897,0.48654836863194,1750,859,891,0.490857142857143,0.0231860496622733,0.277303605643616,0.699510344694111
12,"Brandenburg",12067357,"Neuzelle",4404,2221,2183,0.504314259763851,4404,2200,2204,0.499545867393279,0.0231860496622733,0.277303605643616,0.699510344694111
12,"Brandenburg",12067397,"Ragow-Merz",515,249,266,0.483495145631068,471,227,244,0.481953290870488,0.0231860496622733,0.277303605643616,0.699510344694111
12,"Brandenburg",12067408,"Rauen",1953,984,969,0.50384024577573,1940,971,969,0.500515463917526,0.0231860496622733,0.277303605643616,0.699510344694111
12,"Brandenburg",12067413,"Reichenwalde",1122,595,527,0.53030303030303,1115,592,523,0.530941704035874,0.0231860496622733,0.277303605643616,0.699510344694111
12,"Brandenburg",12067426,"Rietz-Neuendorf",4209,2180,2029,0.517937752435258,4200,2185,2015,0.520238095238095,0.0231860496622733,0.277303605643616,0.699510344694111
12,"Brandenburg",12067438,"Schlaubetal",1890,962,928,0.508994708994709,1889,958,931,0.507146638433033,0.0231860496622733,0.277303605643616,0.699510344694111
12,"Brandenburg",12067440,"Schöneiche bei Berlin",12000,5898,6102,0.4915,12217,6032,6185,0.493738233608906,0.0231860496622733,0.277303605643616,0.699510344694111
12,"Brandenburg",12067458,"Siehdichum",1566,778,788,0.496807151979566,1601,801,800,0.500312304809494,0.0231860496622733,0.277303605643616,0.699510344694111
12,"Brandenburg",12067469,"Spreenhagen",3250,1636,1614,0.503384615384615,3390,1732,1658,0.510914454277286,0.0231860496622733,0.277303605643616,0.699510344694111
12,"Brandenburg",12067473,"Steinhöfel",4378,2194,2184,0.501142074006396,4418,2226,2192,0.503847894975102,0.0231860496622733,0.277303605643616,0.699510344694111
12,"Brandenburg",12067481,"Storkow (Mark), Stadt",8963,4466,4497,0.498270668303024,8989,4514,4475,0.502169318055401,0.0231860496622733,0.277303605643616,0.699510344694111
12,"Brandenburg",12067493,"Tauche",3936,1986,1950,0.504573170731707,3853,1945,1908,0.504801453412925,0.0231860496622733,0.277303605643616,0.699510344694111
12,"Brandenburg",12067508,"Vogelsang",768,392,376,0.510416666666667,774,394,380,0.509043927648579,0.0231860496622733,0.277303605643616,0.699510344694111
12,"Brandenburg",12067520,"Wendisch Rietz",1442,699,743,0.484743411927878,1416,688,728,0.485875706214689,0.0231860496622733,0.277303605643616,0.699510344694111
12,"Brandenburg",12067528,"Wiesenau",1291,641,650,0.496514329976762,1304,654,650,0.501533742331288,0.0231860496622733,0.277303605643616,0.699510344694111
12,"Brandenburg",12067544,"Woltersdorf",7744,3850,3894,0.497159090909091,7874,3923,3951,0.498221996443993,0.0231860496622733,0.277303605643616,0.699510344694111
12,"Brandenburg",12067552,"Ziltendorf",1591,812,779,0.510370835952231,1602,805,797,0.502496878901373,0.0231860496622733,0.277303605643616,0.699510344694111
12,"Brandenburg",12068052,"Breddin",911,454,457,0.498353457738749,922,476,446,0.516268980477223,0.0231860496622733,0.277303605643616,0.699510344694111
12,"Brandenburg",12068072,"Dabergotz",613,287,326,0.468189233278956,606,282,324,0.465346534653465,0.0231860496622733,0.277303605643616,0.699510344694111
12,"Brandenburg",12068109,"Dreetz",1147,573,574,0.499564080209241,1183,604,579,0.510566356720203,0.0231860496622733,0.277303605643616,0.699510344694111
12,"Brandenburg",12068117,"Fehrbellin",8595,4421,4174,0.514368819080861,8700,4454,4246,0.511954022988506,0.0231860496622733,0.277303605643616,0.699510344694111
12,"Brandenburg",12068181,"Heiligengrabe",4603,2329,2274,0.505974364544862,4638,2353,2285,0.507330746011212,0.0231860496622733,0.277303605643616,0.699510344694111
12,"Brandenburg",12068188,"Herzberg (Mark)",643,320,323,0.497667185069984,658,323,335,0.490881458966565,0.0231860496622733,0.277303605643616,0.699510344694111
12,"Brandenburg",12068264,"Kyritz, Stadt",9303,4529,4774,0.486832204665162,9449,4627,4822,0.489681447772251,0.0231860496622733,0.277303605643616,0.699510344694111
12,"Brandenburg",12068280,"Lindow (Mark), Stadt",3075,1562,1513,0.507967479674797,3064,1559,1505,0.508812010443864,0.0231860496622733,0.277303605643616,0.699510344694111
12,"Brandenburg",12068306,"Märkisch Linden",1188,609,579,0.512626262626263,1236,647,589,0.523462783171521,0.0231860496622733,0.277303605643616,0.699510344694111
12,"Brandenburg",12068320,"Neuruppin, Stadt",30184,14750,15434,0.488669493771535,31508,15567,15941,0.494064999365241,0.0231860496622733,0.277303605643616,0.699510344694111
12,"Brandenburg",12068324,"Neustadt (Dosse), Stadt",3531,1715,1816,0.485698102520532,3569,1811,1758,0.507425049033343,0.0231860496622733,0.277303605643616,0.699510344694111
12,"Brandenburg",12068353,"Rheinsberg, Stadt",8254,4114,4140,0.498425006057669,8422,4206,4216,0.499406316789361,0.0231860496622733,0.277303605643616,0.699510344694111
12,"Brandenburg",12068372,"Rüthnick",494,246,248,0.497975708502024,502,247,255,0.49203187250996,0.0231860496622733,0.277303605643616,0.699510344694111
12,"Brandenburg",12068409,"Sieversdorf-Hohenofen",756,391,365,0.517195767195767,777,408,369,0.525096525096525,0.0231860496622733,0.277303605643616,0.699510344694111
12,"Brandenburg",12068413,"Storbeck-Frankendorf",481,240,241,0.498960498960499,500,250,250,0.5,0.0231860496622733,0.277303605643616,0.699510344694111
12,"Brandenburg",12068417,"Stüdenitz-Schönermark",616,312,304,0.506493506493506,605,300,305,0.495867768595041,0.0231860496622733,0.277303605643616,0.699510344694111
12,"Brandenburg",12068425,"Temnitzquell",786,385,401,0.489821882951654,801,384,417,0.47940074906367,0.0231860496622733,0.277303605643616,0.699510344694111
12,"Brandenburg",12068426,"Temnitztal",1450,744,706,0.513103448275862,1523,786,737,0.516086671043992,0.0231860496622733,0.277303605643616,0.699510344694111
12,"Brandenburg",12068437,"Vielitzsee",479,256,223,0.534446764091858,537,296,241,0.5512104283054,0.0231860496622733,0.277303605643616,0.699510344694111
12,"Brandenburg",12068452,"Walsleben",821,441,380,0.537149817295981,769,412,357,0.535760728218466,0.0231860496622733,0.277303605643616,0.699510344694111
12,"Brandenburg",12068468,"Wittstock/Dosse, Stadt",14801,7323,7478,0.494763867306263,15050,7475,7575,0.496677740863787,0.0231860496622733,0.277303605643616,0.699510344694111
12,"Brandenburg",12068477,"Wusterhausen/Dosse",6129,3138,2991,0.511992168379834,6186,3157,3029,0.510345942450695,0.0231860496622733,0.277303605643616,0.699510344694111
12,"Brandenburg",12068501,"Zernitz-Lohm",893,459,434,0.513997760358343,903,466,437,0.516057585825028,0.0231860496622733,0.277303605643616,0.699510344694111
12,"Brandenburg",12069017,"Beelitz, Stadt",11658,5862,5796,0.502830674215131,11831,6007,5824,0.507733919364382,0.0231860496622733,0.277303605643616,0.699510344694111
12,"Brandenburg",12069018,"Beetzsee",2427,1234,1193,0.508446641944788,2502,1287,1215,0.514388489208633,0.0231860496622733,0.277303605643616,0.699510344694111
12,"Brandenburg",12069019,"Beetzseeheide",654,325,329,0.496941896024465,658,314,344,0.477203647416413,0.0231860496622733,0.277303605643616,0.699510344694111
12,"Brandenburg",12069020,"Bad Belzig, Stadt",11161,5491,5670,0.491981005286265,11203,5506,5697,0.491475497634562,0.0231860496622733,0.277303605643616,0.699510344694111
12,"Brandenburg",12069028,"Bensdorf",1266,632,634,0.499210110584518,1224,615,609,0.502450980392157,0.0231860496622733,0.277303605643616,0.699510344694111
12,"Brandenburg",12069052,"Borkheide",1875,965,910,0.514666666666667,1864,942,922,0.505364806866953,0.0231860496622733,0.277303605643616,0.699510344694111
12,"Brandenburg",12069056,"Borkwalde",1480,731,749,0.493918918918919,1574,797,777,0.506353240152478,0.0231860496622733,0.277303605643616,0.699510344694111
12,"Brandenburg",12069076,"Brück, Stadt",3685,1859,1826,0.504477611940298,3602,1812,1790,0.50305385896724,0.0231860496622733,0.277303605643616,0.699510344694111
12,"Brandenburg",12069089,"Buckautal",524,274,250,0.522900763358779,517,268,249,0.518375241779497,0.0231860496622733,0.277303605643616,0.699510344694111
12,"Brandenburg",12069216,"Golzow",1331,674,657,0.506386175807663,1311,660,651,0.503432494279176,0.0231860496622733,0.277303605643616,0.699510344694111
12,"Brandenburg",12069224,"Görzke",1296,656,640,0.506172839506173,1330,685,645,0.515037593984962,0.0231860496622733,0.277303605643616,0.699510344694111
12,"Brandenburg",12069232,"Gräben",540,270,270,0.5,560,281,279,0.501785714285714,0.0231860496622733,0.277303605643616,0.699510344694111
12,"Brandenburg",12069249,"Groß Kreutz (Havel)",8103,4064,4039,0.50154263852894,8107,4086,4021,0.504008881213766,0.0231860496622733,0.277303605643616,0.699510344694111
12,"Brandenburg",12069270,"Havelsee, Stadt",3431,1711,1720,0.498688429029437,3460,1707,1753,0.493352601156069,0.0231860496622733,0.277303605643616,0.699510344694111
12,"Brandenburg",12069304,"Kleinmachnow",20086,9690,10396,0.48242557004879,20181,9779,10402,0.484564689559487,0.0231860496622733,0.277303605643616,0.699510344694111
12,"Brandenburg",12069306,"Kloster Lehnin",10732,5386,5346,0.501863585538576,11018,5521,5497,0.501089126883282,0.0231860496622733,0.277303605643616,0.699510344694111
12,"Brandenburg",12069345,"Linthe",896,478,418,0.533482142857143,889,481,408,0.541057367829021,0.0231860496622733,0.277303605643616,0.699510344694111
12,"Brandenburg",12069397,"Michendorf",11766,5717,6049,0.485891551929288,11911,5901,6010,0.495424397615649,0.0231860496622733,0.277303605643616,0.699510344694111
12,"Brandenburg",12069402,"Mühlenfließ",917,470,447,0.512540894220283,930,469,461,0.504301075268817,0.0231860496622733,0.277303605643616,0.699510344694111
12,"Brandenburg",12069448,"Niemegk, Stadt",2034,1027,1007,0.504916420845624,2045,1034,1011,0.505623471882641,0.0231860496622733,0.277303605643616,0.699510344694111
12,"Brandenburg",12069454,"Nuthetal",8625,4246,4379,0.492289855072464,8798,4355,4443,0.49499886337804,0.0231860496622733,0.277303605643616,0.699510344694111
12,"Brandenburg",12069460,"Päwesin",537,260,277,0.484171322160149,562,279,283,0.49644128113879,0.0231860496622733,0.277303605643616,0.699510344694111
12,"Brandenburg",12069470,"Planebruch",1084,564,520,0.520295202952029,1090,565,525,0.518348623853211,0.0231860496622733,0.277303605643616,0.699510344694111
12,"Brandenburg",12069474,"Planetal",983,505,478,0.513733468972533,983,510,473,0.51881993896236,0.0231860496622733,0.277303605643616,0.699510344694111
12,"Brandenburg",12069485,"Rabenstein/Fläming",860,449,411,0.522093023255814,867,458,409,0.528258362168397,0.0231860496622733,0.277303605643616,0.699510344694111
12,"Brandenburg",12069537,"Rosenau",939,484,455,0.515441959531416,942,477,465,0.506369426751592,0.0231860496622733,0.277303605643616,0.699510344694111
12,"Brandenburg",12069541,"Roskow",1215,625,590,0.51440329218107,1222,630,592,0.515548281505728,0.0231860496622733,0.277303605643616,0.699510344694111
12,"Brandenburg",12069590,"Schwielowsee",9973,4897,5076,0.49102576957786,10198,4998,5200,0.490096097273975,0.0231860496622733,0.277303605643616,0.699510344694111
12,"Brandenburg",12069596,"Seddiner See",3959,1961,1998,0.495327102803738,4222,2149,2073,0.509000473709143,0.0231860496622733,0.277303605643616,0.699510344694111
12,"Brandenburg",12069604,"Stahnsdorf",14156,6985,7171,0.493430347555807,14351,7092,7259,0.494181590133092,0.0231860496622733,0.277303605643616,0.699510344694111
12,"Brandenburg",12069616,"Teltow, Stadt",22716,11098,11618,0.48855432294418,23069,11236,11833,0.487060557458061,0.0231860496622733,0.277303605643616,0.699510344694111
12,"Brandenburg",12069632,"Treuenbrietzen, Stadt",7569,3720,3849,0.491478398731669,7710,3785,3925,0.490920881971466,0.0231860496622733,0.277303605643616,0.699510344694111
12,"Brandenburg",12069648,"Wenzlow",545,285,260,0.522935779816514,546,286,260,0.523809523809524,0.0231860496622733,0.277303605643616,0.699510344694111
12,"Brandenburg",12069656,"Werder (Havel), Stadt",23297,11443,11854,0.491179121775336,23211,11433,11778,0.492568178880703,0.0231860496622733,0.277303605643616,0.699510344694111
12,"Brandenburg",12069665,"Wiesenburg/Mark",4594,2357,2237,0.513060513713539,4699,2444,2255,0.520110661842945,0.0231860496622733,0.277303605643616,0.699510344694111
12,"Brandenburg",12069680,"Wollin",910,453,457,0.497802197802198,892,436,456,0.488789237668161,0.0231860496622733,0.277303605643616,0.699510344694111
12,"Brandenburg",12069688,"Wusterwitz",3082,1510,1572,0.489941596365996,3111,1517,1594,0.487624558019929,0.0231860496622733,0.277303605643616,0.699510344694111
12,"Brandenburg",12069696,"Ziesar, Stadt",2485,1201,1284,0.483299798792757,2488,1210,1278,0.486334405144695,0.0231860496622733,0.277303605643616,0.699510344694111
12,"Brandenburg",12070008,"Bad Wilsnack, Stadt",2637,1257,1380,0.476678043230944,2606,1254,1352,0.48119723714505,0.0231860496622733,0.277303605643616,0.699510344694111
12,"Brandenburg",12070028,"Berge",784,405,379,0.516581632653061,782,403,379,0.5153452685422,0.0231860496622733,0.277303605643616,0.699510344694111
12,"Brandenburg",12070052,"Breese",1482,750,732,0.506072874493927,1512,768,744,0.507936507936508,0.0231860496622733,0.277303605643616,0.699510344694111
12,"Brandenburg",12070060,"Cumlosen",791,395,396,0.49936788874842,799,399,400,0.499374217772215,0.0231860496622733,0.277303605643616,0.699510344694111
12,"Brandenburg",12070096,"Gerdshagen",537,274,263,0.51024208566108,543,279,264,0.513812154696133,0.0231860496622733,0.277303605643616,0.699510344694111
12,"Brandenburg",12070125,"Groß Pankow (Prignitz)",4063,2066,1997,0.508491262613832,4116,2080,2036,0.505344995140913,0.0231860496622733,0.277303605643616,0.699510344694111
12,"Brandenburg",12070145,"Gülitz-Reetz",475,240,235,0.505263157894737,494,248,246,0.502024291497976,0.0231860496622733,0.277303605643616,0.699510344694111
12,"Brandenburg",12070149,"Gumtow",3577,1802,1775,0.50377411238468,3601,1826,1775,0.507081366287143,0.0231860496622733,0.277303605643616,0.699510344694111
12,"Brandenburg",12070153,"Halenbeck-Rohlsdorf",562,280,282,0.498220640569395,565,281,284,0.497345132743363,0.0231860496622733,0.277303605643616,0.699510344694111
12,"Brandenburg",12070173,"Karstädt",6204,3138,3066,0.505802707930368,6258,3158,3100,0.504634068392458,0.0231860496622733,0.277303605643616,0.699510344694111
12,"Brandenburg",12070222,"Kümmernitztal",370,194,176,0.524324324324324,355,192,163,0.540845070422535,0.0231860496622733,0.277303605643616,0.699510344694111
12,"Brandenburg",12070236,"Lanz",804,401,403,0.498756218905473,802,397,405,0.49501246882793,0.0231860496622733,0.277303605643616,0.699510344694111
12,"Brandenburg",12070241,"Legde/Quitzöbel",634,325,309,0.512618296529968,639,332,307,0.519561815336463,0.0231860496622733,0.277303605643616,0.699510344694111
12,"Brandenburg",12070244,"Lenzen (Elbe), Stadt",2319,1112,1207,0.479517033203967,2327,1106,1221,0.475290073055436,0.0231860496622733,0.277303605643616,0.699510344694111
12,"Brandenburg",12070246,"Lenzerwische",484,249,235,0.514462809917355,510,255,255,0.5,0.0231860496622733,0.277303605643616,0.699510344694111
12,"Brandenburg",12070266,"Marienfließ",767,386,381,0.503259452411995,761,385,376,0.505913272010513,0.0231860496622733,0.277303605643616,0.699510344694111
12,"Brandenburg",12070280,"Meyenburg, Stadt",2243,1106,1137,0.493089612126616,2266,1119,1147,0.493821712268314,0.0231860496622733,0.277303605643616,0.699510344694111
12,"Brandenburg",12070296,"Perleberg, Stadt",12169,5921,6248,0.48656422056044,12250,5962,6288,0.48669387755102,0.0231860496622733,0.277303605643616,0.699510344694111
12,"Brandenburg",12070300,"Pirow",476,234,242,0.491596638655462,471,236,235,0.501061571125265,0.0231860496622733,0.277303605643616,0.699510344694111
12,"Brandenburg",12070302,"Plattenburg",3542,1805,1737,0.509599096555618,3635,1855,1780,0.510316368638239,0.0231860496622733,0.277303605643616,0.699510344694111
12,"Brandenburg",12070316,"Pritzwalk, Stadt",12236,6009,6227,0.491091860084995,12420,6092,6328,0.490499194847021,0.0231860496622733,0.277303605643616,0.699510344694111
12,"Brandenburg",12070325,"Putlitz, Stadt",2761,1402,1359,0.507787033683448,2766,1401,1365,0.506507592190889,0.0231860496622733,0.277303605643616,0.699510344694111
12,"Brandenburg",12070348,"Rühstädt",499,248,251,0.496993987975952,542,267,275,0.492619926199262,0.0231860496622733,0.277303605643616,0.699510344694111
12,"Brandenburg",12070393,"Triglitz",504,255,249,0.505952380952381,528,263,265,0.498106060606061,0.0231860496622733,0.277303605643616,0.699510344694111
12,"Brandenburg",12070416,"Weisen",1016,516,500,0.507874015748031,1046,532,514,0.508604206500956,0.0231860496622733,0.277303605643616,0.699510344694111
12,"Brandenburg",12070424,"Wittenberge, Stadt",17638,8382,9256,0.475223948293457,18278,8817,9461,0.482383192909509,0.0231860496622733,0.277303605643616,0.699510344694111
12,"Brandenburg",12071028,"Briesen",794,399,395,0.502518891687657,798,395,403,0.494987468671679,0.0231860496622733,0.277303605643616,0.699510344694111
12,"Brandenburg",12071032,"Burg (Spreewald)",4357,2169,2188,0.497819600642644,4358,2184,2174,0.50114731528224,0.0231860496622733,0.277303605643616,0.699510344694111
12,"Brandenburg",12071041,"Dissen-Striesow",1014,531,483,0.523668639053254,1022,530,492,0.518590998043053,0.0231860496622733,0.277303605643616,0.699510344694111
12,"Brandenburg",12071044,"Döbern, Stadt",3501,1689,1812,0.482433590402742,3540,1713,1827,0.483898305084746,0.0231860496622733,0.277303605643616,0.699510344694111
12,"Brandenburg",12071052,"Drachhausen",846,433,413,0.511820330969267,841,433,408,0.514863258026159,0.0231860496622733,0.277303605643616,0.699510344694111
12,"Brandenburg",12071057,"Drebkau, Stadt",5849,2988,2861,0.510856556676355,5866,2991,2875,0.509887487214456,0.0231860496622733,0.277303605643616,0.699510344694111
12,"Brandenburg",12071060,"Drehnow",571,286,285,0.500875656742557,577,286,291,0.495667244367418,0.0231860496622733,0.277303605643616,0.699510344694111
12,"Brandenburg",12071074,"Felixsee",2090,1070,1020,0.511961722488038,2172,1117,1055,0.51427255985267,0.0231860496622733,0.277303605643616,0.699510344694111
12,"Brandenburg",12071076,"Forst (Lausitz), Stadt",19576,9486,10090,0.484572946465059,20299,10024,10275,0.493817429430021,0.0231860496622733,0.277303605643616,0.699510344694111
12,"Brandenburg",12071153,"Groß Schacksdorf-Simmersdorf",1098,567,531,0.516393442622951,1147,594,553,0.517872711421098,0.0231860496622733,0.277303605643616,0.699510344694111
12,"Brandenburg",12071160,"Guben, Stadt",18323,8688,9635,0.474158161873056,18931,9087,9844,0.48000633880936,0.0231860496622733,0.277303605643616,0.699510344694111
12,"Brandenburg",12071164,"Guhrow",543,273,270,0.502762430939227,552,280,272,0.507246376811594,0.0231860496622733,0.277303605643616,0.699510344694111
12,"Brandenburg",12071176,"Heinersbrück",621,315,306,0.507246376811594,629,325,304,0.516693163751987,0.0231860496622733,0.277303605643616,0.699510344694111
12,"Brandenburg",12071185,"Hornow-Wadelsdorf",619,304,315,0.491114701130856,605,307,298,0.507438016528926,0.0231860496622733,0.277303605643616,0.699510344694111
12,"Brandenburg",12071189,"Jämlitz-Klein Düben",486,247,239,0.508230452674897,491,250,241,0.509164969450102,0.0231860496622733,0.277303605643616,0.699510344694111
12,"Brandenburg",12071193,"Jänschwalde",1638,837,801,0.510989010989011,1738,896,842,0.515535097813579,0.0231860496622733,0.277303605643616,0.699510344694111
12,"Brandenburg",12071244,"Kolkwitz",9289,4700,4589,0.505974808913769,9457,4817,4640,0.509358147404039,0.0231860496622733,0.277303605643616,0.699510344694111
12,"Brandenburg",12071294,"Neiße-Malxetal",1740,910,830,0.522988505747126,1783,932,851,0.522714526079641,0.0231860496622733,0.277303605643616,0.699510344694111
12,"Brandenburg",12071301,"Neuhausen/Spree",5173,2586,2587,0.499903344287647,5164,2604,2560,0.504260263361735,0.0231860496622733,0.277303605643616,0.699510344694111
12,"Brandenburg",12071304,"Peitz, Stadt",4500,2210,2290,0.491111111111111,4569,2346,2223,0.513460275771504,0.0231860496622733,0.277303605643616,0.699510344694111
12,"Brandenburg",12071337,"Schenkendöbern",3860,1941,1919,0.502849740932642,3875,1963,1912,0.50658064516129,0.0231860496622733,0.277303605643616,0.699510344694111
12,"Brandenburg",12071341,"Schmogrow-Fehrow",852,434,418,0.509389671361502,857,431,426,0.50291715285881,0.0231860496622733,0.277303605643616,0.699510344694111
12,"Brandenburg",12071372,"Spremberg, Stadt",22773,11007,11766,0.483335528915821,23991,12066,11925,0.502938601975741,0.0231860496622733,0.277303605643616,0.699510344694111
12,"Brandenburg",12071384,"Tauer",745,381,364,0.511409395973154,748,382,366,0.510695187165775,0.0231860496622733,0.277303605643616,0.699510344694111
12,"Brandenburg",12071386,"Teichland",1186,603,583,0.508431703204047,1170,600,570,0.512820512820513,0.0231860496622733,0.277303605643616,0.699510344694111
12,"Brandenburg",12071392,"Tschernitz",1297,662,635,0.510408635312259,1347,686,661,0.50927988121752,0.0231860496622733,0.277303605643616,0.699510344694111
12,"Brandenburg",12071401,"Turnow-Preilack",1184,598,586,0.505067567567568,1176,595,581,0.505952380952381,0.0231860496622733,0.277303605643616,0.699510344694111
12,"Brandenburg",12071408,"Welzow, Stadt",3866,1928,1938,0.498706673564408,3684,1860,1824,0.504885993485342,0.0231860496622733,0.277303605643616,0.699510344694111
12,"Brandenburg",12071412,"Werben",1719,861,858,0.50087260034904,1760,886,874,0.503409090909091,0.0231860496622733,0.277303605643616,0.699510344694111
12,"Brandenburg",12071414,"Wiesengrund",1461,745,716,0.509924709103354,1515,776,739,0.512211221122112,0.0231860496622733,0.277303605643616,0.699510344694111
12,"Brandenburg",12072002,"Am Mellensee",6490,3278,3212,0.505084745762712,6405,3225,3180,0.503512880562061,0.0231860496622733,0.277303605643616,0.699510344694111
12,"Brandenburg",12072014,"Baruth/Mark, Stadt",4192,2138,2054,0.510019083969466,4177,2150,2027,0.514723485755327,0.0231860496622733,0.277303605643616,0.699510344694111
12,"Brandenburg",12072017,"Blankenfelde-Mahlow",25604,12712,12892,0.496484924230589,25934,13167,12767,0.507711884013264,0.0231860496622733,0.277303605643616,0.699510344694111
12,"Brandenburg",12072053,"Dahme/Mark, Stadt",5288,2605,2683,0.492624810892587,5276,2607,2669,0.494124336618651,0.0231860496622733,0.277303605643616,0.699510344694111
12,"Brandenburg",12072055,"Dahmetal",494,249,245,0.504048582995951,473,238,235,0.503171247357294,0.0231860496622733,0.277303605643616,0.699510344694111
12,"Brandenburg",12072120,"Großbeeren",7666,3916,3750,0.510827028437255,7604,3870,3734,0.50894266175697,0.0231860496622733,0.277303605643616,0.699510344694111
12,"Brandenburg",12072157,"Ihlow",750,384,366,0.512,768,385,383,0.501302083333333,0.0231860496622733,0.277303605643616,0.699510344694111
12,"Brandenburg",12072169,"Jüterbog, Stadt",12211,5887,6324,0.482106297600524,12624,6190,6434,0.490335868187579,0.0231860496622733,0.277303605643616,0.699510344694111
12,"Brandenburg",12072232,"Luckenwalde, Stadt",20230,9703,10527,0.479634206623826,20414,9782,10632,0.479180954247085,0.0231860496622733,0.277303605643616,0.699510344694111
12,"Brandenburg",12072240,"Ludwigsfelde, Stadt",23769,11811,11958,0.49690773696832,24150,12013,12137,0.497432712215321,0.0231860496622733,0.277303605643616,0.699510344694111
12,"Brandenburg",12072297,"Niedergörsdorf",6089,3063,3026,0.503038265725078,6201,3112,3089,0.501854539590389,0.0231860496622733,0.277303605643616,0.699510344694111
12,"Brandenburg",12072298,"Niederer Fläming",3222,1672,1550,0.51893234016139,3224,1688,1536,0.523573200992556,0.0231860496622733,0.277303605643616,0.699510344694111
12,"Brandenburg",12072312,"Nuthe-Urstromtal",6459,3267,3192,0.505805852299118,6690,3401,3289,0.508370702541106,0.0231860496622733,0.277303605643616,0.699510344694111
12,"Brandenburg",12072340,"Rangsdorf",10444,5156,5288,0.493680582152432,10570,5244,5326,0.496121097445601,0.0231860496622733,0.277303605643616,0.699510344694111
12,"Brandenburg",12072426,"Trebbin, Stadt",9211,4643,4568,0.504071219194441,9319,4686,4633,0.502843652752441,0.0231860496622733,0.277303605643616,0.699510344694111
12,"Brandenburg",12072477,"Zossen, Stadt",17392,8559,8833,0.492122815087397,17717,8825,8892,0.49810916069312,0.0231860496622733,0.277303605643616,0.699510344694111
12,"Brandenburg",12073008,"Angermünde, Stadt",13826,6661,7165,0.481773470273398,14282,7008,7274,0.49068757877048,0.0231860496622733,0.277303605643616,0.699510344694111
12,"Brandenburg",12073032,"Berkholz-Meyenburg",1279,664,615,0.519155590304926,1287,659,628,0.512043512043512,0.0231860496622733,0.277303605643616,0.699510344694111
12,"Brandenburg",12073069,"Boitzenburger Land",3392,1757,1635,0.517983490566038,3559,1853,1706,0.520651868502388,0.0231860496622733,0.277303605643616,0.699510344694111
12,"Brandenburg",12073085,"Brüssow, Stadt",1992,1004,988,0.504016064257028,2038,1039,999,0.509813542688911,0.0231860496622733,0.277303605643616,0.699510344694111
12,"Brandenburg",12073093,"Carmzow-Wallmow",662,353,309,0.533232628398791,663,346,317,0.521870286576169,0.0231860496622733,0.277303605643616,0.699510344694111
12,"Brandenburg",12073097,"Casekow",1953,983,970,0.503328213005632,2134,1084,1050,0.50796626054358,0.0231860496622733,0.277303605643616,0.699510344694111
12,"Brandenburg",12073157,"Flieth-Stegelitz",578,295,283,0.51038062283737,626,318,308,0.507987220447284,0.0231860496622733,0.277303605643616,0.699510344694111
12,"Brandenburg",12073189,"Gartz (Oder), Stadt",2461,1203,1258,0.488825680617635,2472,1212,1260,0.490291262135922,0.0231860496622733,0.277303605643616,0.699510344694111
12,"Brandenburg",12073201,"Gerswalde",1656,872,784,0.526570048309179,1638,853,785,0.520757020757021,0.0231860496622733,0.277303605643616,0.699510344694111
12,"Brandenburg",12073216,"Göritz",796,385,411,0.483668341708543,786,387,399,0.49236641221374,0.0231860496622733,0.277303605643616,0.699510344694111
12,"Brandenburg",12073225,"Gramzow",1972,1002,970,0.508113590263692,1952,1006,946,0.515368852459016,0.0231860496622733,0.277303605643616,0.699510344694111
12,"Brandenburg",12073261,"Grünow",929,466,463,0.501614639397201,890,447,443,0.502247191011236,0.0231860496622733,0.277303605643616,0.699510344694111
12,"Brandenburg",12073309,"Hohenselchow-Groß Pinnow",818,428,390,0.523227383863081,831,440,391,0.529482551143201,0.0231860496622733,0.277303605643616,0.699510344694111
12,"Brandenburg",12073384,"Lychen, Stadt",3257,1577,1680,0.484187902978201,3523,1727,1796,0.490207209764405,0.0231860496622733,0.277303605643616,0.699510344694111
12,"Brandenburg",12073386,"Mark Landin",1043,539,504,0.516778523489933,1054,540,514,0.512333965844402,0.0231860496622733,0.277303605643616,0.699510344694111
12,"Brandenburg",12073393,"Mescherin",760,394,366,0.518421052631579,781,404,377,0.517285531370038,0.0231860496622733,0.277303605643616,0.699510344694111
12,"Brandenburg",12073396,"Milmersdorf",1531,807,724,0.527106466361855,1629,854,775,0.524248004910988,0.0231860496622733,0.277303605643616,0.699510344694111
12,"Brandenburg",12073404,"Mittenwalde",408,211,197,0.517156862745098,369,182,187,0.493224932249323,0.0231860496622733,0.277303605643616,0.699510344694111
12,"Brandenburg",12073429,"Nordwestuckermark",4558,2297,2261,0.503949100482668,4668,2392,2276,0.512425021422451,0.0231860496622733,0.277303605643616,0.699510344694111
12,"Brandenburg",12073430,"Oberuckersee",1716,877,839,0.511072261072261,1719,883,836,0.513670738801629,0.0231860496622733,0.277303605643616,0.699510344694111
12,"Brandenburg",12073440,"Pinnow",912,461,451,0.505482456140351,912,459,453,0.503289473684211,0.0231860496622733,0.277303605643616,0.699510344694111
12,"Brandenburg",12073452,"Prenzlau, Stadt",19139,9214,9925,0.481425361826637,19891,9774,10117,0.491378010155347,0.0231860496622733,0.277303605643616,0.699510344694111
12,"Brandenburg",12073458,"Randowtal",1004,517,487,0.514940239043825,1029,534,495,0.518950437317784,0.0231860496622733,0.277303605643616,0.699510344694111
12,"Brandenburg",12073490,"Schenkenberg",603,307,296,0.509121061359867,576,298,278,0.517361111111111,0.0231860496622733,0.277303605643616,0.699510344694111
12,"Brandenburg",12073505,"Schöneberg",853,441,412,0.516998827667057,835,426,409,0.510179640718563,0.0231860496622733,0.277303605643616,0.699510344694111
12,"Brandenburg",12073520,"Schönfeld",614,309,305,0.503257328990228,642,328,314,0.510903426791277,0.0231860496622733,0.277303605643616,0.699510344694111
12,"Brandenburg",12073532,"Schwedt/Oder, Stadt",31515,15142,16373,0.480469617642392,33578,16558,17020,0.493120495562571,0.0231860496622733,0.277303605643616,0.699510344694111
12,"Brandenburg",12073565,"Tantow",753,373,380,0.49535192563081,780,392,388,0.502564102564103,0.0231860496622733,0.277303605643616,0.699510344694111
12,"Brandenburg",12073569,"Temmen-Ringenwalde",577,304,273,0.52686308492201,605,322,283,0.532231404958678,0.0231860496622733,0.277303605643616,0.699510344694111
12,"Brandenburg",12073572,"Templin, Stadt",16109,7894,8215,0.490036625488857,16269,7994,8275,0.491363943696601,0.0231860496622733,0.277303605643616,0.699510344694111
12,"Brandenburg",12073578,"Uckerfelde",1008,528,480,0.523809523809524,1049,541,508,0.515729265967588,0.0231860496622733,0.277303605643616,0.699510344694111
12,"Brandenburg",12073579,"Uckerland",2892,1484,1408,0.51313969571231,2929,1499,1430,0.511778764083305,0.0231860496622733,0.277303605643616,0.699510344694111
12,"Brandenburg",12073603,"Passow",1537,790,747,0.513988288874431,1557,823,734,0.528580603725112,0.0231860496622733,0.277303605643616,0.699510344694111
12,"Brandenburg",12073645,"Zichow",628,315,313,0.501592356687898,621,301,320,0.484702093397746,0.0231860496622733,0.277303605643616,0.699510344694111
13,"Mecklenburg-Vorpommern",13003000,"Rostock, Hansestadt",201813,99255,102558,0.491816681779667,204260,100478,103782,0.491912268677176,0.0393488343893049,0.203080001212599,0.757571164398096
13,"Mecklenburg-Vorpommern",13004000,"Schwerin, Landeshauptstadt",91327,43221,48106,0.473255444720619,95300,45813,49487,0.480724029380902,0.0393488343893049,0.203080001212599,0.757571164398096
13,"Mecklenburg-Vorpommern",13071001,"Alt Schwerin",555,274,281,0.493693693693694,560,276,284,0.492857142857143,0.0393488343893049,0.203080001212599,0.757571164398096
13,"Mecklenburg-Vorpommern",13071002,"Altenhagen",332,165,167,0.496987951807229,329,164,165,0.498480243161094,0.0393488343893049,0.203080001212599,0.757571164398096
13,"Mecklenburg-Vorpommern",13071003,"Altenhof",367,185,182,0.50408719346049,376,190,186,0.50531914893617,0.0393488343893049,0.203080001212599,0.757571164398096
13,"Mecklenburg-Vorpommern",13071004,"Altentreptow, Stadt",5606,2709,2897,0.483232251159472,5690,2765,2925,0.485940246045694,0.0393488343893049,0.203080001212599,0.757571164398096
13,"Mecklenburg-Vorpommern",13071005,"Ankershagen",599,313,286,0.522537562604341,609,306,303,0.502463054187192,0.0393488343893049,0.203080001212599,0.757571164398096
13,"Mecklenburg-Vorpommern",13071006,"Bartow",505,261,244,0.516831683168317,516,271,245,0.525193798449612,0.0393488343893049,0.203080001212599,0.757571164398096
13,"Mecklenburg-Vorpommern",13071007,"Basedow",737,374,363,0.507462686567164,744,382,362,0.513440860215054,0.0393488343893049,0.203080001212599,0.757571164398096
13,"Mecklenburg-Vorpommern",13071008,"Beggerow",561,282,279,0.502673796791444,599,298,301,0.497495826377296,0.0393488343893049,0.203080001212599,0.757571164398096
13,"Mecklenburg-Vorpommern",13071009,"Beseritz",118,55,63,0.466101694915254,133,63,70,0.473684210526316,0.0393488343893049,0.203080001212599,0.757571164398096
13,"Mecklenburg-Vorpommern",13071010,"Blankenhof",686,344,342,0.501457725947522,682,342,340,0.501466275659824,0.0393488343893049,0.203080001212599,0.757571164398096
13,"Mecklenburg-Vorpommern",13071011,"Blankensee",1692,868,824,0.513002364066194,1738,882,856,0.507479861910242,0.0393488343893049,0.203080001212599,0.757571164398096
13,"Mecklenburg-Vorpommern",13071012,"Blumenholz",793,399,394,0.503152585119798,813,413,400,0.5079950799508,0.0393488343893049,0.203080001212599,0.757571164398096
13,"Mecklenburg-Vorpommern",13071013,"Bollewick",646,338,308,0.523219814241486,665,342,323,0.514285714285714,0.0393488343893049,0.203080001212599,0.757571164398096
13,"Mecklenburg-Vorpommern",13071014,"Borrentin",865,424,441,0.490173410404624,894,439,455,0.491051454138702,0.0393488343893049,0.203080001212599,0.757571164398096
13,"Mecklenburg-Vorpommern",13071015,"Bredenfelde",197,105,92,0.532994923857868,196,105,91,0.535714285714286,0.0393488343893049,0.203080001212599,0.757571164398096
13,"Mecklenburg-Vorpommern",13071016,"Breesen",551,274,277,0.497277676950998,551,272,279,0.493647912885662,0.0393488343893049,0.203080001212599,0.757571164398096
13,"Mecklenburg-Vorpommern",13071017,"Breest",163,86,77,0.52760736196319,167,91,76,0.544910179640719,0.0393488343893049,0.203080001212599,0.757571164398096
13,"Mecklenburg-Vorpommern",13071018,"Briggow",331,178,153,0.537764350453172,339,178,161,0.525073746312684,0.0393488343893049,0.203080001212599,0.757571164398096
13,"Mecklenburg-Vorpommern",13071019,"Brunn",1071,533,538,0.497665732959851,1090,545,545,0.5,0.0393488343893049,0.203080001212599,0.757571164398096
13,"Mecklenburg-Vorpommern",13071020,"Buchholz",147,75,72,0.510204081632653,137,69,68,0.503649635036496,0.0393488343893049,0.203080001212599,0.757571164398096
13,"Mecklenburg-Vorpommern",13071021,"Burg Stargard, Stadt",4974,2447,2527,0.491958182549256,5000,2468,2532,0.4936,0.0393488343893049,0.203080001212599,0.757571164398096
13,"Mecklenburg-Vorpommern",13071022,"Burow",1045,541,504,0.517703349282297,1068,552,516,0.51685393258427,0.0393488343893049,0.203080001212599,0.757571164398096
13,"Mecklenburg-Vorpommern",13071023,"Bütow",485,251,234,0.517525773195876,485,255,230,0.525773195876289,0.0393488343893049,0.203080001212599,0.757571164398096
13,"Mecklenburg-Vorpommern",13071024,"Cammin",312,164,148,0.525641025641026,307,160,147,0.521172638436482,0.0393488343893049,0.203080001212599,0.757571164398096
13,"Mecklenburg-Vorpommern",13071025,"Carpin",887,462,425,0.520856820744081,898,468,430,0.521158129175947,0.0393488343893049,0.203080001212599,0.757571164398096
13,"Mecklenburg-Vorpommern",13071026,"Cölpin",766,379,387,0.494778067885117,787,383,404,0.486658195679797,0.0393488343893049,0.203080001212599,0.757571164398096
13,"Mecklenburg-Vorpommern",13071027,"Dargun, Stadt",4511,2242,2269,0.497007315451119,4580,2274,2306,0.496506550218341,0.0393488343893049,0.203080001212599,0.757571164398096
13,"Mecklenburg-Vorpommern",13071028,"Datzetal",891,439,452,0.492704826038159,893,440,453,0.492721164613662,0.0393488343893049,0.203080001212599,0.757571164398096
13,"Mecklenburg-Vorpommern",13071029,"Demmin, Hansestadt",11645,5548,6097,0.476427651352512,11756,5561,6195,0.473035045933991,0.0393488343893049,0.203080001212599,0.757571164398096
13,"Mecklenburg-Vorpommern",13071030,"Duckow",257,133,124,0.517509727626459,258,133,125,0.515503875968992,0.0393488343893049,0.203080001212599,0.757571164398096
13,"Mecklenburg-Vorpommern",13071031,"Eichhorst",484,262,222,0.541322314049587,493,267,226,0.54158215010142,0.0393488343893049,0.203080001212599,0.757571164398096
13,"Mecklenburg-Vorpommern",13071032,"Faulenrost",676,338,338,0.5,682,344,338,0.504398826979472,0.0393488343893049,0.203080001212599,0.757571164398096
13,"Mecklenburg-Vorpommern",13071033,"Feldberger Seenlandschaft",4519,2205,2314,0.48793980969241,4613,2282,2331,0.494688922610015,0.0393488343893049,0.203080001212599,0.757571164398096
13,"Mecklenburg-Vorpommern",13071034,"Fincken",546,279,267,0.510989010989011,560,283,277,0.505357142857143,0.0393488343893049,0.203080001212599,0.757571164398096
13,"Mecklenburg-Vorpommern",13071035,"Friedland, Stadt",6333,3064,3269,0.483814937628296,6428,3220,3208,0.500933416303671,0.0393488343893049,0.203080001212599,0.757571164398096
13,"Mecklenburg-Vorpommern",13071036,"Fünfseen",1115,575,540,0.515695067264574,1128,573,555,0.507978723404255,0.0393488343893049,0.203080001212599,0.757571164398096
13,"Mecklenburg-Vorpommern",13071037,"Galenbeck",1186,593,593,0.5,1217,617,600,0.506984387838948,0.0393488343893049,0.203080001212599,0.757571164398096
13,"Mecklenburg-Vorpommern",13071038,"Genzkow",140,76,64,0.542857142857143,144,78,66,0.541666666666667,0.0393488343893049,0.203080001212599,0.757571164398096
13,"Mecklenburg-Vorpommern",13071039,"Gielow",1177,613,564,0.520815632965166,1344,738,606,0.549107142857143,0.0393488343893049,0.203080001212599,0.757571164398096
13,"Mecklenburg-Vorpommern",13071040,"Glienke",157,80,77,0.509554140127389,158,83,75,0.525316455696203,0.0393488343893049,0.203080001212599,0.757571164398096
13,"Mecklenburg-Vorpommern",13071041,"Gnevkow",379,192,187,0.506596306068602,367,181,186,0.493188010899183,0.0393488343893049,0.203080001212599,0.757571164398096
13,"Mecklenburg-Vorpommern",13071042,"Godendorf",239,121,118,0.506276150627615,248,132,116,0.532258064516129,0.0393488343893049,0.203080001212599,0.757571164398096
13,"Mecklenburg-Vorpommern",13071043,"Göhren-Lebbin",579,307,272,0.530224525043178,598,321,277,0.536789297658863,0.0393488343893049,0.203080001212599,0.757571164398096
13,"Mecklenburg-Vorpommern",13071044,"Golchen",299,158,141,0.528428093645485,313,165,148,0.527156549520767,0.0393488343893049,0.203080001212599,0.757571164398096
13,"Mecklenburg-Vorpommern",13071045,"Gotthun",316,155,161,0.490506329113924,304,141,163,0.463815789473684,0.0393488343893049,0.203080001212599,0.757571164398096
13,"Mecklenburg-Vorpommern",13071046,"Grabow-Below",112,60,52,0.535714285714286,116,62,54,0.53448275862069,0.0393488343893049,0.203080001212599,0.757571164398096
13,"Mecklenburg-Vorpommern",13071047,"Grabowhöfe",948,473,475,0.498945147679325,998,499,499,0.5,0.0393488343893049,0.203080001212599,0.757571164398096
13,"Mecklenburg-Vorpommern",13071048,"Grammentin",228,115,113,0.504385964912281,232,117,115,0.504310344827586,0.0393488343893049,0.203080001212599,0.757571164398096
13,"Mecklenburg-Vorpommern",13071049,"Grapzow",409,209,200,0.511002444987775,412,210,202,0.509708737864078,0.0393488343893049,0.203080001212599,0.757571164398096
13,"Mecklenburg-Vorpommern",13071050,"Grischow",261,135,126,0.517241379310345,273,145,128,0.531135531135531,0.0393488343893049,0.203080001212599,0.757571164398096
13,"Mecklenburg-Vorpommern",13071051,"Groß Dratow",369,189,180,0.51219512195122,356,177,179,0.497191011235955,0.0393488343893049,0.203080001212599,0.757571164398096
13,"Mecklenburg-Vorpommern",13071052,"Groß Gievitz",460,247,213,0.53695652173913,458,245,213,0.534934497816594,0.0393488343893049,0.203080001212599,0.757571164398096
13,"Mecklenburg-Vorpommern",13071053,"Groß Kelle",125,58,67,0.464,136,62,74,0.455882352941176,0.0393488343893049,0.203080001212599,0.757571164398096
13,"Mecklenburg-Vorpommern",13071054,"Groß Miltzow",1124,564,560,0.501779359430605,1137,574,563,0.504837291116975,0.0393488343893049,0.203080001212599,0.757571164398096
13,"Mecklenburg-Vorpommern",13071055,"Groß Nemerow",1168,605,563,0.517979452054795,1186,608,578,0.512647554806071,0.0393488343893049,0.203080001212599,0.757571164398096
13,"Mecklenburg-Vorpommern",13071056,"Groß Plasten",705,348,357,0.493617021276596,714,350,364,0.490196078431373,0.0393488343893049,0.203080001212599,0.757571164398096
13,"Mecklenburg-Vorpommern",13071057,"Groß Teetzleben",683,347,336,0.50805270863836,697,353,344,0.506456241032999,0.0393488343893049,0.203080001212599,0.757571164398096
13,"Mecklenburg-Vorpommern",13071058,"Grünow",306,157,149,0.513071895424837,310,157,153,0.506451612903226,0.0393488343893049,0.203080001212599,0.757571164398096
13,"Mecklenburg-Vorpommern",13071059,"Gültz",567,296,271,0.522045855379189,529,280,249,0.52930056710775,0.0393488343893049,0.203080001212599,0.757571164398096
13,"Mecklenburg-Vorpommern",13071060,"Gülzow",451,231,220,0.51219512195122,472,237,235,0.502118644067797,0.0393488343893049,0.203080001212599,0.757571164398096
13,"Mecklenburg-Vorpommern",13071061,"Helpt",355,186,169,0.523943661971831,348,184,164,0.528735632183908,0.0393488343893049,0.203080001212599,0.757571164398096
13,"Mecklenburg-Vorpommern",13071062,"Hinrichshagen",159,83,76,0.522012578616352,153,81,72,0.529411764705882,0.0393488343893049,0.203080001212599,0.757571164398096
13,"Mecklenburg-Vorpommern",13071063,"Hohen Wangelin",608,314,294,0.516447368421053,624,338,286,0.541666666666667,0.0393488343893049,0.203080001212599,0.757571164398096
13,"Mecklenburg-Vorpommern",13071064,"Hohenbollentin",125,59,66,0.472,129,61,68,0.472868217054264,0.0393488343893049,0.203080001212599,0.757571164398096
13,"Mecklenburg-Vorpommern",13071065,"Hohenmocker",517,268,249,0.518375241779497,529,273,256,0.516068052930057,0.0393488343893049,0.203080001212599,0.757571164398096
13,"Mecklenburg-Vorpommern",13071066,"Hohenzieritz",492,253,239,0.514227642276423,496,253,243,0.51008064516129,0.0393488343893049,0.203080001212599,0.757571164398096
13,"Mecklenburg-Vorpommern",13071067,"Holldorf",787,393,394,0.499364675984752,793,397,396,0.50063051702396,0.0393488343893049,0.203080001212599,0.757571164398096
13,"Mecklenburg-Vorpommern",13071068,"Ivenack",884,458,426,0.518099547511312,890,463,427,0.520224719101124,0.0393488343893049,0.203080001212599,0.757571164398096
13,"Mecklenburg-Vorpommern",13071069,"Jabel",541,280,261,0.517560073937153,562,284,278,0.505338078291815,0.0393488343893049,0.203080001212599,0.757571164398096
13,"Mecklenburg-Vorpommern",13071070,"Jürgenstorf",1084,586,498,0.540590405904059,1098,601,497,0.54735883424408,0.0393488343893049,0.203080001212599,0.757571164398096
13,"Mecklenburg-Vorpommern",13071071,"Kargow",661,342,319,0.517397881996974,723,377,346,0.521438450899032,0.0393488343893049,0.203080001212599,0.757571164398096
13,"Mecklenburg-Vorpommern",13071072,"Kentzlin",203,93,110,0.458128078817734,213,95,118,0.446009389671362,0.0393488343893049,0.203080001212599,0.757571164398096
13,"Mecklenburg-Vorpommern",13071073,"Kieve",149,71,78,0.476510067114094,145,70,75,0.482758620689655,0.0393488343893049,0.203080001212599,0.757571164398096
13,"Mecklenburg-Vorpommern",13071074,"Kittendorf",339,162,177,0.47787610619469,366,176,190,0.480874316939891,0.0393488343893049,0.203080001212599,0.757571164398096
13,"Mecklenburg-Vorpommern",13071075,"Klein Vielen",692,357,335,0.515895953757225,719,378,341,0.525730180806676,0.0393488343893049,0.203080001212599,0.757571164398096
13,"Mecklenburg-Vorpommern",13071076,"Kletzin",750,391,359,0.521333333333333,767,401,366,0.522816166883963,0.0393488343893049,0.203080001212599,0.757571164398096
13,"Mecklenburg-Vorpommern",13071077,"Klink",1050,511,539,0.486666666666667,1104,541,563,0.490036231884058,0.0393488343893049,0.203080001212599,0.757571164398096
13,"Mecklenburg-Vorpommern",13071078,"Klocksin",337,169,168,0.501483679525223,383,194,189,0.506527415143603,0.0393488343893049,0.203080001212599,0.757571164398096
13,"Mecklenburg-Vorpommern",13071079,"Knorrendorf",667,347,320,0.52023988005997,655,341,314,0.520610687022901,0.0393488343893049,0.203080001212599,0.757571164398096
13,"Mecklenburg-Vorpommern",13071080,"Kratzeburg",549,285,264,0.519125683060109,560,289,271,0.516071428571429,0.0393488343893049,0.203080001212599,0.757571164398096
13,"Mecklenburg-Vorpommern",13071081,"Kriesow",320,179,141,0.559375,324,181,143,0.558641975308642,0.0393488343893049,0.203080001212599,0.757571164398096
13,"Mecklenburg-Vorpommern",13071082,"Krukow",194,100,94,0.515463917525773,190,101,89,0.531578947368421,0.0393488343893049,0.203080001212599,0.757571164398096
13,"Mecklenburg-Vorpommern",13071083,"Kublank",172,89,83,0.517441860465116,164,58,106,0.353658536585366,0.0393488343893049,0.203080001212599,0.757571164398096
13,"Mecklenburg-Vorpommern",13071084,"Kummerow",611,310,301,0.507364975450082,622,323,299,0.519292604501608,0.0393488343893049,0.203080001212599,0.757571164398096
13,"Mecklenburg-Vorpommern",13071085,"Lansen-Schönau",459,223,236,0.485838779956427,468,220,248,0.47008547008547,0.0393488343893049,0.203080001212599,0.757571164398096
13,"Mecklenburg-Vorpommern",13071086,"Lapitz",168,81,87,0.482142857142857,169,82,87,0.485207100591716,0.0393488343893049,0.203080001212599,0.757571164398096
13,"Mecklenburg-Vorpommern",13071087,"Lärz",539,276,263,0.512059369202226,550,271,279,0.492727272727273,0.0393488343893049,0.203080001212599,0.757571164398096
13,"Mecklenburg-Vorpommern",13071088,"Leizen",467,238,229,0.509635974304068,473,242,231,0.511627906976744,0.0393488343893049,0.203080001212599,0.757571164398096
13,"Mecklenburg-Vorpommern",13071089,"Lindenberg",228,117,111,0.513157894736842,222,113,109,0.509009009009009,0.0393488343893049,0.203080001212599,0.757571164398096
13,"Mecklenburg-Vorpommern",13071090,"Lindetal",1153,589,564,0.510841283607979,1205,602,603,0.499585062240664,0.0393488343893049,0.203080001212599,0.757571164398096
13,"Mecklenburg-Vorpommern",13071091,"Ludorf",487,251,236,0.515400410677618,495,263,232,0.531313131313131,0.0393488343893049,0.203080001212599,0.757571164398096
13,"Mecklenburg-Vorpommern",13071092,"Malchin, Stadt",7719,3807,3912,0.493198600855033,7820,3867,3953,0.494501278772379,0.0393488343893049,0.203080001212599,0.757571164398096
13,"Mecklenburg-Vorpommern",13071093,"Malchow, Stadt",6657,3205,3452,0.48144809974463,6696,3265,3431,0.487604540023895,0.0393488343893049,0.203080001212599,0.757571164398096
13,"Mecklenburg-Vorpommern",13071094,"Mallin",376,192,184,0.51063829787234,376,193,183,0.513297872340426,0.0393488343893049,0.203080001212599,0.757571164398096
13,"Mecklenburg-Vorpommern",13071095,"Massow",202,103,99,0.50990099009901,223,124,99,0.556053811659193,0.0393488343893049,0.203080001212599,0.757571164398096
13,"Mecklenburg-Vorpommern",13071096,"Meesiger",242,114,128,0.471074380165289,251,116,135,0.462151394422311,0.0393488343893049,0.203080001212599,0.757571164398096
13,"Mecklenburg-Vorpommern",13071097,"Melz",356,184,172,0.51685393258427,360,186,174,0.516666666666667,0.0393488343893049,0.203080001212599,0.757571164398096
13,"Mecklenburg-Vorpommern",13071098,"Mildenitz",501,268,233,0.534930139720559,506,277,229,0.547430830039526,0.0393488343893049,0.203080001212599,0.757571164398096
13,"Mecklenburg-Vorpommern",13071099,"Mirow, Stadt",3553,1715,1838,0.482690683929074,3422,1685,1737,0.492402104032729,0.0393488343893049,0.203080001212599,0.757571164398096
13,"Mecklenburg-Vorpommern",13071100,"Möllenbeck",713,363,350,0.509116409537167,721,376,345,0.521497919556172,0.0393488343893049,0.203080001212599,0.757571164398096
13,"Mecklenburg-Vorpommern",13071101,"Möllenhagen",1609,831,778,0.516469857054071,1614,846,768,0.524163568773234,0.0393488343893049,0.203080001212599,0.757571164398096
13,"Mecklenburg-Vorpommern",13071102,"Mölln",533,277,256,0.519699812382739,522,268,254,0.513409961685824,0.0393488343893049,0.203080001212599,0.757571164398096
13,"Mecklenburg-Vorpommern",13071103,"Moltzow",359,176,183,0.49025069637883,326,160,166,0.49079754601227,0.0393488343893049,0.203080001212599,0.757571164398096
13,"Mecklenburg-Vorpommern",13071104,"Neddemin",332,155,177,0.466867469879518,331,162,169,0.489425981873112,0.0393488343893049,0.203080001212599,0.757571164398096
13,"Mecklenburg-Vorpommern",13071105,"Neetzka",247,133,114,0.538461538461538,259,137,122,0.528957528957529,0.0393488343893049,0.203080001212599,0.757571164398096
13,"Mecklenburg-Vorpommern",13071106,"Neu Gaarz",96,49,47,0.510416666666667,113,56,57,0.495575221238938,0.0393488343893049,0.203080001212599,0.757571164398096
13,"Mecklenburg-Vorpommern",13071107,"Neubrandenburg, Stadt",64027,30769,33258,0.480562887531823,64995,31515,33480,0.484883452573275,0.0393488343893049,0.203080001212599,0.757571164398096
13,"Mecklenburg-Vorpommern",13071108,"Neuenkirchen",1150,572,578,0.497391304347826,1160,586,574,0.505172413793103,0.0393488343893049,0.203080001212599,0.757571164398096
13,"Mecklenburg-Vorpommern",13071109,"Neukalen, Stadt",1855,933,922,0.502964959568733,1974,1017,957,0.515197568389058,0.0393488343893049,0.203080001212599,0.757571164398096
13,"Mecklenburg-Vorpommern",13071110,"Neustrelitz, Stadt",20328,9724,10604,0.478354978354978,21126,10200,10926,0.482817381425731,0.0393488343893049,0.203080001212599,0.757571164398096
13,"Mecklenburg-Vorpommern",13071111,"Neverin",1047,524,523,0.500477554918816,1056,520,536,0.492424242424242,0.0393488343893049,0.203080001212599,0.757571164398096
13,"Mecklenburg-Vorpommern",13071112,"Nossendorf",727,378,349,0.519944979367263,751,392,359,0.521970705725699,0.0393488343893049,0.203080001212599,0.757571164398096
13,"Mecklenburg-Vorpommern",13071113,"Nossentiner Hütte",676,335,341,0.495562130177515,679,343,336,0.505154639175258,0.0393488343893049,0.203080001212599,0.757571164398096
13,"Mecklenburg-Vorpommern",13071114,"Penkow",297,156,141,0.525252525252525,299,155,144,0.518394648829431,0.0393488343893049,0.203080001212599,0.757571164398096
13,"Mecklenburg-Vorpommern",13071115,"Penzlin, Stadt",3952,1969,1983,0.498228744939271,3986,2012,1974,0.504766683391872,0.0393488343893049,0.203080001212599,0.757571164398096
13,"Mecklenburg-Vorpommern",13071116,"Petersdorf",165,91,74,0.551515151515152,169,88,81,0.520710059171598,0.0393488343893049,0.203080001212599,0.757571164398096
13,"Mecklenburg-Vorpommern",13071117,"Pragsdorf",512,265,247,0.517578125,503,259,244,0.514910536779324,0.0393488343893049,0.203080001212599,0.757571164398096
13,"Mecklenburg-Vorpommern",13071118,"Priborn",358,187,171,0.522346368715084,376,195,181,0.518617021276596,0.0393488343893049,0.203080001212599,0.757571164398096
13,"Mecklenburg-Vorpommern",13071119,"Priepert",320,175,145,0.546875,320,171,149,0.534375,0.0393488343893049,0.203080001212599,0.757571164398096
13,"Mecklenburg-Vorpommern",13071120,"Pripsleben",267,141,126,0.528089887640449,267,133,134,0.49812734082397,0.0393488343893049,0.203080001212599,0.757571164398096
13,"Mecklenburg-Vorpommern",13071121,"Puchow",146,75,71,0.513698630136986,141,73,68,0.517730496453901,0.0393488343893049,0.203080001212599,0.757571164398096
13,"Mecklenburg-Vorpommern",13071122,"Rechlin",2124,1038,1086,0.488700564971751,2141,1051,1090,0.490892106492293,0.0393488343893049,0.203080001212599,0.757571164398096
13,"Mecklenburg-Vorpommern",13071123,"Ritzerow",428,225,203,0.525700934579439,429,225,204,0.524475524475524,0.0393488343893049,0.203080001212599,0.757571164398096
13,"Mecklenburg-Vorpommern",13071124,"Röbel/Müritz, Stadt",5188,2468,2720,0.475713184271396,5224,2508,2716,0.480091883614089,0.0393488343893049,0.203080001212599,0.757571164398096
13,"Mecklenburg-Vorpommern",13071125,"Röckwitz",289,157,132,0.543252595155709,294,160,134,0.54421768707483,0.0393488343893049,0.203080001212599,0.757571164398096
13,"Mecklenburg-Vorpommern",13071126,"Roggentin",637,330,307,0.518053375196232,661,333,328,0.503782148260212,0.0393488343893049,0.203080001212599,0.757571164398096
13,"Mecklenburg-Vorpommern",13071127,"Rosenow",980,481,499,0.490816326530612,1007,499,508,0.495531281032771,0.0393488343893049,0.203080001212599,0.757571164398096
13,"Mecklenburg-Vorpommern",13071128,"Sarow",725,366,359,0.504827586206897,742,379,363,0.51078167115903,0.0393488343893049,0.203080001212599,0.757571164398096
13,"Mecklenburg-Vorpommern",13071129,"Schloen",504,243,261,0.482142857142857,489,234,255,0.478527607361963,0.0393488343893049,0.203080001212599,0.757571164398096
13,"Mecklenburg-Vorpommern",13071130,"Schönbeck",432,215,217,0.497685185185185,379,183,196,0.482849604221636,0.0393488343893049,0.203080001212599,0.757571164398096
13,"Mecklenburg-Vorpommern",13071131,"Schönfeld",380,205,175,0.539473684210526,401,214,187,0.533665835411471,0.0393488343893049,0.203080001212599,0.757571164398096
13,"Mecklenburg-Vorpommern",13071132,"Schönhausen",251,129,122,0.51394422310757,259,134,125,0.517374517374517,0.0393488343893049,0.203080001212599,0.757571164398096
13,"Mecklenburg-Vorpommern",13071133,"Schwarz",369,191,178,0.517615176151762,366,192,174,0.524590163934426,0.0393488343893049,0.203080001212599,0.757571164398096
13,"Mecklenburg-Vorpommern",13071134,"Schwinkendorf",520,259,261,0.498076923076923,528,268,260,0.507575757575758,0.0393488343893049,0.203080001212599,0.757571164398096
13,"Mecklenburg-Vorpommern",13071135,"Siedenbollentin",589,302,287,0.512733446519525,579,292,287,0.504317789291883,0.0393488343893049,0.203080001212599,0.757571164398096
13,"Mecklenburg-Vorpommern",13071136,"Siedenbrünzow",574,291,283,0.506968641114983,609,313,296,0.513957307060755,0.0393488343893049,0.203080001212599,0.757571164398096
13,"Mecklenburg-Vorpommern",13071137,"Sietow",631,310,321,0.491283676703645,629,312,317,0.496025437201908,0.0393488343893049,0.203080001212599,0.757571164398096
13,"Mecklenburg-Vorpommern",13071138,"Silz",341,165,176,0.483870967741935,342,164,178,0.47953216374269,0.0393488343893049,0.203080001212599,0.757571164398096
13,"Mecklenburg-Vorpommern",13071139,"Sommersdorf",249,131,118,0.526104417670683,258,138,120,0.534883720930233,0.0393488343893049,0.203080001212599,0.757571164398096
13,"Mecklenburg-Vorpommern",13071140,"Sponholz",741,376,365,0.507422402159244,751,384,367,0.511318242343542,0.0393488343893049,0.203080001212599,0.757571164398096
13,"Mecklenburg-Vorpommern",13071141,"Staven",443,223,220,0.503386004514673,448,225,223,0.502232142857143,0.0393488343893049,0.203080001212599,0.757571164398096
13,"Mecklenburg-Vorpommern",13071142,"Stavenhagen, Reuterstadt, Stadt",5707,2772,2935,0.485719292097424,5822,2816,3006,0.483682583304706,0.0393488343893049,0.203080001212599,0.757571164398096
13,"Mecklenburg-Vorpommern",13071143,"Stuer",263,144,119,0.547528517110266,261,140,121,0.53639846743295,0.0393488343893049,0.203080001212599,0.757571164398096
13,"Mecklenburg-Vorpommern",13071144,"Torgelow am See",445,229,216,0.514606741573034,450,234,216,0.52,0.0393488343893049,0.203080001212599,0.757571164398096
13,"Mecklenburg-Vorpommern",13071145,"Trollenhagen",928,476,452,0.512931034482759,927,473,454,0.51024811218986,0.0393488343893049,0.203080001212599,0.757571164398096
13,"Mecklenburg-Vorpommern",13071146,"Tützpatz",568,291,277,0.512323943661972,553,281,272,0.508137432188065,0.0393488343893049,0.203080001212599,0.757571164398096
13,"Mecklenburg-Vorpommern",13071147,"Userin",666,344,322,0.516516516516517,676,354,322,0.523668639053254,0.0393488343893049,0.203080001212599,0.757571164398096
13,"Mecklenburg-Vorpommern",13071148,"Utzedel",512,262,250,0.51171875,539,272,267,0.504638218923933,0.0393488343893049,0.203080001212599,0.757571164398096
13,"Mecklenburg-Vorpommern",13071149,"Varchentin",306,164,142,0.535947712418301,348,184,164,0.528735632183908,0.0393488343893049,0.203080001212599,0.757571164398096
13,"Mecklenburg-Vorpommern",13071150,"Verchen",420,225,195,0.535714285714286,426,227,199,0.532863849765258,0.0393488343893049,0.203080001212599,0.757571164398096
13,"Mecklenburg-Vorpommern",13071151,"Vielist",461,242,219,0.524945770065076,467,242,225,0.518201284796574,0.0393488343893049,0.203080001212599,0.757571164398096
13,"Mecklenburg-Vorpommern",13071152,"Vipperow",423,205,218,0.484633569739953,443,218,225,0.492099322799097,0.0393488343893049,0.203080001212599,0.757571164398096
13,"Mecklenburg-Vorpommern",13071153,"Voigtsdorf",110,54,56,0.490909090909091,102,51,51,0.5,0.0393488343893049,0.203080001212599,0.757571164398096
13,"Mecklenburg-Vorpommern",13071154,"Vollrathsruhe",445,222,223,0.498876404494382,457,219,238,0.479212253829322,0.0393488343893049,0.203080001212599,0.757571164398096
13,"Mecklenburg-Vorpommern",13071155,"Walow",500,258,242,0.516,510,265,245,0.519607843137255,0.0393488343893049,0.203080001212599,0.757571164398096
13,"Mecklenburg-Vorpommern",13071156,"Waren (Müritz), Stadt",21153,10012,11141,0.473313477993665,21230,10098,11132,0.475647668393782,0.0393488343893049,0.203080001212599,0.757571164398096
13,"Mecklenburg-Vorpommern",13071157,"Warrenzin",428,210,218,0.490654205607477,429,215,214,0.501165501165501,0.0393488343893049,0.203080001212599,0.757571164398096
13,"Mecklenburg-Vorpommern",13071158,"Werder",590,295,295,0.5,575,291,284,0.506086956521739,0.0393488343893049,0.203080001212599,0.757571164398096
13,"Mecklenburg-Vorpommern",13071159,"Wesenberg, Stadt",3074,1527,1547,0.496746909564086,3051,1517,1534,0.49721402818748,0.0393488343893049,0.203080001212599,0.757571164398096
13,"Mecklenburg-Vorpommern",13071160,"Wildberg",582,306,276,0.525773195876289,588,317,271,0.539115646258503,0.0393488343893049,0.203080001212599,0.757571164398096
13,"Mecklenburg-Vorpommern",13071161,"Woggersin",519,245,274,0.472061657032755,555,261,294,0.47027027027027,0.0393488343893049,0.203080001212599,0.757571164398096
13,"Mecklenburg-Vorpommern",13071162,"Wokuhl-Dabelow",605,308,297,0.509090909090909,586,300,286,0.511945392491468,0.0393488343893049,0.203080001212599,0.757571164398096
13,"Mecklenburg-Vorpommern",13071163,"Wolde",619,322,297,0.520193861066236,627,320,307,0.5103668261563,0.0393488343893049,0.203080001212599,0.757571164398096
13,"Mecklenburg-Vorpommern",13071164,"Woldegk, Stadt",3716,1884,1832,0.506996770721206,3709,1899,1810,0.511997843084389,0.0393488343893049,0.203080001212599,0.757571164398096
13,"Mecklenburg-Vorpommern",13071165,"Wredenhagen",491,254,237,0.517311608961303,490,253,237,0.516326530612245,0.0393488343893049,0.203080001212599,0.757571164398096
13,"Mecklenburg-Vorpommern",13071166,"Wulkenzin",1454,759,695,0.522008253094911,1508,789,719,0.523209549071618,0.0393488343893049,0.203080001212599,0.757571164398096
13,"Mecklenburg-Vorpommern",13071167,"Wustrow",720,369,351,0.5125,751,363,388,0.48335552596538,0.0393488343893049,0.203080001212599,0.757571164398096
13,"Mecklenburg-Vorpommern",13071168,"Zepkow",213,109,104,0.511737089201878,218,113,105,0.518348623853211,0.0393488343893049,0.203080001212599,0.757571164398096
13,"Mecklenburg-Vorpommern",13071169,"Zettemin",317,159,158,0.501577287066246,329,170,159,0.516717325227964,0.0393488343893049,0.203080001212599,0.757571164398096
13,"Mecklenburg-Vorpommern",13071170,"Zirzow",334,172,162,0.514970059880239,340,174,166,0.511764705882353,0.0393488343893049,0.203080001212599,0.757571164398096
13,"Mecklenburg-Vorpommern",13071171,"Zislow",204,100,104,0.490196078431373,218,110,108,0.504587155963303,0.0393488343893049,0.203080001212599,0.757571164398096
13,"Mecklenburg-Vorpommern",13072001,"Admannshagen-Bargeshagen",2807,1405,1402,0.500534378339865,2833,1406,1427,0.496293681609601,0.0393488343893049,0.203080001212599,0.757571164398096
13,"Mecklenburg-Vorpommern",13072002,"Alt Bukow",496,254,242,0.512096774193548,544,277,267,0.509191176470588,0.0393488343893049,0.203080001212599,0.757571164398096
13,"Mecklenburg-Vorpommern",13072003,"Alt Sührkow",406,219,187,0.539408866995074,418,223,195,0.533492822966507,0.0393488343893049,0.203080001212599,0.757571164398096
13,"Mecklenburg-Vorpommern",13072004,"Altkalen",819,436,383,0.532356532356532,837,447,390,0.53405017921147,0.0393488343893049,0.203080001212599,0.757571164398096
13,"Mecklenburg-Vorpommern",13072005,"Am Salzhaff",510,268,242,0.525490196078431,523,279,244,0.533460803059273,0.0393488343893049,0.203080001212599,0.757571164398096
13,"Mecklenburg-Vorpommern",13072006,"Bad Doberan, Stadt",11552,5532,6020,0.47887811634349,11310,5437,5873,0.480725022104332,0.0393488343893049,0.203080001212599,0.757571164398096
13,"Mecklenburg-Vorpommern",13072007,"Bartenshagen-Parkentin",1216,603,613,0.495888157894737,1265,623,642,0.492490118577075,0.0393488343893049,0.203080001212599,0.757571164398096
13,"Mecklenburg-Vorpommern",13072008,"Bastorf",1010,507,503,0.501980198019802,1082,540,542,0.499075785582255,0.0393488343893049,0.203080001212599,0.757571164398096
13,"Mecklenburg-Vorpommern",13072009,"Baumgarten",857,445,412,0.519253208868145,886,450,436,0.507900677200903,0.0393488343893049,0.203080001212599,0.757571164398096
13,"Mecklenburg-Vorpommern",13072010,"Behren-Lübchin",959,491,468,0.511991657977059,996,518,478,0.520080321285141,0.0393488343893049,0.203080001212599,0.757571164398096
13,"Mecklenburg-Vorpommern",13072011,"Benitz",365,191,174,0.523287671232877,354,187,167,0.528248587570621,0.0393488343893049,0.203080001212599,0.757571164398096
13,"Mecklenburg-Vorpommern",13072012,"Bentwisch",2422,1241,1181,0.512386457473163,2542,1324,1218,0.520849724626279,0.0393488343893049,0.203080001212599,0.757571164398096
13,"Mecklenburg-Vorpommern",13072013,"Bernitt",1655,854,801,0.516012084592145,1716,879,837,0.512237762237762,0.0393488343893049,0.203080001212599,0.757571164398096
13,"Mecklenburg-Vorpommern",13072014,"Biendorf",1188,588,600,0.494949494949495,1268,642,626,0.506309148264984,0.0393488343893049,0.203080001212599,0.757571164398096
13,"Mecklenburg-Vorpommern",13072015,"Blankenhagen",788,402,386,0.510152284263959,800,411,389,0.51375,0.0393488343893049,0.203080001212599,0.757571164398096
13,"Mecklenburg-Vorpommern",13072016,"Boddin",313,160,153,0.511182108626198,338,164,174,0.485207100591716,0.0393488343893049,0.203080001212599,0.757571164398096
13,"Mecklenburg-Vorpommern",13072017,"Börgerende-Rethwisch",1663,829,834,0.498496692723993,1717,869,848,0.506115317414094,0.0393488343893049,0.203080001212599,0.757571164398096
13,"Mecklenburg-Vorpommern",13072018,"Bröbberow",494,260,234,0.526315789473684,503,261,242,0.518886679920477,0.0393488343893049,0.203080001212599,0.757571164398096
13,"Mecklenburg-Vorpommern",13072019,"Broderstorf",3109,1573,1536,0.505950466387906,3119,1583,1536,0.507534466175056,0.0393488343893049,0.203080001212599,0.757571164398096
13,"Mecklenburg-Vorpommern",13072020,"Bützow, Stadt",7702,3847,3855,0.499480654375487,7619,3747,3872,0.491796823730148,0.0393488343893049,0.203080001212599,0.757571164398096
13,"Mecklenburg-Vorpommern",13072021,"Cammin",789,423,366,0.536121673003802,807,425,382,0.526641883519207,0.0393488343893049,0.203080001212599,0.757571164398096
13,"Mecklenburg-Vorpommern",13072022,"Carinerland",984,529,455,0.53760162601626,1138,630,508,0.553602811950791,0.0393488343893049,0.203080001212599,0.757571164398096
13,"Mecklenburg-Vorpommern",13072023,"Dahmen",496,256,240,0.516129032258065,522,277,245,0.530651340996169,0.0393488343893049,0.203080001212599,0.757571164398096
13,"Mecklenburg-Vorpommern",13072024,"Dalkendorf",273,150,123,0.549450549450549,285,154,131,0.540350877192982,0.0393488343893049,0.203080001212599,0.757571164398096
13,"Mecklenburg-Vorpommern",13072025,"Diekhof",942,462,480,0.490445859872611,940,468,472,0.497872340425532,0.0393488343893049,0.203080001212599,0.757571164398096
13,"Mecklenburg-Vorpommern",13072026,"Dobbin-Linstow",505,266,239,0.526732673267327,529,282,247,0.533081285444234,0.0393488343893049,0.203080001212599,0.757571164398096
13,"Mecklenburg-Vorpommern",13072027,"Dolgen am See",633,332,301,0.524486571879937,674,361,313,0.535608308605341,0.0393488343893049,0.203080001212599,0.757571164398096
13,"Mecklenburg-Vorpommern",13072028,"Dreetz",224,119,105,0.53125,239,124,115,0.518828451882845,0.0393488343893049,0.203080001212599,0.757571164398096
13,"Mecklenburg-Vorpommern",13072029,"Dummerstorf",7069,3754,3315,0.53105106804357,7183,3809,3374,0.53027982737018,0.0393488343893049,0.203080001212599,0.757571164398096
13,"Mecklenburg-Vorpommern",13072030,"Elmenhorst/Lichtenhagen",3966,1990,1976,0.501765002521432,4161,2109,2052,0.506849315068493,0.0393488343893049,0.203080001212599,0.757571164398096
13,"Mecklenburg-Vorpommern",13072031,"Finkenthal",281,146,135,0.519572953736655,305,157,148,0.514754098360656,0.0393488343893049,0.203080001212599,0.757571164398096
13,"Mecklenburg-Vorpommern",13072032,"Gelbensande",1562,830,732,0.531370038412292,1646,869,777,0.527946537059538,0.0393488343893049,0.203080001212599,0.757571164398096
13,"Mecklenburg-Vorpommern",13072033,"Glasewitz",451,244,207,0.541019955654102,431,238,193,0.552204176334107,0.0393488343893049,0.203080001212599,0.757571164398096
13,"Mecklenburg-Vorpommern",13072034,"Gnewitz",209,106,103,0.507177033492823,212,109,103,0.514150943396226,0.0393488343893049,0.203080001212599,0.757571164398096
13,"Mecklenburg-Vorpommern",13072035,"Gnoien, Stadt",3099,1517,1582,0.489512746047112,2977,1453,1524,0.488075243533759,0.0393488343893049,0.203080001212599,0.757571164398096
13,"Mecklenburg-Vorpommern",13072036,"Graal-Müritz",4217,1909,2308,0.452691486838985,4282,1962,2320,0.458197104156936,0.0393488343893049,0.203080001212599,0.757571164398096
13,"Mecklenburg-Vorpommern",13072037,"Grammow",174,93,81,0.53448275862069,182,96,86,0.527472527472527,0.0393488343893049,0.203080001212599,0.757571164398096
13,"Mecklenburg-Vorpommern",13072038,"Groß Roge",643,333,310,0.517884914463453,661,343,318,0.518910741301059,0.0393488343893049,0.203080001212599,0.757571164398096
13,"Mecklenburg-Vorpommern",13072039,"Groß Schwiesow",337,178,159,0.528189910979229,298,162,136,0.543624161073825,0.0393488343893049,0.203080001212599,0.757571164398096
13,"Mecklenburg-Vorpommern",13072040,"Groß Wokern",1047,546,501,0.521489971346705,1087,562,525,0.517019319227231,0.0393488343893049,0.203080001212599,0.757571164398096
13,"Mecklenburg-Vorpommern",13072041,"Groß Wüstenfelde",877,449,428,0.511972633979475,915,468,447,0.511475409836066,0.0393488343893049,0.203080001212599,0.757571164398096
13,"Mecklenburg-Vorpommern",13072042,"Gülzow-Prüzen",1606,843,763,0.524906600249066,1619,865,754,0.534280420012353,0.0393488343893049,0.203080001212599,0.757571164398096
13,"Mecklenburg-Vorpommern",13072043,"Güstrow, Stadt",28704,13723,14981,0.478086677814939,29762,14304,15458,0.480612862038841,0.0393488343893049,0.203080001212599,0.757571164398096
13,"Mecklenburg-Vorpommern",13072044,"Gutow",962,475,487,0.493762993762994,975,485,490,0.497435897435897,0.0393488343893049,0.203080001212599,0.757571164398096
13,"Mecklenburg-Vorpommern",13072045,"Hohen Demzin",410,204,206,0.497560975609756,433,223,210,0.515011547344111,0.0393488343893049,0.203080001212599,0.757571164398096
13,"Mecklenburg-Vorpommern",13072046,"Hohen Sprenz",506,254,252,0.50197628458498,505,256,249,0.506930693069307,0.0393488343893049,0.203080001212599,0.757571164398096
13,"Mecklenburg-Vorpommern",13072047,"Hohenfelde",841,423,418,0.502972651605232,842,420,422,0.498812351543943,0.0393488343893049,0.203080001212599,0.757571164398096
13,"Mecklenburg-Vorpommern",13072048,"Hoppenrade",673,341,332,0.506686478454681,761,365,396,0.479632063074901,0.0393488343893049,0.203080001212599,0.757571164398096
13,"Mecklenburg-Vorpommern",13072049,"Jördenstorf",899,467,432,0.519466073414905,872,433,439,0.496559633027523,0.0393488343893049,0.203080001212599,0.757571164398096
13,"Mecklenburg-Vorpommern",13072050,"Jürgenshagen",1082,549,533,0.507393715341959,1113,568,545,0.510332434860737,0.0393488343893049,0.203080001212599,0.757571164398096
13,"Mecklenburg-Vorpommern",13072051,"Kassow",355,178,177,0.501408450704225,364,174,190,0.478021978021978,0.0393488343893049,0.203080001212599,0.757571164398096
13,"Mecklenburg-Vorpommern",13072052,"Kirch Mulsow",339,167,172,0.492625368731563,336,163,173,0.485119047619048,0.0393488343893049,0.203080001212599,0.757571164398096
13,"Mecklenburg-Vorpommern",13072053,"Klein Belitz",813,414,399,0.509225092250922,839,431,408,0.513706793802145,0.0393488343893049,0.203080001212599,0.757571164398096
13,"Mecklenburg-Vorpommern",13072054,"Klein Kussewitz",715,374,341,0.523076923076923,749,388,361,0.518024032042724,0.0393488343893049,0.203080001212599,0.757571164398096
13,"Mecklenburg-Vorpommern",13072055,"Klein Upahl",275,144,131,0.523636363636364,273,142,131,0.52014652014652,0.0393488343893049,0.203080001212599,0.757571164398096
13,"Mecklenburg-Vorpommern",13072056,"Krakow am See, Stadt",3600,1804,1796,0.501111111111111,3301,1644,1657,0.498030899727355,0.0393488343893049,0.203080001212599,0.757571164398096
13,"Mecklenburg-Vorpommern",13072057,"Kritzmow",3253,1622,1631,0.498616661543191,3228,1628,1600,0.504337050805452,0.0393488343893049,0.203080001212599,0.757571164398096
13,"Mecklenburg-Vorpommern",13072058,"Kröpelin, Stadt",4830,2428,2402,0.502691511387164,4733,2386,2347,0.504120008451299,0.0393488343893049,0.203080001212599,0.757571164398096
13,"Mecklenburg-Vorpommern",13072059,"Kuchelmiß",767,428,339,0.558018252933507,886,502,384,0.566591422121896,0.0393488343893049,0.203080001212599,0.757571164398096
13,"Mecklenburg-Vorpommern",13072060,"Kühlungsborn, Stadt",7336,3459,3877,0.471510359869138,7236,3443,3793,0.475815367606412,0.0393488343893049,0.203080001212599,0.757571164398096
13,"Mecklenburg-Vorpommern",13072061,"Kuhs",325,165,160,0.507692307692308,341,178,163,0.521994134897361,0.0393488343893049,0.203080001212599,0.757571164398096
13,"Mecklenburg-Vorpommern",13072062,"Laage, Stadt",5434,2738,2696,0.503864556496135,5523,2790,2733,0.505160239000543,0.0393488343893049,0.203080001212599,0.757571164398096
13,"Mecklenburg-Vorpommern",13072063,"Lalendorf",3067,1542,1525,0.502771437887186,3130,1570,1560,0.501597444089457,0.0393488343893049,0.203080001212599,0.757571164398096
13,"Mecklenburg-Vorpommern",13072064,"Lambrechtshagen",2711,1362,1349,0.50239763924751,2845,1468,1377,0.515992970123023,0.0393488343893049,0.203080001212599,0.757571164398096
13,"Mecklenburg-Vorpommern",13072065,"Langhagen",577,305,272,0.528596187175043,607,321,286,0.528830313014827,0.0393488343893049,0.203080001212599,0.757571164398096
13,"Mecklenburg-Vorpommern",13072066,"Lelkendorf",493,253,240,0.513184584178499,516,272,244,0.527131782945736,0.0393488343893049,0.203080001212599,0.757571164398096
13,"Mecklenburg-Vorpommern",13072067,"Lohmen",759,362,397,0.476943346508564,709,366,343,0.516220028208745,0.0393488343893049,0.203080001212599,0.757571164398096
13,"Mecklenburg-Vorpommern",13072068,"Lühburg",226,111,115,0.491150442477876,244,120,124,0.491803278688525,0.0393488343893049,0.203080001212599,0.757571164398096
13,"Mecklenburg-Vorpommern",13072069,"Lüssow",950,491,459,0.516842105263158,901,461,440,0.51165371809101,0.0393488343893049,0.203080001212599,0.757571164398096
13,"Mecklenburg-Vorpommern",13072070,"Mandelshagen",256,127,129,0.49609375,257,131,126,0.509727626459144,0.0393488343893049,0.203080001212599,0.757571164398096
13,"Mecklenburg-Vorpommern",13072071,"Mistorf",660,350,310,0.53030303030303,636,328,308,0.515723270440252,0.0393488343893049,0.203080001212599,0.757571164398096
13,"Mecklenburg-Vorpommern",13072072,"Mönchhagen",1125,575,550,0.511111111111111,1134,588,546,0.518518518518518,0.0393488343893049,0.203080001212599,0.757571164398096
13,"Mecklenburg-Vorpommern",13072073,"Mühl Rosin",1077,529,548,0.491179201485608,1086,534,552,0.49171270718232,0.0393488343893049,0.203080001212599,0.757571164398096
13,"Mecklenburg-Vorpommern",13072074,"Neubukow, Stadt",3951,1941,2010,0.491268033409264,4003,1967,2036,0.491381463902073,0.0393488343893049,0.203080001212599,0.757571164398096
13,"Mecklenburg-Vorpommern",13072075,"Nienhagen",1865,917,948,0.491689008042895,1855,903,952,0.486792452830189,0.0393488343893049,0.203080001212599,0.757571164398096
13,"Mecklenburg-Vorpommern",13072076,"Nustrow",161,83,78,0.515527950310559,164,89,75,0.542682926829268,0.0393488343893049,0.203080001212599,0.757571164398096
13,"Mecklenburg-Vorpommern",13072077,"Papendorf",2457,1231,1226,0.501017501017501,2500,1263,1237,0.5052,0.0393488343893049,0.203080001212599,0.757571164398096
13,"Mecklenburg-Vorpommern",13072078,"Penzin",154,76,78,0.493506493506494,150,76,74,0.506666666666667,0.0393488343893049,0.203080001212599,0.757571164398096
13,"Mecklenburg-Vorpommern",13072079,"Plaaz",799,426,373,0.533166458072591,769,404,365,0.525357607282185,0.0393488343893049,0.203080001212599,0.757571164398096
13,"Mecklenburg-Vorpommern",13072080,"Pölchow",899,455,444,0.506117908787542,939,476,463,0.50692225772098,0.0393488343893049,0.203080001212599,0.757571164398096
13,"Mecklenburg-Vorpommern",13072081,"Poppendorf",665,343,322,0.515789473684211,678,349,329,0.514749262536873,0.0393488343893049,0.203080001212599,0.757571164398096
13,"Mecklenburg-Vorpommern",13072082,"Prebberede",795,415,380,0.522012578616352,787,409,378,0.519695044472681,0.0393488343893049,0.203080001212599,0.757571164398096
13,"Mecklenburg-Vorpommern",13072083,"Reddelich",887,452,435,0.509582863585118,919,471,448,0.512513601741023,0.0393488343893049,0.203080001212599,0.757571164398096
13,"Mecklenburg-Vorpommern",13072084,"Reimershagen",415,213,202,0.513253012048193,459,233,226,0.507625272331155,0.0393488343893049,0.203080001212599,0.757571164398096
13,"Mecklenburg-Vorpommern",13072085,"Rerik, Stadt",2200,1054,1146,0.479090909090909,2195,1055,1140,0.480637813211845,0.0393488343893049,0.203080001212599,0.757571164398096
13,"Mecklenburg-Vorpommern",13072086,"Retschow",920,486,434,0.528260869565217,916,491,425,0.536026200873362,0.0393488343893049,0.203080001212599,0.757571164398096
13,"Mecklenburg-Vorpommern",13072087,"Roggentin",2638,1347,1291,0.510614101592115,2701,1380,1321,0.510921880784895,0.0393488343893049,0.203080001212599,0.757571164398096
13,"Mecklenburg-Vorpommern",13072088,"Rövershagen",2446,1250,1196,0.511038430089943,2537,1308,1229,0.515569570358691,0.0393488343893049,0.203080001212599,0.757571164398096
13,"Mecklenburg-Vorpommern",13072089,"Rühn",635,312,323,0.491338582677165,677,346,331,0.511078286558346,0.0393488343893049,0.203080001212599,0.757571164398096
13,"Mecklenburg-Vorpommern",13072090,"Rukieten",302,158,144,0.52317880794702,315,167,148,0.53015873015873,0.0393488343893049,0.203080001212599,0.757571164398096
13,"Mecklenburg-Vorpommern",13072091,"Sanitz",5704,2875,2829,0.504032258064516,5762,2901,2861,0.503471017007983,0.0393488343893049,0.203080001212599,0.757571164398096
13,"Mecklenburg-Vorpommern",13072092,"Sarmstorf",510,261,249,0.511764705882353,513,262,251,0.510721247563353,0.0393488343893049,0.203080001212599,0.757571164398096
13,"Mecklenburg-Vorpommern",13072093,"Satow",5490,2793,2697,0.508743169398907,5541,2839,2702,0.512362389460386,0.0393488343893049,0.203080001212599,0.757571164398096
13,"Mecklenburg-Vorpommern",13072094,"Schorssow",463,233,230,0.503239740820734,478,243,235,0.50836820083682,0.0393488343893049,0.203080001212599,0.757571164398096
13,"Mecklenburg-Vorpommern",13072095,"Schwaan, Stadt",5014,2453,2561,0.48923015556442,5083,2489,2594,0.489671453865827,0.0393488343893049,0.203080001212599,0.757571164398096
13,"Mecklenburg-Vorpommern",13072096,"Schwasdorf",502,258,244,0.51394422310757,623,355,268,0.569823434991974,0.0393488343893049,0.203080001212599,0.757571164398096
13,"Mecklenburg-Vorpommern",13072097,"Selpin",493,260,233,0.527383367139959,507,255,252,0.502958579881657,0.0393488343893049,0.203080001212599,0.757571164398096
13,"Mecklenburg-Vorpommern",13072098,"Stäbelow",1399,705,694,0.503931379556826,1345,665,680,0.494423791821561,0.0393488343893049,0.203080001212599,0.757571164398096
13,"Mecklenburg-Vorpommern",13072099,"Steffenshagen",462,243,219,0.525974025974026,479,250,229,0.521920668058455,0.0393488343893049,0.203080001212599,0.757571164398096
13,"Mecklenburg-Vorpommern",13072100,"Steinfeld",544,281,263,0.516544117647059,557,281,276,0.504488330341113,0.0393488343893049,0.203080001212599,0.757571164398096
13,"Mecklenburg-Vorpommern",13072101,"Steinhagen",710,353,357,0.497183098591549,758,394,364,0.519788918205805,0.0393488343893049,0.203080001212599,0.757571164398096
13,"Mecklenburg-Vorpommern",13072102,"Stubbendorf",134,71,63,0.529850746268657,142,76,66,0.535211267605634,0.0393488343893049,0.203080001212599,0.757571164398096
13,"Mecklenburg-Vorpommern",13072103,"Sukow-Levitzow",476,248,228,0.521008403361345,470,240,230,0.51063829787234,0.0393488343893049,0.203080001212599,0.757571164398096
13,"Mecklenburg-Vorpommern",13072104,"Tarnow",1117,568,549,0.508504923903312,1139,584,555,0.512730465320457,0.0393488343893049,0.203080001212599,0.757571164398096
13,"Mecklenburg-Vorpommern",13072105,"Tessin, Stadt",3908,1886,2022,0.482599795291709,3869,1873,1996,0.484104419746705,0.0393488343893049,0.203080001212599,0.757571164398096
13,"Mecklenburg-Vorpommern",13072106,"Teterow, Stadt",8863,4295,4568,0.484598894279589,8852,4298,4554,0.485539990962494,0.0393488343893049,0.203080001212599,0.757571164398096
13,"Mecklenburg-Vorpommern",13072107,"Thelkow",461,242,219,0.524945770065076,441,241,200,0.546485260770975,0.0393488343893049,0.203080001212599,0.757571164398096
13,"Mecklenburg-Vorpommern",13072108,"Thulendorf",595,315,280,0.529411764705882,593,320,273,0.539629005059022,0.0393488343893049,0.203080001212599,0.757571164398096
13,"Mecklenburg-Vorpommern",13072109,"Thürkow",386,200,186,0.518134715025907,402,209,193,0.519900497512438,0.0393488343893049,0.203080001212599,0.757571164398096
13,"Mecklenburg-Vorpommern",13072110,"Vorbeck",302,164,138,0.543046357615894,326,180,146,0.552147239263804,0.0393488343893049,0.203080001212599,0.757571164398096
13,"Mecklenburg-Vorpommern",13072111,"Walkendorf",443,221,222,0.498871331828442,454,230,224,0.506607929515419,0.0393488343893049,0.203080001212599,0.757571164398096
13,"Mecklenburg-Vorpommern",13072112,"Wardow",1323,685,638,0.517762660619803,1404,723,681,0.514957264957265,0.0393488343893049,0.203080001212599,0.757571164398096
13,"Mecklenburg-Vorpommern",13072113,"Warnkenhagen",357,183,174,0.512605042016807,345,171,174,0.495652173913044,0.0393488343893049,0.203080001212599,0.757571164398096
13,"Mecklenburg-Vorpommern",13072114,"Warnow",934,493,441,0.527837259100642,956,495,461,0.517782426778243,0.0393488343893049,0.203080001212599,0.757571164398096
13,"Mecklenburg-Vorpommern",13072116,"Wiendorf",764,400,364,0.523560209424084,775,402,373,0.518709677419355,0.0393488343893049,0.203080001212599,0.757571164398096
13,"Mecklenburg-Vorpommern",13072117,"Wittenbeck",784,386,398,0.49234693877551,808,405,403,0.501237623762376,0.0393488343893049,0.203080001212599,0.757571164398096
13,"Mecklenburg-Vorpommern",13072118,"Zarnewanz",373,197,176,0.528150134048257,378,193,185,0.510582010582011,0.0393488343893049,0.203080001212599,0.757571164398096
13,"Mecklenburg-Vorpommern",13072119,"Zehna",623,322,301,0.51685393258427,606,312,294,0.514851485148515,0.0393488343893049,0.203080001212599,0.757571164398096
13,"Mecklenburg-Vorpommern",13072120,"Zepelin",451,228,223,0.505543237250554,431,216,215,0.501160092807425,0.0393488343893049,0.203080001212599,0.757571164398096
13,"Mecklenburg-Vorpommern",13072121,"Ziesendorf",1354,669,685,0.494091580502216,1388,688,700,0.495677233429395,0.0393488343893049,0.203080001212599,0.757571164398096
13,"Mecklenburg-Vorpommern",13073001,"Ahrenshagen-Daskow",2051,1064,987,0.51877133105802,2042,1059,983,0.518609206660137,0.0393488343893049,0.203080001212599,0.757571164398096
13,"Mecklenburg-Vorpommern",13073002,"Ahrenshoop",655,324,331,0.494656488549618,694,321,373,0.462536023054755,0.0393488343893049,0.203080001212599,0.757571164398096
13,"Mecklenburg-Vorpommern",13073003,"Altefähr",1215,637,578,0.524279835390946,1210,631,579,0.521487603305785,0.0393488343893049,0.203080001212599,0.757571164398096
13,"Mecklenburg-Vorpommern",13073004,"Altenkirchen",998,489,509,0.48997995991984,984,487,497,0.494918699186992,0.0393488343893049,0.203080001212599,0.757571164398096
13,"Mecklenburg-Vorpommern",13073005,"Altenpleen",977,480,497,0.491299897645855,939,467,472,0.497337593184239,0.0393488343893049,0.203080001212599,0.757571164398096
13,"Mecklenburg-Vorpommern",13073006,"Baabe",858,405,453,0.472027972027972,816,381,435,0.466911764705882,0.0393488343893049,0.203080001212599,0.757571164398096
13,"Mecklenburg-Vorpommern",13073007,"Bad Sülze, Stadt",1734,862,872,0.497116493656286,1677,831,846,0.495527728085868,0.0393488343893049,0.203080001212599,0.757571164398096
13,"Mecklenburg-Vorpommern",13073008,"Bartelshagen II b. Barth",379,199,180,0.525065963060686,410,209,201,0.509756097560976,0.0393488343893049,0.203080001212599,0.757571164398096
13,"Mecklenburg-Vorpommern",13073009,"Barth, Stadt",8722,4129,4593,0.473400596193534,8706,4146,4560,0.476223294279807,0.0393488343893049,0.203080001212599,0.757571164398096
13,"Mecklenburg-Vorpommern",13073010,"Bergen auf Rügen, Stadt",13844,6591,7253,0.476090725223924,14240,6839,7401,0.480266853932584,0.0393488343893049,0.203080001212599,0.757571164398096
13,"Mecklenburg-Vorpommern",13073011,"Binz",5176,2462,2714,0.475656877897991,5399,2621,2778,0.485460270420448,0.0393488343893049,0.203080001212599,0.757571164398096
13,"Mecklenburg-Vorpommern",13073012,"Born a. Darß",1151,573,578,0.497827975673328,1117,561,556,0.502238137869293,0.0393488343893049,0.203080001212599,0.757571164398096
13,"Mecklenburg-Vorpommern",13073013,"Breege",648,339,309,0.523148148148148,768,420,348,0.546875,0.0393488343893049,0.203080001212599,0.757571164398096
13,"Mecklenburg-Vorpommern",13073014,"Buschvitz",243,124,119,0.510288065843621,235,123,112,0.523404255319149,0.0393488343893049,0.203080001212599,0.757571164398096
13,"Mecklenburg-Vorpommern",13073015,"Dettmannsdorf",981,489,492,0.498470948012232,1029,510,519,0.495626822157434,0.0393488343893049,0.203080001212599,0.757571164398096
13,"Mecklenburg-Vorpommern",13073016,"Deyelsdorf",506,270,236,0.533596837944664,517,273,244,0.528046421663443,0.0393488343893049,0.203080001212599,0.757571164398096
13,"Mecklenburg-Vorpommern",13073017,"Dierhagen",1520,738,782,0.485526315789474,1535,746,789,0.48599348534202,0.0393488343893049,0.203080001212599,0.757571164398096
13,"Mecklenburg-Vorpommern",13073018,"Divitz-Spoldershagen",475,234,241,0.492631578947368,482,240,242,0.49792531120332,0.0393488343893049,0.203080001212599,0.757571164398096
13,"Mecklenburg-Vorpommern",13073019,"Dranske",1214,634,580,0.522240527182867,1181,608,573,0.514817950889077,0.0393488343893049,0.203080001212599,0.757571164398096
13,"Mecklenburg-Vorpommern",13073020,"Drechow",244,134,110,0.549180327868853,225,133,92,0.591111111111111,0.0393488343893049,0.203080001212599,0.757571164398096
13,"Mecklenburg-Vorpommern",13073021,"Dreschvitz",798,426,372,0.533834586466165,811,429,382,0.528976572133169,0.0393488343893049,0.203080001212599,0.757571164398096
13,"Mecklenburg-Vorpommern",13073022,"Eixen",779,428,351,0.549422336328626,784,427,357,0.544642857142857,0.0393488343893049,0.203080001212599,0.757571164398096
13,"Mecklenburg-Vorpommern",13073023,"Elmenhorst",742,373,369,0.502695417789757,701,346,355,0.49358059914408,0.0393488343893049,0.203080001212599,0.757571164398096
13,"Mecklenburg-Vorpommern",13073024,"Franzburg, Stadt",1496,716,780,0.478609625668449,1412,660,752,0.46742209631728,0.0393488343893049,0.203080001212599,0.757571164398096
13,"Mecklenburg-Vorpommern",13073025,"Fuhlendorf",805,401,404,0.498136645962733,905,457,448,0.504972375690608,0.0393488343893049,0.203080001212599,0.757571164398096
13,"Mecklenburg-Vorpommern",13073026,"Gager",408,218,190,0.534313725490196,398,209,189,0.525125628140704,0.0393488343893049,0.203080001212599,0.757571164398096
13,"Mecklenburg-Vorpommern",13073027,"Garz/Rügen, Stadt",2264,1117,1147,0.493374558303887,2306,1147,1159,0.497398091934085,0.0393488343893049,0.203080001212599,0.757571164398096
13,"Mecklenburg-Vorpommern",13073028,"Gingst",1413,677,736,0.479122434536447,1366,642,724,0.469985358711567,0.0393488343893049,0.203080001212599,0.757571164398096
13,"Mecklenburg-Vorpommern",13073029,"Glewitz",561,294,267,0.524064171122995,561,296,265,0.527629233511586,0.0393488343893049,0.203080001212599,0.757571164398096
13,"Mecklenburg-Vorpommern",13073030,"Glowe",983,484,499,0.492370295015259,1014,514,500,0.506903353057199,0.0393488343893049,0.203080001212599,0.757571164398096
13,"Mecklenburg-Vorpommern",13073031,"Göhren",1228,587,641,0.478013029315961,1234,599,635,0.485413290113452,0.0393488343893049,0.203080001212599,0.757571164398096
13,"Mecklenburg-Vorpommern",13073032,"Grammendorf",543,286,257,0.52670349907919,577,302,275,0.523396880415945,0.0393488343893049,0.203080001212599,0.757571164398096
13,"Mecklenburg-Vorpommern",13073033,"Gransebieth",592,298,294,0.503378378378378,623,318,305,0.510433386837881,0.0393488343893049,0.203080001212599,0.757571164398096
13,"Mecklenburg-Vorpommern",13073034,"Gremersdorf-Buchholz",679,364,315,0.536082474226804,710,380,330,0.535211267605634,0.0393488343893049,0.203080001212599,0.757571164398096
13,"Mecklenburg-Vorpommern",13073035,"Grimmen, Stadt",10049,4819,5230,0.479550204000398,10330,4958,5372,0.479961277831559,0.0393488343893049,0.203080001212599,0.757571164398096
13,"Mecklenburg-Vorpommern",13073036,"Groß Kordshagen",354,189,165,0.533898305084746,355,189,166,0.532394366197183,0.0393488343893049,0.203080001212599,0.757571164398096
13,"Mecklenburg-Vorpommern",13073037,"Groß Mohrdorf",761,385,376,0.505913272010513,794,399,395,0.502518891687657,0.0393488343893049,0.203080001212599,0.757571164398096
13,"Mecklenburg-Vorpommern",13073038,"Gustow",645,325,320,0.503875968992248,653,331,322,0.506891271056662,0.0393488343893049,0.203080001212599,0.757571164398096
13,"Mecklenburg-Vorpommern",13073039,"Hugoldsdorf",143,78,65,0.545454545454545,144,80,64,0.555555555555556,0.0393488343893049,0.203080001212599,0.757571164398096
13,"Mecklenburg-Vorpommern",13073040,"Insel Hiddensee",980,488,492,0.497959183673469,1014,494,520,0.487179487179487,0.0393488343893049,0.203080001212599,0.757571164398096
13,"Mecklenburg-Vorpommern",13073041,"Jakobsdorf",488,260,228,0.532786885245902,513,272,241,0.530214424951267,0.0393488343893049,0.203080001212599,0.757571164398096
13,"Mecklenburg-Vorpommern",13073042,"Karnin",214,114,100,0.532710280373832,213,116,97,0.544600938967136,0.0393488343893049,0.203080001212599,0.757571164398096
13,"Mecklenburg-Vorpommern",13073043,"Kenz-Küstrow",527,265,262,0.502846299810247,525,255,270,0.485714285714286,0.0393488343893049,0.203080001212599,0.757571164398096
13,"Mecklenburg-Vorpommern",13073044,"Klausdorf",652,317,335,0.486196319018405,642,316,326,0.492211838006231,0.0393488343893049,0.203080001212599,0.757571164398096
13,"Mecklenburg-Vorpommern",13073045,"Kluis",393,201,192,0.511450381679389,419,216,203,0.515513126491647,0.0393488343893049,0.203080001212599,0.757571164398096
13,"Mecklenburg-Vorpommern",13073046,"Kramerhof",1734,905,829,0.521914648212226,1782,929,853,0.521324354657688,0.0393488343893049,0.203080001212599,0.757571164398096
13,"Mecklenburg-Vorpommern",13073047,"Kummerow",320,167,153,0.521875,329,166,163,0.504559270516717,0.0393488343893049,0.203080001212599,0.757571164398096
13,"Mecklenburg-Vorpommern",13073048,"Lancken-Granitz",386,192,194,0.49740932642487,384,195,189,0.5078125,0.0393488343893049,0.203080001212599,0.757571164398096
13,"Mecklenburg-Vorpommern",13073049,"Lietzow",248,127,121,0.512096774193548,263,131,132,0.498098859315589,0.0393488343893049,0.203080001212599,0.757571164398096
13,"Mecklenburg-Vorpommern",13073050,"Lindholz",691,353,338,0.510853835021708,674,336,338,0.498516320474777,0.0393488343893049,0.203080001212599,0.757571164398096
13,"Mecklenburg-Vorpommern",13073051,"Löbnitz",630,334,296,0.53015873015873,636,333,303,0.523584905660377,0.0393488343893049,0.203080001212599,0.757571164398096
13,"Mecklenburg-Vorpommern",13073052,"Lohme",459,240,219,0.522875816993464,497,255,242,0.51307847082495,0.0393488343893049,0.203080001212599,0.757571164398096
13,"Mecklenburg-Vorpommern",13073053,"Lüdershagen",577,289,288,0.500866551126516,580,285,295,0.491379310344828,0.0393488343893049,0.203080001212599,0.757571164398096
13,"Mecklenburg-Vorpommern",13073054,"Lüssow",875,461,414,0.526857142857143,923,477,446,0.516793066088841,0.0393488343893049,0.203080001212599,0.757571164398096
13,"Mecklenburg-Vorpommern",13073055,"Marlow, Stadt",4677,2379,2298,0.508659397049391,4662,2381,2281,0.510725010725011,0.0393488343893049,0.203080001212599,0.757571164398096
13,"Mecklenburg-Vorpommern",13073056,"Middelhagen",575,280,295,0.48695652173913,579,279,300,0.481865284974093,0.0393488343893049,0.203080001212599,0.757571164398096
13,"Mecklenburg-Vorpommern",13073057,"Millienhagen-Oebelitz",357,192,165,0.53781512605042,354,199,155,0.562146892655367,0.0393488343893049,0.203080001212599,0.757571164398096
13,"Mecklenburg-Vorpommern",13073058,"Neu Bartelshagen",332,178,154,0.536144578313253,352,185,167,0.525568181818182,0.0393488343893049,0.203080001212599,0.757571164398096
13,"Mecklenburg-Vorpommern",13073059,"Neuenkirchen",339,188,151,0.554572271386431,307,169,138,0.550488599348534,0.0393488343893049,0.203080001212599,0.757571164398096
13,"Mecklenburg-Vorpommern",13073060,"Niepars",1840,946,894,0.514130434782609,1861,962,899,0.516926383664696,0.0393488343893049,0.203080001212599,0.757571164398096
13,"Mecklenburg-Vorpommern",13073061,"Pantelitz",717,377,340,0.525801952580195,741,395,346,0.53306342780027,0.0393488343893049,0.203080001212599,0.757571164398096
13,"Mecklenburg-Vorpommern",13073062,"Papenhagen",554,287,267,0.518050541516246,567,289,278,0.509700176366843,0.0393488343893049,0.203080001212599,0.757571164398096
13,"Mecklenburg-Vorpommern",13073063,"Parchtitz",763,386,377,0.505897771952818,774,394,380,0.509043927648579,0.0393488343893049,0.203080001212599,0.757571164398096
13,"Mecklenburg-Vorpommern",13073064,"Patzig",474,253,221,0.533755274261603,474,249,225,0.525316455696203,0.0393488343893049,0.203080001212599,0.757571164398096
13,"Mecklenburg-Vorpommern",13073065,"Poseritz",1048,541,507,0.516221374045801,1091,555,536,0.508707607699358,0.0393488343893049,0.203080001212599,0.757571164398096
13,"Mecklenburg-Vorpommern",13073066,"Preetz",1028,520,508,0.505836575875486,992,503,489,0.507056451612903,0.0393488343893049,0.203080001212599,0.757571164398096
13,"Mecklenburg-Vorpommern",13073067,"Prerow",1546,754,792,0.48771021992238,1611,785,826,0.487274984481688,0.0393488343893049,0.203080001212599,0.757571164398096
13,"Mecklenburg-Vorpommern",13073068,"Prohn",1989,965,1024,0.485168426344897,1978,953,1025,0.481799797775531,0.0393488343893049,0.203080001212599,0.757571164398096
13,"Mecklenburg-Vorpommern",13073069,"Pruchten",730,347,383,0.475342465753425,715,346,369,0.483916083916084,0.0393488343893049,0.203080001212599,0.757571164398096
13,"Mecklenburg-Vorpommern",13073070,"Putbus, Stadt",4324,2164,2160,0.500462534690102,4540,2261,2279,0.498017621145374,0.0393488343893049,0.203080001212599,0.757571164398096
13,"Mecklenburg-Vorpommern",13073071,"Putgarten",217,118,99,0.543778801843318,267,148,119,0.554307116104869,0.0393488343893049,0.203080001212599,0.757571164398096
13,"Mecklenburg-Vorpommern",13073072,"Ralswiek",231,118,113,0.510822510822511,251,132,119,0.525896414342629,0.0393488343893049,0.203080001212599,0.757571164398096
13,"Mecklenburg-Vorpommern",13073073,"Rambin",1000,526,474,0.526,996,526,470,0.528112449799197,0.0393488343893049,0.203080001212599,0.757571164398096
13,"Mecklenburg-Vorpommern",13073074,"Rappin",320,165,155,0.515625,340,182,158,0.535294117647059,0.0393488343893049,0.203080001212599,0.757571164398096
13,"Mecklenburg-Vorpommern",13073075,"Ribnitz-Damgarten, Stadt",15043,7190,7853,0.47796317223958,15893,7648,8245,0.481218146353741,0.0393488343893049,0.203080001212599,0.757571164398096
13,"Mecklenburg-Vorpommern",13073076,"Richtenberg, Stadt",1397,691,706,0.494631352899069,1324,647,677,0.488670694864048,0.0393488343893049,0.203080001212599,0.757571164398096
13,"Mecklenburg-Vorpommern",13073077,"Saal",1174,581,593,0.49488926746167,1192,582,610,0.488255033557047,0.0393488343893049,0.203080001212599,0.757571164398096
13,"Mecklenburg-Vorpommern",13073078,"Sagard",2464,1227,1237,0.497970779220779,2512,1246,1266,0.496019108280255,0.0393488343893049,0.203080001212599,0.757571164398096
13,"Mecklenburg-Vorpommern",13073079,"Samtens",1977,964,1013,0.487607486090035,1920,939,981,0.4890625,0.0393488343893049,0.203080001212599,0.757571164398096
13,"Mecklenburg-Vorpommern",13073080,"Sassnitz, Stadt",9678,4633,5045,0.478714610456706,10276,5046,5230,0.491047100038926,0.0393488343893049,0.203080001212599,0.757571164398096
13,"Mecklenburg-Vorpommern",13073081,"Schaprode",481,248,233,0.515592515592516,509,263,246,0.516699410609037,0.0393488343893049,0.203080001212599,0.757571164398096
13,"Mecklenburg-Vorpommern",13073082,"Schlemmin",294,149,145,0.506802721088435,297,149,148,0.501683501683502,0.0393488343893049,0.203080001212599,0.757571164398096
13,"Mecklenburg-Vorpommern",13073083,"Sehlen",864,431,433,0.498842592592593,886,436,450,0.492099322799097,0.0393488343893049,0.203080001212599,0.757571164398096
13,"Mecklenburg-Vorpommern",13073084,"Sellin",2410,1126,1284,0.467219917012448,2412,1125,1287,0.466417910447761,0.0393488343893049,0.203080001212599,0.757571164398096
13,"Mecklenburg-Vorpommern",13073085,"Semlow",749,390,359,0.520694259012016,785,414,371,0.527388535031847,0.0393488343893049,0.203080001212599,0.757571164398096
13,"Mecklenburg-Vorpommern",13073086,"Splietsdorf",486,256,230,0.526748971193416,486,259,227,0.532921810699588,0.0393488343893049,0.203080001212599,0.757571164398096
13,"Mecklenburg-Vorpommern",13073087,"Steinhagen",2534,1235,1299,0.487371744277822,2627,1294,1333,0.49257708412638,0.0393488343893049,0.203080001212599,0.757571164398096
13,"Mecklenburg-Vorpommern",13073088,"Stralsund, Hansestadt",56921,27614,29307,0.485128511445688,57862,28056,29806,0.484877812726833,0.0393488343893049,0.203080001212599,0.757571164398096
13,"Mecklenburg-Vorpommern",13073089,"Süderholz",4007,2098,1909,0.523583728475168,4004,2082,1922,0.51998001998002,0.0393488343893049,0.203080001212599,0.757571164398096
13,"Mecklenburg-Vorpommern",13073090,"Sundhagen",5191,2629,2562,0.506453477172028,5364,2746,2618,0.51193139448173,0.0393488343893049,0.203080001212599,0.757571164398096
13,"Mecklenburg-Vorpommern",13073091,"Thiessow",377,174,203,0.461538461538462,406,186,220,0.458128078817734,0.0393488343893049,0.203080001212599,0.757571164398096
13,"Mecklenburg-Vorpommern",13073092,"Trent",728,379,349,0.520604395604396,740,387,353,0.522972972972973,0.0393488343893049,0.203080001212599,0.757571164398096
13,"Mecklenburg-Vorpommern",13073093,"Tribsees, Stadt",2650,1281,1369,0.483396226415094,2561,1231,1330,0.480671612651308,0.0393488343893049,0.203080001212599,0.757571164398096
13,"Mecklenburg-Vorpommern",13073094,"Trinwillershagen",1183,594,589,0.502113271344041,1217,624,593,0.512736236647494,0.0393488343893049,0.203080001212599,0.757571164398096
13,"Mecklenburg-Vorpommern",13073095,"Ummanz",559,294,265,0.525939177101968,603,319,284,0.529021558872305,0.0393488343893049,0.203080001212599,0.757571164398096
13,"Mecklenburg-Vorpommern",13073096,"Velgast",1845,952,893,0.515989159891599,1825,924,901,0.506301369863014,0.0393488343893049,0.203080001212599,0.757571164398096
13,"Mecklenburg-Vorpommern",13073097,"Weitenhagen",247,124,123,0.502024291497976,239,126,113,0.527196652719665,0.0393488343893049,0.203080001212599,0.757571164398096
13,"Mecklenburg-Vorpommern",13073098,"Wendisch Baggendorf",556,284,272,0.510791366906475,554,280,274,0.505415162454874,0.0393488343893049,0.203080001212599,0.757571164398096
13,"Mecklenburg-Vorpommern",13073099,"Wendorf",933,479,454,0.513397642015005,978,499,479,0.510224948875256,0.0393488343893049,0.203080001212599,0.757571164398096
13,"Mecklenburg-Vorpommern",13073100,"Wieck a. Darß",714,350,364,0.490196078431373,750,386,364,0.514666666666667,0.0393488343893049,0.203080001212599,0.757571164398096
13,"Mecklenburg-Vorpommern",13073101,"Wiek",1147,551,596,0.480383609415867,1124,553,571,0.491992882562278,0.0393488343893049,0.203080001212599,0.757571164398096
13,"Mecklenburg-Vorpommern",13073102,"Wittenhagen",1154,571,583,0.494800693240901,1212,616,596,0.508250825082508,0.0393488343893049,0.203080001212599,0.757571164398096
13,"Mecklenburg-Vorpommern",13073103,"Wustrow",1174,580,594,0.494037478705281,1192,592,600,0.496644295302013,0.0393488343893049,0.203080001212599,0.757571164398096
13,"Mecklenburg-Vorpommern",13073104,"Zarrendorf",1027,528,499,0.514118792599805,1049,550,499,0.524308865586273,0.0393488343893049,0.203080001212599,0.757571164398096
13,"Mecklenburg-Vorpommern",13073105,"Zingst",3065,1454,1611,0.474388254486134,3129,1511,1618,0.482901885586449,0.0393488343893049,0.203080001212599,0.757571164398096
13,"Mecklenburg-Vorpommern",13073106,"Zirkow",653,321,332,0.491577335375191,682,339,343,0.497067448680352,0.0393488343893049,0.203080001212599,0.757571164398096
13,"Mecklenburg-Vorpommern",13074001,"Alt Meteln",1228,615,613,0.500814332247557,1271,635,636,0.499606608969316,0.0393488343893049,0.203080001212599,0.757571164398096
13,"Mecklenburg-Vorpommern",13074002,"Bad Kleinen",3645,1807,1838,0.495747599451303,3643,1833,1810,0.503156738951414,0.0393488343893049,0.203080001212599,0.757571164398096
13,"Mecklenburg-Vorpommern",13074003,"Barnekow",617,306,311,0.495948136142626,639,318,321,0.497652582159624,0.0393488343893049,0.203080001212599,0.757571164398096
13,"Mecklenburg-Vorpommern",13074004,"Benz",618,310,308,0.501618122977346,627,312,315,0.497607655502392,0.0393488343893049,0.203080001212599,0.757571164398096
13,"Mecklenburg-Vorpommern",13074005,"Bernstorf",334,182,152,0.544910179640719,339,188,151,0.554572271386431,0.0393488343893049,0.203080001212599,0.757571164398096
13,"Mecklenburg-Vorpommern",13074006,"Bibow",386,226,160,0.585492227979275,406,242,164,0.596059113300493,0.0393488343893049,0.203080001212599,0.757571164398096
13,"Mecklenburg-Vorpommern",13074007,"Blowatz",1130,557,573,0.492920353982301,1173,582,591,0.49616368286445,0.0393488343893049,0.203080001212599,0.757571164398096
13,"Mecklenburg-Vorpommern",13074008,"Bobitz",2491,1285,1206,0.515857085507828,2576,1338,1238,0.519409937888199,0.0393488343893049,0.203080001212599,0.757571164398096
13,"Mecklenburg-Vorpommern",13074009,"Boiensdorf",517,263,254,0.508704061895551,522,266,256,0.509578544061303,0.0393488343893049,0.203080001212599,0.757571164398096
13,"Mecklenburg-Vorpommern",13074010,"Boltenhagen",2397,1136,1261,0.47392574050897,2465,1170,1295,0.474645030425964,0.0393488343893049,0.203080001212599,0.757571164398096
13,"Mecklenburg-Vorpommern",13074011,"Börzow",717,371,346,0.517433751743375,735,377,358,0.512925170068027,0.0393488343893049,0.203080001212599,0.757571164398096
13,"Mecklenburg-Vorpommern",13074012,"Brüsewitz",2095,1074,1021,0.512649164677804,2103,1070,1033,0.508796956728483,0.0393488343893049,0.203080001212599,0.757571164398096
13,"Mecklenburg-Vorpommern",13074013,"Carlow",1193,617,576,0.517183570829841,1247,646,601,0.518043303929431,0.0393488343893049,0.203080001212599,0.757571164398096
13,"Mecklenburg-Vorpommern",13074014,"Cramonshagen",502,266,236,0.529880478087649,518,274,244,0.528957528957529,0.0393488343893049,0.203080001212599,0.757571164398096
13,"Mecklenburg-Vorpommern",13074015,"Dalberg-Wendelstorf",534,273,261,0.51123595505618,526,276,250,0.524714828897338,0.0393488343893049,0.203080001212599,0.757571164398096
13,"Mecklenburg-Vorpommern",13074016,"Damshagen",1255,632,623,0.503585657370518,1331,674,657,0.506386175807663,0.0393488343893049,0.203080001212599,0.757571164398096
13,"Mecklenburg-Vorpommern",13074017,"Dassow, Stadt",4017,2031,1986,0.505601194921583,4028,2035,1993,0.505213505461768,0.0393488343893049,0.203080001212599,0.757571164398096
13,"Mecklenburg-Vorpommern",13074018,"Dechow",202,100,102,0.495049504950495,199,97,102,0.487437185929648,0.0393488343893049,0.203080001212599,0.757571164398096
13,"Mecklenburg-Vorpommern",13074019,"Dorf Mecklenburg",2850,1410,1440,0.494736842105263,2857,1438,1419,0.503325166258313,0.0393488343893049,0.203080001212599,0.757571164398096
13,"Mecklenburg-Vorpommern",13074020,"Dragun",797,397,400,0.498117942283563,810,404,406,0.498765432098765,0.0393488343893049,0.203080001212599,0.757571164398096
13,"Mecklenburg-Vorpommern",13074021,"Gadebusch, Stadt",5568,2731,2837,0.49048132183908,5640,2790,2850,0.49468085106383,0.0393488343893049,0.203080001212599,0.757571164398096
13,"Mecklenburg-Vorpommern",13074022,"Gägelow",2560,1312,1248,0.5125,2551,1329,1222,0.520972167777342,0.0393488343893049,0.203080001212599,0.757571164398096
13,"Mecklenburg-Vorpommern",13074023,"Glasin",806,425,381,0.527295285359802,848,459,389,0.54127358490566,0.0393488343893049,0.203080001212599,0.757571164398096
13,"Mecklenburg-Vorpommern",13074024,"Gottesgabe",765,383,382,0.500653594771242,797,399,398,0.500627352572146,0.0393488343893049,0.203080001212599,0.757571164398096
13,"Mecklenburg-Vorpommern",13074025,"Grambow",627,321,306,0.511961722488038,660,336,324,0.509090909090909,0.0393488343893049,0.203080001212599,0.757571164398096
13,"Mecklenburg-Vorpommern",13074026,"Grevesmühlen, Stadt",10664,5158,5506,0.483683420855214,10623,5149,5474,0.484703002918196,0.0393488343893049,0.203080001212599,0.757571164398096
13,"Mecklenburg-Vorpommern",13074027,"Grieben",167,90,77,0.538922155688623,160,85,75,0.53125,0.0393488343893049,0.203080001212599,0.757571164398096
13,"Mecklenburg-Vorpommern",13074028,"Groß Molzahn",362,172,190,0.475138121546961,383,180,203,0.469973890339426,0.0393488343893049,0.203080001212599,0.757571164398096
13,"Mecklenburg-Vorpommern",13074029,"Groß Siemz",306,160,146,0.522875816993464,292,147,145,0.503424657534247,0.0393488343893049,0.203080001212599,0.757571164398096
13,"Mecklenburg-Vorpommern",13074030,"Groß Stieten",552,287,265,0.519927536231884,612,323,289,0.527777777777778,0.0393488343893049,0.203080001212599,0.757571164398096
13,"Mecklenburg-Vorpommern",13074031,"Hohen Viecheln",640,328,312,0.5125,651,323,328,0.49615975422427,0.0393488343893049,0.203080001212599,0.757571164398096
13,"Mecklenburg-Vorpommern",13074032,"Hohenkirchen",1291,654,637,0.506584043377227,1417,719,698,0.507410021171489,0.0393488343893049,0.203080001212599,0.757571164398096
13,"Mecklenburg-Vorpommern",13074033,"Holdorf",397,204,193,0.513853904282116,406,203,203,0.5,0.0393488343893049,0.203080001212599,0.757571164398096
13,"Mecklenburg-Vorpommern",13074034,"Hornstorf",1073,532,541,0.495806150978565,1139,563,576,0.494293239683933,0.0393488343893049,0.203080001212599,0.757571164398096
13,"Mecklenburg-Vorpommern",13074035,"Insel Poel",2553,1236,1317,0.484136310223267,2624,1260,1364,0.480182926829268,0.0393488343893049,0.203080001212599,0.757571164398096
13,"Mecklenburg-Vorpommern",13074036,"Jesendorf",458,246,212,0.537117903930131,478,252,226,0.527196652719665,0.0393488343893049,0.203080001212599,0.757571164398096
13,"Mecklenburg-Vorpommern",13074037,"Kalkhorst",1804,924,880,0.51219512195122,1834,933,901,0.508724100327154,0.0393488343893049,0.203080001212599,0.757571164398096
13,"Mecklenburg-Vorpommern",13074038,"Klein Trebbow",868,440,428,0.506912442396313,911,467,444,0.512623490669594,0.0393488343893049,0.203080001212599,0.757571164398096
13,"Mecklenburg-Vorpommern",13074039,"Klütz, Stadt",3048,1500,1548,0.492125984251969,3079,1530,1549,0.496914582656707,0.0393488343893049,0.203080001212599,0.757571164398096
13,"Mecklenburg-Vorpommern",13074040,"Kneese",303,165,138,0.544554455445545,308,169,139,0.548701298701299,0.0393488343893049,0.203080001212599,0.757571164398096
13,"Mecklenburg-Vorpommern",13074042,"Königsfeld",945,487,458,0.515343915343915,975,513,462,0.526153846153846,0.0393488343893049,0.203080001212599,0.757571164398096
13,"Mecklenburg-Vorpommern",13074043,"Krembz",894,473,421,0.529082774049217,918,477,441,0.519607843137255,0.0393488343893049,0.203080001212599,0.757571164398096
13,"Mecklenburg-Vorpommern",13074044,"Krusenhagen",509,259,250,0.508840864440079,537,274,263,0.51024208566108,0.0393488343893049,0.203080001212599,0.757571164398096
13,"Mecklenburg-Vorpommern",13074045,"Lockwisch",399,206,193,0.516290726817043,396,198,198,0.5,0.0393488343893049,0.203080001212599,0.757571164398096
13,"Mecklenburg-Vorpommern",13074046,"Lübberstorf",217,115,102,0.529953917050691,221,114,107,0.515837104072398,0.0393488343893049,0.203080001212599,0.757571164398096
13,"Mecklenburg-Vorpommern",13074047,"Lübow",1531,801,730,0.523187459177008,1577,826,751,0.523779327837666,0.0393488343893049,0.203080001212599,0.757571164398096
13,"Mecklenburg-Vorpommern",13074048,"Lübstorf",1489,785,704,0.527199462726662,1462,770,692,0.526675786593707,0.0393488343893049,0.203080001212599,0.757571164398096
13,"Mecklenburg-Vorpommern",13074049,"Lüdersdorf",5113,2540,2573,0.496772931742617,5104,2535,2569,0.496669278996865,0.0393488343893049,0.203080001212599,0.757571164398096
13,"Mecklenburg-Vorpommern",13074050,"Lützow",1507,768,739,0.509621765096218,1461,743,718,0.508555783709788,0.0393488343893049,0.203080001212599,0.757571164398096
13,"Mecklenburg-Vorpommern",13074051,"Mallentin",692,364,328,0.526011560693642,699,364,335,0.520743919885551,0.0393488343893049,0.203080001212599,0.757571164398096
13,"Mecklenburg-Vorpommern",13074052,"Menzendorf",248,138,110,0.556451612903226,257,143,114,0.556420233463035,0.0393488343893049,0.203080001212599,0.757571164398096
13,"Mecklenburg-Vorpommern",13074053,"Metelsdorf",473,237,236,0.501057082452431,503,249,254,0.495029821073559,0.0393488343893049,0.203080001212599,0.757571164398096
13,"Mecklenburg-Vorpommern",13074054,"Mühlen Eichsen",977,498,479,0.509723643807574,1000,520,480,0.52,0.0393488343893049,0.203080001212599,0.757571164398096
13,"Mecklenburg-Vorpommern",13074055,"Nesow",227,116,111,0.511013215859031,236,124,112,0.525423728813559,0.0393488343893049,0.203080001212599,0.757571164398096
13,"Mecklenburg-Vorpommern",13074056,"Neuburg",2067,1036,1031,0.501209482341558,2029,1021,1008,0.503203548546082,0.0393488343893049,0.203080001212599,0.757571164398096
13,"Mecklenburg-Vorpommern",13074057,"Neukloster, Stadt",3887,1975,1912,0.508103936197582,3926,2020,1906,0.514518593988793,0.0393488343893049,0.203080001212599,0.757571164398096
13,"Mecklenburg-Vorpommern",13074058,"Niendorf",319,164,155,0.5141065830721,284,152,132,0.535211267605634,0.0393488343893049,0.203080001212599,0.757571164398096
13,"Mecklenburg-Vorpommern",13074059,"Papenhusen",321,180,141,0.560747663551402,312,168,144,0.538461538461538,0.0393488343893049,0.203080001212599,0.757571164398096
13,"Mecklenburg-Vorpommern",13074060,"Passee",172,92,80,0.534883720930233,177,95,82,0.536723163841808,0.0393488343893049,0.203080001212599,0.757571164398096
13,"Mecklenburg-Vorpommern",13074061,"Perlin",377,189,188,0.50132625994695,378,192,186,0.507936507936508,0.0393488343893049,0.203080001212599,0.757571164398096
13,"Mecklenburg-Vorpommern",13074062,"Pingelshagen",521,266,255,0.510556621880998,517,263,254,0.508704061895551,0.0393488343893049,0.203080001212599,0.757571164398096
13,"Mecklenburg-Vorpommern",13074063,"Plüschow",502,268,234,0.533864541832669,506,269,237,0.531620553359684,0.0393488343893049,0.203080001212599,0.757571164398096
13,"Mecklenburg-Vorpommern",13074064,"Pokrent",698,353,345,0.505730659025788,713,365,348,0.511921458625526,0.0393488343893049,0.203080001212599,0.757571164398096
13,"Mecklenburg-Vorpommern",13074065,"Rehna, Stadt",3024,1473,1551,0.487103174603175,2991,1451,1540,0.485122032764962,0.0393488343893049,0.203080001212599,0.757571164398096
13,"Mecklenburg-Vorpommern",13074066,"Rieps",362,199,163,0.549723756906077,379,205,174,0.54089709762533,0.0393488343893049,0.203080001212599,0.757571164398096
13,"Mecklenburg-Vorpommern",13074067,"Roduchelstorf",245,125,120,0.510204081632653,260,132,128,0.507692307692308,0.0393488343893049,0.203080001212599,0.757571164398096
13,"Mecklenburg-Vorpommern",13074068,"Roggendorf",1016,532,484,0.523622047244094,1014,532,482,0.52465483234714,0.0393488343893049,0.203080001212599,0.757571164398096
13,"Mecklenburg-Vorpommern",13074069,"Roggenstorf",465,243,222,0.52258064516129,458,239,219,0.521834061135371,0.0393488343893049,0.203080001212599,0.757571164398096
13,"Mecklenburg-Vorpommern",13074070,"Rögnitz",194,96,98,0.494845360824742,194,94,100,0.484536082474227,0.0393488343893049,0.203080001212599,0.757571164398096
13,"Mecklenburg-Vorpommern",13074071,"Rüting",538,273,265,0.507434944237918,548,269,279,0.490875912408759,0.0393488343893049,0.203080001212599,0.757571164398096
13,"Mecklenburg-Vorpommern",13074072,"Schildetal",806,417,389,0.517369727047146,814,431,383,0.52948402948403,0.0393488343893049,0.203080001212599,0.757571164398096
13,"Mecklenburg-Vorpommern",13074073,"Schlagsdorf",1084,567,517,0.523062730627306,1102,569,533,0.516333938294011,0.0393488343893049,0.203080001212599,0.757571164398096
13,"Mecklenburg-Vorpommern",13074074,"Schönberg, Stadt",4352,2132,2220,0.489889705882353,4288,2095,2193,0.48857276119403,0.0393488343893049,0.203080001212599,0.757571164398096
13,"Mecklenburg-Vorpommern",13074075,"Seehof",951,468,483,0.49211356466877,930,457,473,0.491397849462366,0.0393488343893049,0.203080001212599,0.757571164398096
13,"Mecklenburg-Vorpommern",13074076,"Selmsdorf",2697,1328,1369,0.492398961809418,2745,1373,1372,0.500182149362477,0.0393488343893049,0.203080001212599,0.757571164398096
13,"Mecklenburg-Vorpommern",13074077,"Testorf-Steinfort",627,322,305,0.513556618819777,644,335,309,0.520186335403727,0.0393488343893049,0.203080001212599,0.757571164398096
13,"Mecklenburg-Vorpommern",13074078,"Thandorf",173,86,87,0.497109826589595,176,83,93,0.471590909090909,0.0393488343893049,0.203080001212599,0.757571164398096
13,"Mecklenburg-Vorpommern",13074079,"Upahl",1066,548,518,0.514071294559099,1105,563,542,0.509502262443439,0.0393488343893049,0.203080001212599,0.757571164398096
13,"Mecklenburg-Vorpommern",13074080,"Utecht",324,166,158,0.512345679012346,376,213,163,0.566489361702128,0.0393488343893049,0.203080001212599,0.757571164398096
13,"Mecklenburg-Vorpommern",13074081,"Veelböken",694,350,344,0.504322766570605,702,353,349,0.502849002849003,0.0393488343893049,0.203080001212599,0.757571164398096
13,"Mecklenburg-Vorpommern",13074082,"Ventschow",688,336,352,0.488372093023256,722,348,374,0.481994459833795,0.0393488343893049,0.203080001212599,0.757571164398096
13,"Mecklenburg-Vorpommern",13074083,"Vitense",320,157,163,0.490625,334,169,165,0.505988023952096,0.0393488343893049,0.203080001212599,0.757571164398096
13,"Mecklenburg-Vorpommern",13074084,"Warin, Stadt",3411,1661,1750,0.486953972442099,3477,1699,1778,0.488639631866552,0.0393488343893049,0.203080001212599,0.757571164398096
13,"Mecklenburg-Vorpommern",13074085,"Warnow",644,332,312,0.515527950310559,641,334,307,0.521060842433697,0.0393488343893049,0.203080001212599,0.757571164398096
13,"Mecklenburg-Vorpommern",13074087,"Wismar, Hansestadt",42290,20465,21825,0.483920548593048,44057,21541,22516,0.488934789023311,0.0393488343893049,0.203080001212599,0.757571164398096
13,"Mecklenburg-Vorpommern",13074088,"Zickhusen",543,269,274,0.495395948434622,561,285,276,0.508021390374332,0.0393488343893049,0.203080001212599,0.757571164398096
13,"Mecklenburg-Vorpommern",13074089,"Zierow",757,390,367,0.515191545574637,763,389,374,0.509829619921363,0.0393488343893049,0.203080001212599,0.757571164398096
13,"Mecklenburg-Vorpommern",13074090,"Zurow",1348,712,636,0.528189910979229,1392,731,661,0.52514367816092,0.0393488343893049,0.203080001212599,0.757571164398096
13,"Mecklenburg-Vorpommern",13074091,"Züsow",306,165,141,0.53921568627451,321,174,147,0.542056074766355,0.0393488343893049,0.203080001212599,0.757571164398096
13,"Mecklenburg-Vorpommern",13074092,"Wedendorfersee",657,344,313,0.523592085235921,684,352,332,0.514619883040936,0.0393488343893049,0.203080001212599,0.757571164398096
13,"Mecklenburg-Vorpommern",13075001,"Ahlbeck",698,360,338,0.515759312320917,675,365,310,0.540740740740741,0.0393488343893049,0.203080001212599,0.757571164398096
13,"Mecklenburg-Vorpommern",13075002,"Alt Tellin",414,205,209,0.495169082125604,427,222,205,0.519906323185012,0.0393488343893049,0.203080001212599,0.757571164398096
13,"Mecklenburg-Vorpommern",13075003,"Altwarp",520,266,254,0.511538461538461,522,268,254,0.513409961685824,0.0393488343893049,0.203080001212599,0.757571164398096
13,"Mecklenburg-Vorpommern",13075004,"Altwigshagen",464,250,214,0.538793103448276,495,263,232,0.531313131313131,0.0393488343893049,0.203080001212599,0.757571164398096
13,"Mecklenburg-Vorpommern",13075005,"Anklam, Stadt",13050,6224,6826,0.476934865900383,13347,6443,6904,0.482730201543418,0.0393488343893049,0.203080001212599,0.757571164398096
13,"Mecklenburg-Vorpommern",13075006,"Bandelin",550,277,273,0.503636363636364,586,289,297,0.493174061433447,0.0393488343893049,0.203080001212599,0.757571164398096
13,"Mecklenburg-Vorpommern",13075007,"Bargischow",347,175,172,0.504322766570605,350,176,174,0.502857142857143,0.0393488343893049,0.203080001212599,0.757571164398096
13,"Mecklenburg-Vorpommern",13075008,"Behrenhoff",767,393,374,0.51238591916558,772,393,379,0.509067357512953,0.0393488343893049,0.203080001212599,0.757571164398096
13,"Mecklenburg-Vorpommern",13075009,"Bentzin",837,428,409,0.511350059737157,917,463,454,0.504907306434024,0.0393488343893049,0.203080001212599,0.757571164398096
13,"Mecklenburg-Vorpommern",13075010,"Benz",985,509,476,0.516751269035533,998,511,487,0.512024048096192,0.0393488343893049,0.203080001212599,0.757571164398096
13,"Mecklenburg-Vorpommern",13075011,"Bergholz",372,189,183,0.508064516129032,381,190,191,0.498687664041995,0.0393488343893049,0.203080001212599,0.757571164398096
13,"Mecklenburg-Vorpommern",13075012,"Blankensee",581,300,281,0.516351118760757,534,274,260,0.51310861423221,0.0393488343893049,0.203080001212599,0.757571164398096
13,"Mecklenburg-Vorpommern",13075013,"Blesewitz",259,136,123,0.525096525096525,267,137,130,0.51310861423221,0.0393488343893049,0.203080001212599,0.757571164398096
13,"Mecklenburg-Vorpommern",13075014,"Blumenhagen",355,185,170,0.52112676056338,362,195,167,0.538674033149171,0.0393488343893049,0.203080001212599,0.757571164398096
13,"Mecklenburg-Vorpommern",13075015,"Boldekow",502,262,240,0.52191235059761,526,270,256,0.513307984790874,0.0393488343893049,0.203080001212599,0.757571164398096
13,"Mecklenburg-Vorpommern",13075016,"Boock",597,309,288,0.517587939698492,595,300,295,0.504201680672269,0.0393488343893049,0.203080001212599,0.757571164398096
13,"Mecklenburg-Vorpommern",13075017,"Brietzig",199,107,92,0.537688442211055,204,110,94,0.53921568627451,0.0393488343893049,0.203080001212599,0.757571164398096
13,"Mecklenburg-Vorpommern",13075018,"Brünzow",616,320,296,0.519480519480519,646,326,320,0.504643962848297,0.0393488343893049,0.203080001212599,0.757571164398096
13,"Mecklenburg-Vorpommern",13075019,"Buddenhagen",440,221,219,0.502272727272727,427,212,215,0.496487119437939,0.0393488343893049,0.203080001212599,0.757571164398096
13,"Mecklenburg-Vorpommern",13075020,"Bugewitz",287,156,131,0.543554006968641,300,160,140,0.533333333333333,0.0393488343893049,0.203080001212599,0.757571164398096
13,"Mecklenburg-Vorpommern",13075021,"Buggenhagen",236,118,118,0.5,267,128,139,0.47940074906367,0.0393488343893049,0.203080001212599,0.757571164398096
13,"Mecklenburg-Vorpommern",13075022,"Butzow",440,218,222,0.495454545454545,438,216,222,0.493150684931507,0.0393488343893049,0.203080001212599,0.757571164398096
13,"Mecklenburg-Vorpommern",13075023,"Daberkow",355,186,169,0.523943661971831,358,187,171,0.522346368715084,0.0393488343893049,0.203080001212599,0.757571164398096
13,"Mecklenburg-Vorpommern",13075024,"Damerow",135,70,65,0.518518518518518,135,70,65,0.518518518518518,0.0393488343893049,0.203080001212599,0.757571164398096
13,"Mecklenburg-Vorpommern",13075025,"Dargelin",377,194,183,0.514588859416446,376,188,188,0.5,0.0393488343893049,0.203080001212599,0.757571164398096
13,"Mecklenburg-Vorpommern",13075026,"Dargen",532,266,266,0.5,527,260,267,0.493358633776091,0.0393488343893049,0.203080001212599,0.757571164398096
13,"Mecklenburg-Vorpommern",13075027,"Dersekow",1063,534,529,0.502351834430856,1076,536,540,0.49814126394052,0.0393488343893049,0.203080001212599,0.757571164398096
13,"Mecklenburg-Vorpommern",13075028,"Diedrichshagen",488,263,225,0.538934426229508,474,252,222,0.531645569620253,0.0393488343893049,0.203080001212599,0.757571164398096
13,"Mecklenburg-Vorpommern",13075029,"Ducherow",2558,1304,1254,0.509773260359656,2559,1313,1246,0.513091051191872,0.0393488343893049,0.203080001212599,0.757571164398096
13,"Mecklenburg-Vorpommern",13075030,"Düvier",460,256,204,0.556521739130435,510,285,225,0.558823529411765,0.0393488343893049,0.203080001212599,0.757571164398096
13,"Mecklenburg-Vorpommern",13075031,"Eggesin, Stadt",5033,2484,2549,0.493542618716471,5153,2556,2597,0.496021734911702,0.0393488343893049,0.203080001212599,0.757571164398096
13,"Mecklenburg-Vorpommern",13075032,"Fahrenwalde",332,173,159,0.521084337349398,347,177,170,0.510086455331412,0.0393488343893049,0.203080001212599,0.757571164398096
13,"Mecklenburg-Vorpommern",13075033,"Ferdinandshof",2757,1349,1408,0.489299963728691,2781,1368,1413,0.491909385113269,0.0393488343893049,0.203080001212599,0.757571164398096
13,"Mecklenburg-Vorpommern",13075034,"Garz",242,118,124,0.487603305785124,212,91,121,0.429245283018868,0.0393488343893049,0.203080001212599,0.757571164398096
13,"Mecklenburg-Vorpommern",13075035,"Glasow",176,101,75,0.573863636363636,161,92,69,0.571428571428571,0.0393488343893049,0.203080001212599,0.757571164398096
13,"Mecklenburg-Vorpommern",13075036,"Görmin",893,459,434,0.513997760358343,962,494,468,0.513513513513513,0.0393488343893049,0.203080001212599,0.757571164398096
13,"Mecklenburg-Vorpommern",13075037,"Grambin",434,219,215,0.504608294930876,444,225,219,0.506756756756757,0.0393488343893049,0.203080001212599,0.757571164398096
13,"Mecklenburg-Vorpommern",13075038,"Grambow",904,463,441,0.51216814159292,973,517,456,0.531346351490236,0.0393488343893049,0.203080001212599,0.757571164398096
13,"Mecklenburg-Vorpommern",13075039,"Greifswald, Hansestadt",55949,26632,29317,0.47600493306404,55051,26363,28688,0.478883217380247,0.0393488343893049,0.203080001212599,0.757571164398096
13,"Mecklenburg-Vorpommern",13075040,"Gribow",169,82,87,0.485207100591716,191,79,112,0.413612565445026,0.0393488343893049,0.203080001212599,0.757571164398096
13,"Mecklenburg-Vorpommern",13075041,"Groß Kiesow",1323,662,661,0.500377928949358,1379,682,697,0.494561276287165,0.0393488343893049,0.203080001212599,0.757571164398096
13,"Mecklenburg-Vorpommern",13075042,"Groß Luckow",214,117,97,0.546728971962617,207,115,92,0.555555555555556,0.0393488343893049,0.203080001212599,0.757571164398096
13,"Mecklenburg-Vorpommern",13075043,"Groß Polzin",423,224,199,0.529550827423168,439,235,204,0.535307517084282,0.0393488343893049,0.203080001212599,0.757571164398096
13,"Mecklenburg-Vorpommern",13075044,"Gützkow, Stadt",2836,1411,1425,0.4975317348378,2835,1425,1410,0.502645502645503,0.0393488343893049,0.203080001212599,0.757571164398096
13,"Mecklenburg-Vorpommern",13075045,"Hammer a.d. Uecker",491,250,241,0.509164969450102,496,256,240,0.516129032258065,0.0393488343893049,0.203080001212599,0.757571164398096
13,"Mecklenburg-Vorpommern",13075046,"Hanshagen",912,466,446,0.510964912280702,926,478,448,0.516198704103672,0.0393488343893049,0.203080001212599,0.757571164398096
13,"Mecklenburg-Vorpommern",13075047,"Heinrichsruh",252,119,133,0.472222222222222,247,118,129,0.477732793522267,0.0393488343893049,0.203080001212599,0.757571164398096
13,"Mecklenburg-Vorpommern",13075048,"Heinrichswalde",433,232,201,0.535796766743649,451,242,209,0.536585365853659,0.0393488343893049,0.203080001212599,0.757571164398096
13,"Mecklenburg-Vorpommern",13075049,"Heringsdorf",9018,4281,4737,0.474717232202262,9254,4404,4850,0.475902312513508,0.0393488343893049,0.203080001212599,0.757571164398096
13,"Mecklenburg-Vorpommern",13075050,"Hinrichshagen",837,431,406,0.514934289127838,828,425,403,0.513285024154589,0.0393488343893049,0.203080001212599,0.757571164398096
13,"Mecklenburg-Vorpommern",13075051,"Hintersee",332,168,164,0.506024096385542,353,178,175,0.504249291784703,0.0393488343893049,0.203080001212599,0.757571164398096
13,"Mecklenburg-Vorpommern",13075052,"Hohendorf",953,473,480,0.496327387198321,896,443,453,0.494419642857143,0.0393488343893049,0.203080001212599,0.757571164398096
13,"Mecklenburg-Vorpommern",13075053,"Iven",185,96,89,0.518918918918919,193,99,94,0.512953367875648,0.0393488343893049,0.203080001212599,0.757571164398096
13,"Mecklenburg-Vorpommern",13075054,"Jarmen, Stadt",3089,1530,1559,0.495305924247329,3147,1558,1589,0.495074674292977,0.0393488343893049,0.203080001212599,0.757571164398096
13,"Mecklenburg-Vorpommern",13075055,"Jatznick",1829,917,912,0.501366867140514,1839,931,908,0.506253398586188,0.0393488343893049,0.203080001212599,0.757571164398096
13,"Mecklenburg-Vorpommern",13075056,"Kamminke",281,142,139,0.505338078291815,280,141,139,0.503571428571429,0.0393488343893049,0.203080001212599,0.757571164398096
13,"Mecklenburg-Vorpommern",13075057,"Karlsburg",1315,652,663,0.495817490494297,1352,662,690,0.489644970414201,0.0393488343893049,0.203080001212599,0.757571164398096
13,"Mecklenburg-Vorpommern",13075058,"Karlshagen",3120,1498,1622,0.480128205128205,3124,1510,1614,0.483354673495519,0.0393488343893049,0.203080001212599,0.757571164398096
13,"Mecklenburg-Vorpommern",13075059,"Katzow",627,331,296,0.527910685805423,629,327,302,0.519872813990461,0.0393488343893049,0.203080001212599,0.757571164398096
13,"Mecklenburg-Vorpommern",13075060,"Kemnitz",1099,550,549,0.500454959053685,1133,569,564,0.502206531332745,0.0393488343893049,0.203080001212599,0.757571164398096
13,"Mecklenburg-Vorpommern",13075061,"Klein Bünzow",768,384,384,0.5,813,408,405,0.501845018450184,0.0393488343893049,0.203080001212599,0.757571164398096
13,"Mecklenburg-Vorpommern",13075062,"Klein Luckow",229,119,110,0.519650655021834,220,117,103,0.531818181818182,0.0393488343893049,0.203080001212599,0.757571164398096
13,"Mecklenburg-Vorpommern",13075063,"Koblentz",224,117,107,0.522321428571429,227,120,107,0.52863436123348,0.0393488343893049,0.203080001212599,0.757571164398096
13,"Mecklenburg-Vorpommern",13075064,"Kölzin",305,160,145,0.524590163934426,305,161,144,0.527868852459016,0.0393488343893049,0.203080001212599,0.757571164398096
13,"Mecklenburg-Vorpommern",13075065,"Korswandt",607,312,295,0.514003294892916,577,293,284,0.507798960138648,0.0393488343893049,0.203080001212599,0.757571164398096
13,"Mecklenburg-Vorpommern",13075066,"Koserow",1712,799,913,0.466705607476636,1674,797,877,0.47610513739546,0.0393488343893049,0.203080001212599,0.757571164398096
13,"Mecklenburg-Vorpommern",13075067,"Krackow",671,340,331,0.506706408345753,708,375,333,0.529661016949153,0.0393488343893049,0.203080001212599,0.757571164398096
13,"Mecklenburg-Vorpommern",13075068,"Krien",736,379,357,0.514945652173913,717,367,350,0.511854951185495,0.0393488343893049,0.203080001212599,0.757571164398096
13,"Mecklenburg-Vorpommern",13075069,"Kröslin",1780,891,889,0.500561797752809,1781,893,888,0.501403705783268,0.0393488343893049,0.203080001212599,0.757571164398096
13,"Mecklenburg-Vorpommern",13075070,"Kruckow",660,335,325,0.507575757575758,648,305,343,0.470679012345679,0.0393488343893049,0.203080001212599,0.757571164398096
13,"Mecklenburg-Vorpommern",13075071,"Krugsdorf",420,217,203,0.516666666666667,420,219,201,0.521428571428571,0.0393488343893049,0.203080001212599,0.757571164398096
13,"Mecklenburg-Vorpommern",13075072,"Krummin",240,127,113,0.529166666666667,237,121,116,0.510548523206751,0.0393488343893049,0.203080001212599,0.757571164398096
13,"Mecklenburg-Vorpommern",13075073,"Krusenfelde",184,91,93,0.494565217391304,178,87,91,0.48876404494382,0.0393488343893049,0.203080001212599,0.757571164398096
13,"Mecklenburg-Vorpommern",13075074,"Lassan, Stadt",1556,817,739,0.525064267352185,1568,824,744,0.525510204081633,0.0393488343893049,0.203080001212599,0.757571164398096
13,"Mecklenburg-Vorpommern",13075075,"Leopoldshagen",713,365,348,0.511921458625526,737,383,354,0.519674355495251,0.0393488343893049,0.203080001212599,0.757571164398096
13,"Mecklenburg-Vorpommern",13075076,"Levenhagen",402,212,190,0.527363184079602,395,210,185,0.531645569620253,0.0393488343893049,0.203080001212599,0.757571164398096
13,"Mecklenburg-Vorpommern",13075077,"Liepen",315,157,158,0.498412698412698,316,165,151,0.522151898734177,0.0393488343893049,0.203080001212599,0.757571164398096
13,"Mecklenburg-Vorpommern",13075078,"Liepgarten",781,405,376,0.518565941101152,806,414,392,0.513647642679901,0.0393488343893049,0.203080001212599,0.757571164398096
13,"Mecklenburg-Vorpommern",13075079,"Löcknitz",3093,1498,1595,0.484319430973165,3039,1482,1557,0.487660414610069,0.0393488343893049,0.203080001212599,0.757571164398096
13,"Mecklenburg-Vorpommern",13075080,"Loddin",1017,507,510,0.498525073746313,1053,522,531,0.495726495726496,0.0393488343893049,0.203080001212599,0.757571164398096
13,"Mecklenburg-Vorpommern",13075081,"Loissin",797,450,347,0.564617314930991,836,469,367,0.561004784688995,0.0393488343893049,0.203080001212599,0.757571164398096
13,"Mecklenburg-Vorpommern",13075082,"Loitz, Stadt",4122,1987,2135,0.482047549733139,4186,2022,2164,0.483038700430005,0.0393488343893049,0.203080001212599,0.757571164398096
13,"Mecklenburg-Vorpommern",13075083,"Lubmin",1983,994,989,0.501260716086737,2009,1028,981,0.511697361871578,0.0393488343893049,0.203080001212599,0.757571164398096
13,"Mecklenburg-Vorpommern",13075084,"Lübs",382,196,186,0.513089005235602,371,195,176,0.525606469002695,0.0393488343893049,0.203080001212599,0.757571164398096
13,"Mecklenburg-Vorpommern",13075085,"Luckow",631,320,311,0.507131537242472,641,319,322,0.497659906396256,0.0393488343893049,0.203080001212599,0.757571164398096
13,"Mecklenburg-Vorpommern",13075086,"Lühmannsdorf",693,359,334,0.518037518037518,706,366,340,0.518413597733711,0.0393488343893049,0.203080001212599,0.757571164398096
13,"Mecklenburg-Vorpommern",13075087,"Lütow",373,198,175,0.53083109919571,385,200,185,0.519480519480519,0.0393488343893049,0.203080001212599,0.757571164398096
13,"Mecklenburg-Vorpommern",13075088,"Medow",559,283,276,0.506261180679785,571,283,288,0.495621716287215,0.0393488343893049,0.203080001212599,0.757571164398096
13,"Mecklenburg-Vorpommern",13075089,"Meiersberg",414,211,203,0.509661835748792,428,216,212,0.504672897196262,0.0393488343893049,0.203080001212599,0.757571164398096
13,"Mecklenburg-Vorpommern",13075090,"Mellenthin",473,234,239,0.494714587737844,478,241,237,0.50418410041841,0.0393488343893049,0.203080001212599,0.757571164398096
13,"Mecklenburg-Vorpommern",13075091,"Mesekenhagen",1055,538,517,0.509952606635071,1018,512,506,0.502946954813359,0.0393488343893049,0.203080001212599,0.757571164398096
13,"Mecklenburg-Vorpommern",13075092,"Mölschow",790,403,387,0.510126582278481,796,407,389,0.511306532663317,0.0393488343893049,0.203080001212599,0.757571164398096
13,"Mecklenburg-Vorpommern",13075093,"Mönkebude",769,378,391,0.491547464239272,780,385,395,0.493589743589744,0.0393488343893049,0.203080001212599,0.757571164398096
13,"Mecklenburg-Vorpommern",13075094,"Murchin",818,413,405,0.504889975550122,867,424,443,0.489042675893887,0.0393488343893049,0.203080001212599,0.757571164398096
13,"Mecklenburg-Vorpommern",13075095,"Nadrensee",367,182,185,0.49591280653951,381,182,199,0.477690288713911,0.0393488343893049,0.203080001212599,0.757571164398096
13,"Mecklenburg-Vorpommern",13075096,"Neetzow",584,308,276,0.527397260273973,615,331,284,0.538211382113821,0.0393488343893049,0.203080001212599,0.757571164398096
13,"Mecklenburg-Vorpommern",13075097,"Neu Boltenhagen",620,311,309,0.501612903225806,639,316,323,0.49452269170579,0.0393488343893049,0.203080001212599,0.757571164398096
13,"Mecklenburg-Vorpommern",13075098,"Neu Kosenow",541,274,267,0.506469500924214,574,296,278,0.515679442508711,0.0393488343893049,0.203080001212599,0.757571164398096
13,"Mecklenburg-Vorpommern",13075099,"Neuendorf A",138,69,69,0.5,137,68,69,0.496350364963504,0.0393488343893049,0.203080001212599,0.757571164398096
13,"Mecklenburg-Vorpommern",13075100,"Neuendorf B",154,77,77,0.5,154,75,79,0.487012987012987,0.0393488343893049,0.203080001212599,0.757571164398096
13,"Mecklenburg-Vorpommern",13075101,"Neuenkirchen",254,128,126,0.503937007874016,284,142,142,0.5,0.0393488343893049,0.203080001212599,0.757571164398096
13,"Mecklenburg-Vorpommern",13075102,"Neuenkirchen",2300,1124,1176,0.488695652173913,2301,1126,1175,0.48935245545415,0.0393488343893049,0.203080001212599,0.757571164398096
13,"Mecklenburg-Vorpommern",13075103,"Nieden",179,91,88,0.508379888268156,171,87,84,0.508771929824561,0.0393488343893049,0.203080001212599,0.757571164398096
13,"Mecklenburg-Vorpommern",13075104,"Papendorf",243,121,122,0.497942386831276,230,113,117,0.491304347826087,0.0393488343893049,0.203080001212599,0.757571164398096
13,"Mecklenburg-Vorpommern",13075105,"Pasewalk, Stadt",10618,5045,5573,0.475136560557544,11219,5406,5813,0.48186112844282,0.0393488343893049,0.203080001212599,0.757571164398096
13,"Mecklenburg-Vorpommern",13075106,"Peenemünde",267,160,107,0.599250936329588,317,190,127,0.599369085173502,0.0393488343893049,0.203080001212599,0.757571164398096
13,"Mecklenburg-Vorpommern",13075107,"Penkun, Stadt",1938,988,950,0.509803921568627,1944,995,949,0.511831275720165,0.0393488343893049,0.203080001212599,0.757571164398096
13,"Mecklenburg-Vorpommern",13075108,"Plöwen",299,151,148,0.505016722408027,314,165,149,0.525477707006369,0.0393488343893049,0.203080001212599,0.757571164398096
13,"Mecklenburg-Vorpommern",13075109,"Polzow",252,124,128,0.492063492063492,251,129,122,0.51394422310757,0.0393488343893049,0.203080001212599,0.757571164398096
13,"Mecklenburg-Vorpommern",13075110,"Postlow",341,172,169,0.504398826979472,362,182,180,0.502762430939227,0.0393488343893049,0.203080001212599,0.757571164398096
13,"Mecklenburg-Vorpommern",13075111,"Pudagla",431,219,212,0.508120649651972,435,219,216,0.503448275862069,0.0393488343893049,0.203080001212599,0.757571164398096
13,"Mecklenburg-Vorpommern",13075112,"Putzar",202,101,101,0.5,203,98,105,0.482758620689655,0.0393488343893049,0.203080001212599,0.757571164398096
13,"Mecklenburg-Vorpommern",13075113,"Ramin",689,356,333,0.516690856313498,734,371,363,0.505449591280654,0.0393488343893049,0.203080001212599,0.757571164398096
13,"Mecklenburg-Vorpommern",13075114,"Rankwitz",626,329,297,0.52555910543131,629,330,299,0.524642289348172,0.0393488343893049,0.203080001212599,0.757571164398096
13,"Mecklenburg-Vorpommern",13075115,"Rollwitz",596,301,295,0.50503355704698,618,310,308,0.501618122977346,0.0393488343893049,0.203080001212599,0.757571164398096
13,"Mecklenburg-Vorpommern",13075116,"Rossin",164,87,77,0.530487804878049,152,78,74,0.513157894736842,0.0393488343893049,0.203080001212599,0.757571164398096
13,"Mecklenburg-Vorpommern",13075117,"Rossow",448,221,227,0.493303571428571,452,213,239,0.471238938053097,0.0393488343893049,0.203080001212599,0.757571164398096
13,"Mecklenburg-Vorpommern",13075118,"Rothemühl",313,157,156,0.501597444089457,310,158,152,0.509677419354839,0.0393488343893049,0.203080001212599,0.757571164398096
13,"Mecklenburg-Vorpommern",13075119,"Rothenklempenow",638,328,310,0.5141065830721,647,341,306,0.527047913446677,0.0393488343893049,0.203080001212599,0.757571164398096
13,"Mecklenburg-Vorpommern",13075120,"Rubenow",810,426,384,0.525925925925926,816,431,385,0.528186274509804,0.0393488343893049,0.203080001212599,0.757571164398096
13,"Mecklenburg-Vorpommern",13075121,"Rubkow",678,353,325,0.520648967551622,675,348,327,0.515555555555556,0.0393488343893049,0.203080001212599,0.757571164398096
13,"Mecklenburg-Vorpommern",13075122,"Sarnow",441,222,219,0.503401360544218,452,237,215,0.524336283185841,0.0393488343893049,0.203080001212599,0.757571164398096
13,"Mecklenburg-Vorpommern",13075123,"Sassen-Trantow",889,446,443,0.501687289088864,902,464,438,0.514412416851441,0.0393488343893049,0.203080001212599,0.757571164398096
13,"Mecklenburg-Vorpommern",13075124,"Sauzin",421,204,217,0.484560570071259,421,205,216,0.486935866983373,0.0393488343893049,0.203080001212599,0.757571164398096
13,"Mecklenburg-Vorpommern",13075125,"Schmatzin",311,169,142,0.543408360128617,304,159,145,0.523026315789474,0.0393488343893049,0.203080001212599,0.757571164398096
13,"Mecklenburg-Vorpommern",13075126,"Schönwalde",479,247,232,0.515657620041754,465,233,232,0.501075268817204,0.0393488343893049,0.203080001212599,0.757571164398096
13,"Mecklenburg-Vorpommern",13075127,"Spantekow",1134,557,577,0.491181657848325,1115,555,560,0.497757847533632,0.0393488343893049,0.203080001212599,0.757571164398096
13,"Mecklenburg-Vorpommern",13075128,"Stolpe",345,181,164,0.52463768115942,345,184,161,0.533333333333333,0.0393488343893049,0.203080001212599,0.757571164398096
13,"Mecklenburg-Vorpommern",13075129,"Stolpe auf Usedom",375,199,176,0.530666666666667,372,194,178,0.521505376344086,0.0393488343893049,0.203080001212599,0.757571164398096
13,"Mecklenburg-Vorpommern",13075130,"Strasburg (Uckermark), Stadt",5255,2530,2725,0.481446241674596,5303,2525,2778,0.476145577974731,0.0393488343893049,0.203080001212599,0.757571164398096
13,"Mecklenburg-Vorpommern",13075131,"Torgelow, Stadt",8850,4390,4460,0.496045197740113,9130,4566,4564,0.500109529025192,0.0393488343893049,0.203080001212599,0.757571164398096
13,"Mecklenburg-Vorpommern",13075132,"Torgelow-Holländerei",409,210,199,0.513447432762836,414,221,193,0.533816425120773,0.0393488343893049,0.203080001212599,0.757571164398096
13,"Mecklenburg-Vorpommern",13075133,"Trassenheide",879,429,450,0.488054607508532,914,450,464,0.492341356673961,0.0393488343893049,0.203080001212599,0.757571164398096
13,"Mecklenburg-Vorpommern",13075134,"Tutow",1255,625,630,0.49800796812749,1205,613,592,0.508713692946058,0.0393488343893049,0.203080001212599,0.757571164398096
13,"Mecklenburg-Vorpommern",13075135,"Ückeritz",999,487,512,0.487487487487487,1006,502,504,0.499005964214712,0.0393488343893049,0.203080001212599,0.757571164398096
13,"Mecklenburg-Vorpommern",13075136,"Ueckermünde, Stadt",9026,4424,4602,0.490139596720585,9872,5042,4830,0.510737439222042,0.0393488343893049,0.203080001212599,0.757571164398096
13,"Mecklenburg-Vorpommern",13075137,"Usedom, Stadt",1851,916,935,0.494867639113992,1854,930,924,0.501618122977346,0.0393488343893049,0.203080001212599,0.757571164398096
13,"Mecklenburg-Vorpommern",13075138,"Viereck",1220,650,570,0.532786885245902,1242,664,578,0.534621578099839,0.0393488343893049,0.203080001212599,0.757571164398096
13,"Mecklenburg-Vorpommern",13075139,"Vogelsang-Warsin",344,180,164,0.523255813953488,363,181,182,0.49862258953168,0.0393488343893049,0.203080001212599,0.757571164398096
13,"Mecklenburg-Vorpommern",13075140,"Völschow",512,269,243,0.525390625,493,255,238,0.517241379310345,0.0393488343893049,0.203080001212599,0.757571164398096
13,"Mecklenburg-Vorpommern",13075141,"Wackerow",1372,697,675,0.50801749271137,1383,692,691,0.500361532899494,0.0393488343893049,0.203080001212599,0.757571164398096
13,"Mecklenburg-Vorpommern",13075142,"Weitenhagen",1508,777,731,0.51525198938992,1519,781,738,0.514154048716261,0.0393488343893049,0.203080001212599,0.757571164398096
13,"Mecklenburg-Vorpommern",13075143,"Wilhelmsburg",831,447,384,0.537906137184116,838,431,407,0.514319809069212,0.0393488343893049,0.203080001212599,0.757571164398096
13,"Mecklenburg-Vorpommern",13075144,"Wolgast, Stadt",11115,5384,5731,0.484390463337832,11849,5820,6029,0.491180690353616,0.0393488343893049,0.203080001212599,0.757571164398096
13,"Mecklenburg-Vorpommern",13075145,"Wrangelsburg",207,103,104,0.497584541062802,202,95,107,0.47029702970297,0.0393488343893049,0.203080001212599,0.757571164398096
13,"Mecklenburg-Vorpommern",13075146,"Wusterhusen",1221,616,605,0.504504504504504,1238,618,620,0.499192245557351,0.0393488343893049,0.203080001212599,0.757571164398096
13,"Mecklenburg-Vorpommern",13075147,"Zemitz",738,377,361,0.510840108401084,806,416,390,0.516129032258065,0.0393488343893049,0.203080001212599,0.757571164398096
13,"Mecklenburg-Vorpommern",13075148,"Zempin",944,452,492,0.478813559322034,933,448,485,0.480171489817792,0.0393488343893049,0.203080001212599,0.757571164398096
13,"Mecklenburg-Vorpommern",13075149,"Zerrenthin",481,235,246,0.488565488565489,478,234,244,0.489539748953975,0.0393488343893049,0.203080001212599,0.757571164398096
13,"Mecklenburg-Vorpommern",13075150,"Ziethen",492,264,228,0.536585365853659,423,231,192,0.546099290780142,0.0393488343893049,0.203080001212599,0.757571164398096
13,"Mecklenburg-Vorpommern",13075151,"Zinnowitz",3919,1879,2040,0.479459045674917,3745,1771,1974,0.472897196261682,0.0393488343893049,0.203080001212599,0.757571164398096
13,"Mecklenburg-Vorpommern",13075152,"Zirchow",593,311,282,0.524451939291737,594,321,273,0.54040404040404,0.0393488343893049,0.203080001212599,0.757571164398096
13,"Mecklenburg-Vorpommern",13075153,"Züsedom",241,120,121,0.49792531120332,243,126,117,0.518518518518518,0.0393488343893049,0.203080001212599,0.757571164398096
13,"Mecklenburg-Vorpommern",13075154,"Züssow",1410,733,677,0.519858156028369,1395,723,672,0.518279569892473,0.0393488343893049,0.203080001212599,0.757571164398096
13,"Mecklenburg-Vorpommern",13076001,"Alt Krenzlin",776,368,408,0.474226804123711,808,389,419,0.481435643564356,0.0393488343893049,0.203080001212599,0.757571164398096
13,"Mecklenburg-Vorpommern",13076002,"Alt Zachun",370,192,178,0.518918918918919,366,188,178,0.513661202185792,0.0393488343893049,0.203080001212599,0.757571164398096
13,"Mecklenburg-Vorpommern",13076003,"Balow",331,158,173,0.477341389728097,316,147,169,0.465189873417722,0.0393488343893049,0.203080001212599,0.757571164398096
13,"Mecklenburg-Vorpommern",13076004,"Bandenitz",469,241,228,0.513859275053305,481,245,236,0.509355509355509,0.0393488343893049,0.203080001212599,0.757571164398096
13,"Mecklenburg-Vorpommern",13076005,"Banzkow",2776,1388,1388,0.5,2743,1383,1360,0.504192489974481,0.0393488343893049,0.203080001212599,0.757571164398096
13,"Mecklenburg-Vorpommern",13076006,"Barkhagen",629,310,319,0.492845786963434,582,286,296,0.491408934707904,0.0393488343893049,0.203080001212599,0.757571164398096
13,"Mecklenburg-Vorpommern",13076007,"Barnin",463,238,225,0.514038876889849,470,235,235,0.5,0.0393488343893049,0.203080001212599,0.757571164398096
13,"Mecklenburg-Vorpommern",13076008,"Belsch",221,111,110,0.502262443438914,233,118,115,0.506437768240343,0.0393488343893049,0.203080001212599,0.757571164398096
13,"Mecklenburg-Vorpommern",13076009,"Bengerstorf",567,281,286,0.495590828924162,604,300,304,0.496688741721854,0.0393488343893049,0.203080001212599,0.757571164398096
13,"Mecklenburg-Vorpommern",13076010,"Besitz",449,237,212,0.527839643652561,457,248,209,0.542669584245077,0.0393488343893049,0.203080001212599,0.757571164398096
13,"Mecklenburg-Vorpommern",13076011,"Blankenberg",419,223,196,0.532219570405728,425,221,204,0.52,0.0393488343893049,0.203080001212599,0.757571164398096
13,"Mecklenburg-Vorpommern",13076012,"Blievenstorf",440,213,227,0.484090909090909,444,207,237,0.466216216216216,0.0393488343893049,0.203080001212599,0.757571164398096
13,"Mecklenburg-Vorpommern",13076013,"Bobzin",255,136,119,0.533333333333333,264,143,121,0.541666666666667,0.0393488343893049,0.203080001212599,0.757571164398096
13,"Mecklenburg-Vorpommern",13076014,"Boizenburg/ Elbe, Stadt",10196,4994,5202,0.489799921537858,10595,5253,5342,0.495799905615857,0.0393488343893049,0.203080001212599,0.757571164398096
13,"Mecklenburg-Vorpommern",13076015,"Borkow",470,246,224,0.523404255319149,481,250,231,0.51975051975052,0.0393488343893049,0.203080001212599,0.757571164398096
13,"Mecklenburg-Vorpommern",13076016,"Brahlstorf",718,366,352,0.50974930362117,704,351,353,0.498579545454545,0.0393488343893049,0.203080001212599,0.757571164398096
13,"Mecklenburg-Vorpommern",13076017,"Brenz",515,263,252,0.510679611650485,537,271,266,0.504655493482309,0.0393488343893049,0.203080001212599,0.757571164398096
13,"Mecklenburg-Vorpommern",13076018,"Bresegard bei Eldena",226,110,116,0.486725663716814,231,114,117,0.493506493506494,0.0393488343893049,0.203080001212599,0.757571164398096
13,"Mecklenburg-Vorpommern",13076019,"Bresegard bei Picher",307,148,159,0.482084690553746,316,148,168,0.468354430379747,0.0393488343893049,0.203080001212599,0.757571164398096
13,"Mecklenburg-Vorpommern",13076020,"Brüel, Stadt",2744,1349,1395,0.491618075801749,2731,1334,1397,0.488465763456609,0.0393488343893049,0.203080001212599,0.757571164398096
13,"Mecklenburg-Vorpommern",13076021,"Brunow",335,164,171,0.48955223880597,341,165,176,0.483870967741935,0.0393488343893049,0.203080001212599,0.757571164398096
13,"Mecklenburg-Vorpommern",13076022,"Buchberg",514,257,257,0.5,537,267,270,0.497206703910615,0.0393488343893049,0.203080001212599,0.757571164398096
13,"Mecklenburg-Vorpommern",13076023,"Bülow",358,187,171,0.522346368715084,348,182,166,0.522988505747126,0.0393488343893049,0.203080001212599,0.757571164398096
13,"Mecklenburg-Vorpommern",13076024,"Cambs",638,333,305,0.521943573667712,672,342,330,0.508928571428571,0.0393488343893049,0.203080001212599,0.757571164398096
13,"Mecklenburg-Vorpommern",13076025,"Crivitz, Stadt",5091,2457,2634,0.482616381850324,5111,2458,2653,0.48092349833692,0.0393488343893049,0.203080001212599,0.757571164398096
13,"Mecklenburg-Vorpommern",13076026,"Dabel",1470,734,736,0.499319727891156,1428,743,685,0.5203081232493,0.0393488343893049,0.203080001212599,0.757571164398096
13,"Mecklenburg-Vorpommern",13076027,"Dambeck",300,157,143,0.523333333333333,284,150,134,0.528169014084507,0.0393488343893049,0.203080001212599,0.757571164398096
13,"Mecklenburg-Vorpommern",13076028,"Damm",506,259,247,0.511857707509881,505,258,247,0.510891089108911,0.0393488343893049,0.203080001212599,0.757571164398096
13,"Mecklenburg-Vorpommern",13076029,"Demen",949,503,446,0.530031612223393,969,523,446,0.539731682146543,0.0393488343893049,0.203080001212599,0.757571164398096
13,"Mecklenburg-Vorpommern",13076030,"Dersenow",454,237,217,0.522026431718062,470,249,221,0.529787234042553,0.0393488343893049,0.203080001212599,0.757571164398096
13,"Mecklenburg-Vorpommern",13076031,"Diestelow",460,236,224,0.51304347826087,450,234,216,0.52,0.0393488343893049,0.203080001212599,0.757571164398096
13,"Mecklenburg-Vorpommern",13076032,"Dobbertin",1146,619,527,0.540139616055846,1218,666,552,0.54679802955665,0.0393488343893049,0.203080001212599,0.757571164398096
13,"Mecklenburg-Vorpommern",13076033,"Dobin am See",1910,962,948,0.503664921465969,1979,992,987,0.501263264274886,0.0393488343893049,0.203080001212599,0.757571164398096
13,"Mecklenburg-Vorpommern",13076034,"Dömitz, Stadt",3072,1491,1581,0.4853515625,3121,1533,1588,0.491188721563601,0.0393488343893049,0.203080001212599,0.757571164398096
13,"Mecklenburg-Vorpommern",13076035,"Domsühl",1000,507,493,0.507,1027,539,488,0.524829600778968,0.0393488343893049,0.203080001212599,0.757571164398096
13,"Mecklenburg-Vorpommern",13076036,"Dümmer",1438,725,713,0.504172461752434,1375,692,683,0.503272727272727,0.0393488343893049,0.203080001212599,0.757571164398096
13,"Mecklenburg-Vorpommern",13076037,"Eldena",1240,626,614,0.504838709677419,1231,626,605,0.508529650690495,0.0393488343893049,0.203080001212599,0.757571164398096
13,"Mecklenburg-Vorpommern",13076038,"Friedrichsruhe",899,449,450,0.49944382647386,893,439,454,0.491601343784994,0.0393488343893049,0.203080001212599,0.757571164398096
13,"Mecklenburg-Vorpommern",13076039,"Gallin",514,260,254,0.505836575875486,493,251,242,0.509127789046653,0.0393488343893049,0.203080001212599,0.757571164398096
13,"Mecklenburg-Vorpommern",13076040,"Gallin-Kuppentin",499,253,246,0.507014028056112,534,268,266,0.50187265917603,0.0393488343893049,0.203080001212599,0.757571164398096
13,"Mecklenburg-Vorpommern",13076041,"Gammelin",466,239,227,0.512875536480687,487,250,237,0.513347022587269,0.0393488343893049,0.203080001212599,0.757571164398096
13,"Mecklenburg-Vorpommern",13076042,"Ganzlin",526,260,266,0.494296577946768,529,262,267,0.495274102079395,0.0393488343893049,0.203080001212599,0.757571164398096
13,"Mecklenburg-Vorpommern",13076043,"Gischow",265,145,120,0.547169811320755,274,156,118,0.569343065693431,0.0393488343893049,0.203080001212599,0.757571164398096
13,"Mecklenburg-Vorpommern",13076044,"Gneven",379,194,185,0.511873350923483,398,203,195,0.510050251256281,0.0393488343893049,0.203080001212599,0.757571164398096
13,"Mecklenburg-Vorpommern",13076045,"Godern",341,177,164,0.519061583577713,336,170,166,0.505952380952381,0.0393488343893049,0.203080001212599,0.757571164398096
13,"Mecklenburg-Vorpommern",13076046,"Göhlen",352,186,166,0.528409090909091,344,182,162,0.529069767441861,0.0393488343893049,0.203080001212599,0.757571164398096
13,"Mecklenburg-Vorpommern",13076048,"Goldberg, Stadt",3149,1513,1636,0.480469990473166,3209,1551,1658,0.483328139607354,0.0393488343893049,0.203080001212599,0.757571164398096
13,"Mecklenburg-Vorpommern",13076049,"Gorlosen",518,257,261,0.496138996138996,525,263,262,0.500952380952381,0.0393488343893049,0.203080001212599,0.757571164398096
13,"Mecklenburg-Vorpommern",13076050,"Grabow, Stadt",5773,2802,2971,0.485362896241122,5807,2826,2981,0.486654038229723,0.0393488343893049,0.203080001212599,0.757571164398096
13,"Mecklenburg-Vorpommern",13076051,"Granzin",490,247,243,0.504081632653061,485,253,232,0.521649484536083,0.0393488343893049,0.203080001212599,0.757571164398096
13,"Mecklenburg-Vorpommern",13076052,"Grebbin",510,263,247,0.515686274509804,492,262,230,0.532520325203252,0.0393488343893049,0.203080001212599,0.757571164398096
13,"Mecklenburg-Vorpommern",13076053,"Grebs-Niendorf",577,290,287,0.502599653379549,662,333,329,0.503021148036254,0.0393488343893049,0.203080001212599,0.757571164398096
13,"Mecklenburg-Vorpommern",13076054,"Gresse",655,341,314,0.520610687022901,628,323,305,0.514331210191083,0.0393488343893049,0.203080001212599,0.757571164398096
13,"Mecklenburg-Vorpommern",13076055,"Greven",695,347,348,0.499280575539568,824,454,370,0.550970873786408,0.0393488343893049,0.203080001212599,0.757571164398096
13,"Mecklenburg-Vorpommern",13076056,"Groß Godems",405,200,205,0.493827160493827,399,198,201,0.496240601503759,0.0393488343893049,0.203080001212599,0.757571164398096
13,"Mecklenburg-Vorpommern",13076057,"Groß Krams",178,90,88,0.50561797752809,181,92,89,0.50828729281768,0.0393488343893049,0.203080001212599,0.757571164398096
13,"Mecklenburg-Vorpommern",13076058,"Groß Laasch",971,490,481,0.504634397528321,983,495,488,0.503560528992879,0.0393488343893049,0.203080001212599,0.757571164398096
13,"Mecklenburg-Vorpommern",13076059,"Groß Niendorf",221,116,105,0.524886877828054,226,115,111,0.508849557522124,0.0393488343893049,0.203080001212599,0.757571164398096
13,"Mecklenburg-Vorpommern",13076060,"Hagenow, Stadt",11356,5595,5761,0.492691088411412,11692,5739,5953,0.490848443380089,0.0393488343893049,0.203080001212599,0.757571164398096
13,"Mecklenburg-Vorpommern",13076061,"Herzberg",309,161,148,0.521035598705502,316,172,144,0.544303797468354,0.0393488343893049,0.203080001212599,0.757571164398096
13,"Mecklenburg-Vorpommern",13076062,"Hohen Pritz",383,194,189,0.506527415143603,455,243,212,0.534065934065934,0.0393488343893049,0.203080001212599,0.757571164398096
13,"Mecklenburg-Vorpommern",13076063,"Holthusen",871,455,416,0.522388059701492,851,431,420,0.506462984723854,0.0393488343893049,0.203080001212599,0.757571164398096
13,"Mecklenburg-Vorpommern",13076064,"Hoort",556,283,273,0.508992805755396,576,292,284,0.506944444444444,0.0393488343893049,0.203080001212599,0.757571164398096
13,"Mecklenburg-Vorpommern",13076065,"Hülseburg",165,94,71,0.56969696969697,171,95,76,0.555555555555556,0.0393488343893049,0.203080001212599,0.757571164398096
13,"Mecklenburg-Vorpommern",13076066,"Karbow-Vietlübbe",350,182,168,0.52,369,198,171,0.536585365853659,0.0393488343893049,0.203080001212599,0.757571164398096
13,"Mecklenburg-Vorpommern",13076067,"Karenz",258,125,133,0.484496124031008,277,137,140,0.494584837545126,0.0393488343893049,0.203080001212599,0.757571164398096
13,"Mecklenburg-Vorpommern",13076068,"Karrenzin",596,300,296,0.503355704697987,618,311,307,0.503236245954693,0.0393488343893049,0.203080001212599,0.757571164398096
13,"Mecklenburg-Vorpommern",13076069,"Karstädt",599,318,281,0.530884808013356,573,302,271,0.527050610820244,0.0393488343893049,0.203080001212599,0.757571164398096
13,"Mecklenburg-Vorpommern",13076070,"Kirch Jesar",628,330,298,0.525477707006369,639,338,301,0.528951486697966,0.0393488343893049,0.203080001212599,0.757571164398096
13,"Mecklenburg-Vorpommern",13076071,"Klein Rogahn",1320,649,671,0.491666666666667,1272,616,656,0.484276729559748,0.0393488343893049,0.203080001212599,0.757571164398096
13,"Mecklenburg-Vorpommern",13076072,"Kobrow",428,235,193,0.549065420560748,441,252,189,0.571428571428571,0.0393488343893049,0.203080001212599,0.757571164398096
13,"Mecklenburg-Vorpommern",13076073,"Kogel",646,331,315,0.512383900928793,603,310,293,0.514096185737977,0.0393488343893049,0.203080001212599,0.757571164398096
13,"Mecklenburg-Vorpommern",13076074,"Körchow",796,414,382,0.520100502512563,819,431,388,0.526251526251526,0.0393488343893049,0.203080001212599,0.757571164398096
13,"Mecklenburg-Vorpommern",13076075,"Kreien",411,216,195,0.525547445255474,409,222,187,0.54278728606357,0.0393488343893049,0.203080001212599,0.757571164398096
13,"Mecklenburg-Vorpommern",13076076,"Kremmin",245,128,117,0.522448979591837,241,129,112,0.535269709543568,0.0393488343893049,0.203080001212599,0.757571164398096
13,"Mecklenburg-Vorpommern",13076077,"Kritzow",463,247,216,0.533477321814255,496,265,231,0.534274193548387,0.0393488343893049,0.203080001212599,0.757571164398096
13,"Mecklenburg-Vorpommern",13076078,"Kuhlen-Wendorf",870,455,415,0.522988505747126,922,477,445,0.517353579175705,0.0393488343893049,0.203080001212599,0.757571164398096
13,"Mecklenburg-Vorpommern",13076079,"Kuhstorf",766,400,366,0.522193211488251,782,408,374,0.521739130434783,0.0393488343893049,0.203080001212599,0.757571164398096
13,"Mecklenburg-Vorpommern",13076080,"Langen Brütz",483,245,238,0.507246376811594,473,237,236,0.501057082452431,0.0393488343893049,0.203080001212599,0.757571164398096
13,"Mecklenburg-Vorpommern",13076081,"Langen Jarchow",250,130,120,0.52,260,138,122,0.530769230769231,0.0393488343893049,0.203080001212599,0.757571164398096
13,"Mecklenburg-Vorpommern",13076082,"Leezen",2178,1092,1086,0.50137741046832,2172,1106,1066,0.509208103130755,0.0393488343893049,0.203080001212599,0.757571164398096
13,"Mecklenburg-Vorpommern",13076083,"Lehsen",351,178,173,0.507122507122507,358,182,176,0.508379888268156,0.0393488343893049,0.203080001212599,0.757571164398096
13,"Mecklenburg-Vorpommern",13076084,"Leussow",279,141,138,0.505376344086022,268,133,135,0.496268656716418,0.0393488343893049,0.203080001212599,0.757571164398096
13,"Mecklenburg-Vorpommern",13076085,"Lewitzrand",1469,725,744,0.493533015656909,1511,739,772,0.489080079417604,0.0393488343893049,0.203080001212599,0.757571164398096
13,"Mecklenburg-Vorpommern",13076086,"Lübesse",707,364,343,0.514851485148515,739,384,355,0.519621109607578,0.0393488343893049,0.203080001212599,0.757571164398096
13,"Mecklenburg-Vorpommern",13076087,"Lüblow",598,307,291,0.513377926421405,605,313,292,0.517355371900826,0.0393488343893049,0.203080001212599,0.757571164398096
13,"Mecklenburg-Vorpommern",13076088,"Lübtheen, Stadt",4614,2286,2328,0.495448634590377,4518,2241,2277,0.49601593625498,0.0393488343893049,0.203080001212599,0.757571164398096
13,"Mecklenburg-Vorpommern",13076089,"Lübz, Stadt",6083,2928,3155,0.48134144336676,6104,2928,3176,0.479685452162516,0.0393488343893049,0.203080001212599,0.757571164398096
13,"Mecklenburg-Vorpommern",13076090,"Ludwigslust, Stadt",11984,5728,6256,0.477970627503338,12375,5997,6378,0.484606060606061,0.0393488343893049,0.203080001212599,0.757571164398096
13,"Mecklenburg-Vorpommern",13076091,"Lutheran",312,154,158,0.493589743589744,303,147,156,0.485148514851485,0.0393488343893049,0.203080001212599,0.757571164398096
13,"Mecklenburg-Vorpommern",13076092,"Lüttow-Valluhn",799,408,391,0.51063829787234,808,406,402,0.502475247524752,0.0393488343893049,0.203080001212599,0.757571164398096
13,"Mecklenburg-Vorpommern",13076093,"Malk Göhren",460,246,214,0.534782608695652,487,264,223,0.542094455852156,0.0393488343893049,0.203080001212599,0.757571164398096
13,"Mecklenburg-Vorpommern",13076094,"Malliß",1218,634,584,0.520525451559934,1270,648,622,0.510236220472441,0.0393488343893049,0.203080001212599,0.757571164398096
13,"Mecklenburg-Vorpommern",13076095,"Marnitz",790,385,405,0.487341772151899,766,366,400,0.477806788511749,0.0393488343893049,0.203080001212599,0.757571164398096
13,"Mecklenburg-Vorpommern",13076096,"Mestlin",766,386,380,0.503916449086162,801,411,390,0.51310861423221,0.0393488343893049,0.203080001212599,0.757571164398096
13,"Mecklenburg-Vorpommern",13076097,"Milow",400,196,204,0.49,415,207,208,0.498795180722892,0.0393488343893049,0.203080001212599,0.757571164398096
13,"Mecklenburg-Vorpommern",13076098,"Möllenbeck",210,111,99,0.528571428571429,217,114,103,0.525345622119816,0.0393488343893049,0.203080001212599,0.757571164398096
13,"Mecklenburg-Vorpommern",13076099,"Moraas",475,247,228,0.52,470,246,224,0.523404255319149,0.0393488343893049,0.203080001212599,0.757571164398096
13,"Mecklenburg-Vorpommern",13076100,"Muchow",321,155,166,0.482866043613707,337,167,170,0.495548961424332,0.0393488343893049,0.203080001212599,0.757571164398096
13,"Mecklenburg-Vorpommern",13076101,"Mustin",410,208,202,0.507317073170732,436,211,225,0.48394495412844,0.0393488343893049,0.203080001212599,0.757571164398096
13,"Mecklenburg-Vorpommern",13076102,"Neu Gülze",786,413,373,0.525445292620865,796,416,380,0.522613065326633,0.0393488343893049,0.203080001212599,0.757571164398096
13,"Mecklenburg-Vorpommern",13076103,"Neu Kaliß",1982,987,995,0.497981836528759,1911,961,950,0.502878074306646,0.0393488343893049,0.203080001212599,0.757571164398096
13,"Mecklenburg-Vorpommern",13076104,"Neu Poserin",546,279,267,0.510989010989011,545,279,266,0.511926605504587,0.0393488343893049,0.203080001212599,0.757571164398096
13,"Mecklenburg-Vorpommern",13076105,"Neustadt-Glewe, Stadt",6483,3265,3218,0.503624865031621,6497,3300,3197,0.507926735416346,0.0393488343893049,0.203080001212599,0.757571164398096
13,"Mecklenburg-Vorpommern",13076106,"Nostorf",909,533,376,0.586358635863586,866,470,396,0.542725173210162,0.0393488343893049,0.203080001212599,0.757571164398096
13,"Mecklenburg-Vorpommern",13076107,"Pampow",2925,1441,1484,0.492649572649573,2816,1406,1410,0.499289772727273,0.0393488343893049,0.203080001212599,0.757571164398096
13,"Mecklenburg-Vorpommern",13076108,"Parchim, Stadt",17336,8282,9054,0.477734194739271,18242,8868,9374,0.486130906698827,0.0393488343893049,0.203080001212599,0.757571164398096
13,"Mecklenburg-Vorpommern",13076109,"Passow",679,351,328,0.516936671575847,695,356,339,0.512230215827338,0.0393488343893049,0.203080001212599,0.757571164398096
13,"Mecklenburg-Vorpommern",13076110,"Pätow-Steegen",373,191,182,0.512064343163539,381,193,188,0.506561679790026,0.0393488343893049,0.203080001212599,0.757571164398096
13,"Mecklenburg-Vorpommern",13076111,"Picher",655,308,347,0.470229007633588,667,302,365,0.452773613193403,0.0393488343893049,0.203080001212599,0.757571164398096
13,"Mecklenburg-Vorpommern",13076112,"Pinnow",1594,790,804,0.495608531994981,1577,782,795,0.495878249841471,0.0393488343893049,0.203080001212599,0.757571164398096
13,"Mecklenburg-Vorpommern",13076113,"Plate",3360,1689,1671,0.502678571428571,3376,1696,1680,0.502369668246445,0.0393488343893049,0.203080001212599,0.757571164398096
13,"Mecklenburg-Vorpommern",13076114,"Plau am See, Stadt",6152,2974,3178,0.483420026007802,6331,3133,3198,0.494866529774127,0.0393488343893049,0.203080001212599,0.757571164398096
13,"Mecklenburg-Vorpommern",13076115,"Prislich",710,361,349,0.508450704225352,735,375,360,0.510204081632653,0.0393488343893049,0.203080001212599,0.757571164398096
13,"Mecklenburg-Vorpommern",13076116,"Pritzier",440,224,216,0.509090909090909,441,230,211,0.521541950113379,0.0393488343893049,0.203080001212599,0.757571164398096
13,"Mecklenburg-Vorpommern",13076117,"Raben Steinfeld",1062,512,550,0.48210922787194,1080,529,551,0.489814814814815,0.0393488343893049,0.203080001212599,0.757571164398096
13,"Mecklenburg-Vorpommern",13076118,"Rastow",1895,947,948,0.499736147757256,1917,954,963,0.497652582159624,0.0393488343893049,0.203080001212599,0.757571164398096
13,"Mecklenburg-Vorpommern",13076119,"Redefin",540,281,259,0.52037037037037,552,288,264,0.521739130434783,0.0393488343893049,0.203080001212599,0.757571164398096
13,"Mecklenburg-Vorpommern",13076120,"Rom",821,428,393,0.521315468940317,832,437,395,0.525240384615385,0.0393488343893049,0.203080001212599,0.757571164398096
13,"Mecklenburg-Vorpommern",13076121,"Schossin",242,128,114,0.528925619834711,253,131,122,0.517786561264822,0.0393488343893049,0.203080001212599,0.757571164398096
13,"Mecklenburg-Vorpommern",13076122,"Schwanheide",706,351,355,0.497167138810198,733,365,368,0.497953615279673,0.0393488343893049,0.203080001212599,0.757571164398096
13,"Mecklenburg-Vorpommern",13076123,"Setzin",483,245,238,0.507246376811594,502,248,254,0.49402390438247,0.0393488343893049,0.203080001212599,0.757571164398096
13,"Mecklenburg-Vorpommern",13076124,"Severin",300,162,138,0.54,292,156,136,0.534246575342466,0.0393488343893049,0.203080001212599,0.757571164398096
13,"Mecklenburg-Vorpommern",13076125,"Siggelkow",912,466,446,0.510964912280702,906,480,426,0.529801324503311,0.0393488343893049,0.203080001212599,0.757571164398096
13,"Mecklenburg-Vorpommern",13076126,"Spornitz",1315,671,644,0.510266159695817,1373,718,655,0.522942461762564,0.0393488343893049,0.203080001212599,0.757571164398096
13,"Mecklenburg-Vorpommern",13076127,"Steesow",192,102,90,0.53125,194,101,93,0.520618556701031,0.0393488343893049,0.203080001212599,0.757571164398096
13,"Mecklenburg-Vorpommern",13076128,"Sternberg, Stadt",4310,2108,2202,0.489095127610209,4273,2113,2160,0.494500351041423,0.0393488343893049,0.203080001212599,0.757571164398096
13,"Mecklenburg-Vorpommern",13076129,"Stolpe",371,191,180,0.514824797843666,385,194,191,0.503896103896104,0.0393488343893049,0.203080001212599,0.757571164398096
13,"Mecklenburg-Vorpommern",13076130,"Stralendorf",1370,671,699,0.48978102189781,1333,660,673,0.495123780945236,0.0393488343893049,0.203080001212599,0.757571164398096
13,"Mecklenburg-Vorpommern",13076131,"Strohkirchen",321,161,160,0.501557632398754,319,163,156,0.510971786833856,0.0393488343893049,0.203080001212599,0.757571164398096
13,"Mecklenburg-Vorpommern",13076132,"Suckow",574,292,282,0.508710801393728,602,304,298,0.504983388704319,0.0393488343893049,0.203080001212599,0.757571164398096
13,"Mecklenburg-Vorpommern",13076133,"Sukow",1458,732,726,0.502057613168724,1487,751,736,0.505043712172159,0.0393488343893049,0.203080001212599,0.757571164398096
13,"Mecklenburg-Vorpommern",13076134,"Sülstorf",867,446,421,0.51441753171857,891,460,431,0.516273849607183,0.0393488343893049,0.203080001212599,0.757571164398096
13,"Mecklenburg-Vorpommern",13076135,"Techentin",737,401,336,0.544097693351425,704,380,324,0.539772727272727,0.0393488343893049,0.203080001212599,0.757571164398096
13,"Mecklenburg-Vorpommern",13076136,"Teldau",985,564,421,0.57258883248731,980,564,416,0.575510204081633,0.0393488343893049,0.203080001212599,0.757571164398096
13,"Mecklenburg-Vorpommern",13076137,"Tessenow",614,323,291,0.526058631921824,638,338,300,0.529780564263323,0.0393488343893049,0.203080001212599,0.757571164398096
13,"Mecklenburg-Vorpommern",13076138,"Tessin b. Boizenburg",409,209,200,0.511002444987775,412,214,198,0.519417475728155,0.0393488343893049,0.203080001212599,0.757571164398096
13,"Mecklenburg-Vorpommern",13076139,"Toddin",494,255,239,0.516194331983806,491,251,240,0.511201629327902,0.0393488343893049,0.203080001212599,0.757571164398096
13,"Mecklenburg-Vorpommern",13076140,"Tramm",946,489,457,0.516913319238901,987,517,470,0.523809523809524,0.0393488343893049,0.203080001212599,0.757571164398096
13,"Mecklenburg-Vorpommern",13076141,"Uelitz",419,216,203,0.515513126491647,429,230,199,0.536130536130536,0.0393488343893049,0.203080001212599,0.757571164398096
13,"Mecklenburg-Vorpommern",13076142,"Vellahn",2710,1406,1304,0.518819188191882,2724,1418,1306,0.520558002936858,0.0393488343893049,0.203080001212599,0.757571164398096
13,"Mecklenburg-Vorpommern",13076143,"Vielank",1344,679,665,0.505208333333333,1365,687,678,0.503296703296703,0.0393488343893049,0.203080001212599,0.757571164398096
13,"Mecklenburg-Vorpommern",13076144,"Wahlstorf",156,78,78,0.5,144,72,72,0.5,0.0393488343893049,0.203080001212599,0.757571164398096
13,"Mecklenburg-Vorpommern",13076145,"Warlitz",426,215,211,0.504694835680751,436,225,211,0.51605504587156,0.0393488343893049,0.203080001212599,0.757571164398096
13,"Mecklenburg-Vorpommern",13076146,"Warlow",481,249,232,0.517671517671518,523,286,237,0.546845124282983,0.0393488343893049,0.203080001212599,0.757571164398096
13,"Mecklenburg-Vorpommern",13076147,"Warsow",659,340,319,0.515933232169954,647,331,316,0.511591962905719,0.0393488343893049,0.203080001212599,0.757571164398096
13,"Mecklenburg-Vorpommern",13076148,"Weitendorf",380,201,179,0.528947368421053,422,236,186,0.559241706161137,0.0393488343893049,0.203080001212599,0.757571164398096
13,"Mecklenburg-Vorpommern",13076149,"Wendisch Priborn",431,235,196,0.545243619489559,440,244,196,0.554545454545455,0.0393488343893049,0.203080001212599,0.757571164398096
13,"Mecklenburg-Vorpommern",13076150,"Wendisch Waren",340,177,163,0.520588235294118,362,193,169,0.533149171270718,0.0393488343893049,0.203080001212599,0.757571164398096
13,"Mecklenburg-Vorpommern",13076151,"Werder",377,184,193,0.488063660477454,405,193,212,0.476543209876543,0.0393488343893049,0.203080001212599,0.757571164398096
13,"Mecklenburg-Vorpommern",13076152,"Wittenburg, Stadt",4993,2488,2505,0.498297616663329,4873,2427,2446,0.498050482249128,0.0393488343893049,0.203080001212599,0.757571164398096
13,"Mecklenburg-Vorpommern",13076153,"Wittendörp",2873,1478,1395,0.514444831186913,2967,1548,1419,0.521739130434783,0.0393488343893049,0.203080001212599,0.757571164398096
13,"Mecklenburg-Vorpommern",13076154,"Wittenförden",2681,1344,1337,0.501305483028721,2625,1303,1322,0.496380952380952,0.0393488343893049,0.203080001212599,0.757571164398096
13,"Mecklenburg-Vorpommern",13076155,"Witzin",496,256,240,0.516129032258065,467,239,228,0.511777301927195,0.0393488343893049,0.203080001212599,0.757571164398096
13,"Mecklenburg-Vorpommern",13076156,"Wöbbelin",896,453,443,0.505580357142857,915,468,447,0.511475409836066,0.0393488343893049,0.203080001212599,0.757571164398096
13,"Mecklenburg-Vorpommern",13076157,"Zahrensdorf",302,158,144,0.52317880794702,315,167,148,0.53015873015873,0.0393488343893049,0.203080001212599,0.757571164398096
13,"Mecklenburg-Vorpommern",13076158,"Zapel",418,215,203,0.514354066985646,424,210,214,0.495283018867925,0.0393488343893049,0.203080001212599,0.757571164398096
13,"Mecklenburg-Vorpommern",13076159,"Zarrentin am Schaalsee, Stadt",4822,2457,2365,0.509539610120282,4661,2359,2302,0.506114567689337,0.0393488343893049,0.203080001212599,0.757571164398096
13,"Mecklenburg-Vorpommern",13076160,"Ziegendorf",622,318,304,0.511254019292605,673,335,338,0.49777117384844,0.0393488343893049,0.203080001212599,0.757571164398096
13,"Mecklenburg-Vorpommern",13076161,"Zierzow",398,199,199,0.5,407,202,205,0.496314496314496,0.0393488343893049,0.203080001212599,0.757571164398096
13,"Mecklenburg-Vorpommern",13076162,"Zölkow",566,290,276,0.512367491166078,609,312,297,0.512315270935961,0.0393488343893049,0.203080001212599,0.757571164398096
13,"Mecklenburg-Vorpommern",13076163,"Zülow",155,72,83,0.464516129032258,136,60,76,0.441176470588235,0.0393488343893049,0.203080001212599,0.757571164398096
14,"Sachsen",14511000,"Chemnitz, Stadt",240543,116213,124330,0.48312775678361,243173,117404,125769,0.482800310889778,0.0127663514624012,0.312503616940011,0.674730031597588
14,"Sachsen",14521010,"Amtsberg",3902,1921,1981,0.492311635058944,3993,1935,2058,0.484598046581518,0.0127663514624012,0.312503616940011,0.674730031597588
14,"Sachsen",14521020,"Annaberg-Buchholz, Stadt",20922,9958,10964,0.475958321384189,21604,10379,11225,0.480420292538419,0.0127663514624012,0.312503616940011,0.674730031597588
14,"Sachsen",14521030,"Aue, Stadt",16994,7994,9000,0.470401318112275,17388,8254,9134,0.474695192086496,0.0127663514624012,0.312503616940011,0.674730031597588
14,"Sachsen",14521040,"Auerbach",2714,1313,1401,0.483787767133382,2672,1283,1389,0.480164670658683,0.0127663514624012,0.312503616940011,0.674730031597588
14,"Sachsen",14521050,"Bad Schlema",5031,2464,2567,0.489763466507653,5082,2498,2584,0.491538764266037,0.0127663514624012,0.312503616940011,0.674730031597588
14,"Sachsen",14521060,"Bärenstein",2438,1215,1223,0.498359310910582,2504,1241,1263,0.495607028753994,0.0127663514624012,0.312503616940011,0.674730031597588
14,"Sachsen",14521070,"Bernsbach",4447,2188,2259,0.49201709017315,4480,2198,2282,0.490625,0.0127663514624012,0.312503616940011,0.674730031597588
14,"Sachsen",14521080,"Bockau",2426,1171,1255,0.482687551525144,2435,1177,1258,0.483367556468172,0.0127663514624012,0.312503616940011,0.674730031597588
14,"Sachsen",14521090,"Börnichen/Erzgeb.",977,489,488,0.500511770726714,1015,510,505,0.502463054187192,0.0127663514624012,0.312503616940011,0.674730031597588
14,"Sachsen",14521100,"Borstendorf",1359,680,679,0.500367917586461,1373,663,710,0.482884195193008,0.0127663514624012,0.312503616940011,0.674730031597588
14,"Sachsen",14521110,"Breitenbrunn/Erzgeb.",5741,2767,2974,0.481971781919526,5862,2839,3023,0.484305697714091,0.0127663514624012,0.312503616940011,0.674730031597588
14,"Sachsen",14521120,"Burkhardtsdorf",6337,3105,3232,0.489979485560991,6356,3123,3233,0.491346758967904,0.0127663514624012,0.312503616940011,0.674730031597588
14,"Sachsen",14521130,"Crottendorf",4237,2049,2188,0.483596884588152,4239,2046,2193,0.482661004953999,0.0127663514624012,0.312503616940011,0.674730031597588
14,"Sachsen",14521140,"Deutschneudorf",1062,565,497,0.532015065913371,1080,573,507,0.530555555555556,0.0127663514624012,0.312503616940011,0.674730031597588
14,"Sachsen",14521150,"Drebach",5640,2869,2771,0.508687943262411,5682,2902,2780,0.510735656458993,0.0127663514624012,0.312503616940011,0.674730031597588
14,"Sachsen",14521160,"Ehrenfriedersdorf, Stadt",4937,2381,2556,0.482276686246709,4991,2408,2583,0.482468443197756,0.0127663514624012,0.312503616940011,0.674730031597588
14,"Sachsen",14521170,"Eibenstock, Stadt",7933,3930,4003,0.495398966343124,8028,3976,4052,0.495266567015446,0.0127663514624012,0.312503616940011,0.674730031597588
14,"Sachsen",14521180,"Elterlein, Stadt",3088,1536,1552,0.49740932642487,3090,1543,1547,0.499352750809061,0.0127663514624012,0.312503616940011,0.674730031597588
14,"Sachsen",14521190,"Erlbach-Kirchberg",1639,826,813,0.503965832824893,1673,842,831,0.503287507471608,0.0127663514624012,0.312503616940011,0.674730031597588
14,"Sachsen",14521200,"Gelenau/Erzgeb.",4384,2147,2237,0.489735401459854,4393,2155,2238,0.490553152743,0.0127663514624012,0.312503616940011,0.674730031597588
14,"Sachsen",14521210,"Geyer, Stadt",3773,1832,1941,0.485555261065465,3807,1856,1951,0.487522983976885,0.0127663514624012,0.312503616940011,0.674730031597588
14,"Sachsen",14521220,"Gornau/Erzgeb.",3803,1869,1934,0.491454115172232,3891,1921,1970,0.493703418144436,0.0127663514624012,0.312503616940011,0.674730031597588
14,"Sachsen",14521230,"Gornsdorf",2079,1049,1030,0.504569504569505,2101,1056,1045,0.50261780104712,0.0127663514624012,0.312503616940011,0.674730031597588
14,"Sachsen",14521240,"Großolbersdorf",2953,1478,1475,0.500507958008805,2956,1475,1481,0.498985115020298,0.0127663514624012,0.312503616940011,0.674730031597588
14,"Sachsen",14521250,"Großrückerswalde",3608,1820,1788,0.504434589800443,3654,1847,1807,0.505473453749316,0.0127663514624012,0.312503616940011,0.674730031597588
14,"Sachsen",14521260,"Grünhain-Beierfeld, Stadt",6120,3039,3081,0.49656862745098,6197,3078,3119,0.496691947716637,0.0127663514624012,0.312503616940011,0.674730031597588
14,"Sachsen",14521270,"Grünhainichen",2314,1147,1167,0.495678478824546,2278,1123,1155,0.49297629499561,0.0127663514624012,0.312503616940011,0.674730031597588
14,"Sachsen",14521280,"Heidersdorf",842,432,410,0.513064133016627,849,439,410,0.517078916372203,0.0127663514624012,0.312503616940011,0.674730031597588
14,"Sachsen",14521290,"Hohndorf",3796,1852,1944,0.487881981032666,3834,1882,1952,0.490871152842984,0.0127663514624012,0.312503616940011,0.674730031597588
14,"Sachsen",14521300,"Hormersdorf",1542,761,781,0.493514915693904,1548,760,788,0.490956072351421,0.0127663514624012,0.312503616940011,0.674730031597588
14,"Sachsen",14521310,"Jahnsdorf/Erzgeb.",5607,2778,2829,0.495452113429642,5638,2814,2824,0.499113160695282,0.0127663514624012,0.312503616940011,0.674730031597588
14,"Sachsen",14521320,"Johanngeorgenstadt, Stadt",4474,2133,2341,0.476754582029504,4566,2172,2394,0.47568988173456,0.0127663514624012,0.312503616940011,0.674730031597588
14,"Sachsen",14521330,"Jöhstadt, Stadt",2933,1480,1453,0.504602795772247,2949,1492,1457,0.505934214988132,0.0127663514624012,0.312503616940011,0.674730031597588
14,"Sachsen",14521340,"Königswalde",2305,1147,1158,0.497613882863341,2304,1151,1153,0.499565972222222,0.0127663514624012,0.312503616940011,0.674730031597588
14,"Sachsen",14521350,"Lauter/Sa., Stadt",4657,2276,2381,0.488726648056689,4707,2292,2415,0.486934353091141,0.0127663514624012,0.312503616940011,0.674730031597588
14,"Sachsen",14521360,"Lengefeld, Stadt",4336,2117,2219,0.488238007380074,4389,2140,2249,0.487582592845751,0.0127663514624012,0.312503616940011,0.674730031597588
14,"Sachsen",14521370,"Lößnitz, Stadt",9263,4456,4807,0.481053654323653,9238,4444,4794,0.481056505737173,0.0127663514624012,0.312503616940011,0.674730031597588
14,"Sachsen",14521380,"Lugau/Erzgeb., Stadt",6913,3339,3574,0.483003037754954,7068,3435,3633,0.485993208828523,0.0127663514624012,0.312503616940011,0.674730031597588
14,"Sachsen",14521390,"Marienberg, Stadt",13127,6489,6638,0.494324674335339,13088,6478,6610,0.494957212713936,0.0127663514624012,0.312503616940011,0.674730031597588
14,"Sachsen",14521400,"Mildenau",3501,1753,1748,0.500714081690945,3551,1786,1765,0.50295691354548,0.0127663514624012,0.312503616940011,0.674730031597588
14,"Sachsen",14521410,"Neukirchen/Erzgeb.",6808,3335,3473,0.489864864864865,6927,3391,3536,0.489533708676195,0.0127663514624012,0.312503616940011,0.674730031597588
14,"Sachsen",14521420,"Niederdorf",1247,613,634,0.491579791499599,1277,628,649,0.49177760375881,0.0127663514624012,0.312503616940011,0.674730031597588
14,"Sachsen",14521430,"Niederwürschnitz",2714,1355,1359,0.499263080324245,2790,1399,1391,0.501433691756272,0.0127663514624012,0.312503616940011,0.674730031597588
14,"Sachsen",14521440,"Oberwiesenthal, Kurort, Stadt",2322,1130,1192,0.486649440137812,2432,1180,1252,0.485197368421053,0.0127663514624012,0.312503616940011,0.674730031597588
14,"Sachsen",14521450,"Oelsnitz/Erzgeb., Stadt",11458,5540,5918,0.483504974690173,11645,5648,5997,0.485015027908974,0.0127663514624012,0.312503616940011,0.674730031597588
14,"Sachsen",14521460,"Olbernhau, Stadt",9538,4640,4898,0.486475152023485,9780,4790,4990,0.489775051124744,0.0127663514624012,0.312503616940011,0.674730031597588
14,"Sachsen",14521470,"Pfaffroda",2690,1346,1344,0.500371747211896,2762,1376,1386,0.498189717595945,0.0127663514624012,0.312503616940011,0.674730031597588
14,"Sachsen",14521480,"Pobershau",1965,991,974,0.504325699745547,1978,1001,977,0.506066734074823,0.0127663514624012,0.312503616940011,0.674730031597588
14,"Sachsen",14521490,"Pockau",3902,1945,1957,0.498462327011789,3916,1949,1967,0.497701736465781,0.0127663514624012,0.312503616940011,0.674730031597588
14,"Sachsen",14521500,"Raschau-Markersbach",5427,2660,2767,0.490141883176709,5461,2694,2767,0.493316242446438,0.0127663514624012,0.312503616940011,0.674730031597588
14,"Sachsen",14521510,"Scheibenberg, Stadt",2208,1108,1100,0.501811594202899,2196,1106,1090,0.503642987249545,0.0127663514624012,0.312503616940011,0.674730031597588
14,"Sachsen",14521520,"Schlettau, Stadt",2497,1206,1291,0.482979575490589,2515,1211,1304,0.481510934393638,0.0127663514624012,0.312503616940011,0.674730031597588
14,"Sachsen",14521530,"Schneeberg, Stadt",14705,7098,7607,0.482692961577695,15078,7233,7845,0.479705531237565,0.0127663514624012,0.312503616940011,0.674730031597588
14,"Sachsen",14521540,"Schönheide",4895,2378,2517,0.485801838610827,4918,2415,2503,0.491053273688491,0.0127663514624012,0.312503616940011,0.674730031597588
14,"Sachsen",14521550,"Schwarzenberg/Erzgeb., Stadt",17965,8551,9414,0.475981074311161,18326,8796,9530,0.4799738077049,0.0127663514624012,0.312503616940011,0.674730031597588
14,"Sachsen",14521560,"Sehmatal",6824,3386,3438,0.496189917936694,6988,3459,3529,0.494991413852318,0.0127663514624012,0.312503616940011,0.674730031597588
14,"Sachsen",14521570,"Seiffen/Erzgeb., Kurort",2407,1226,1181,0.509347735770669,2376,1221,1155,0.513888888888889,0.0127663514624012,0.312503616940011,0.674730031597588
14,"Sachsen",14521590,"Stollberg/Erzgeb., Stadt",11494,5537,5957,0.481729598051157,11576,5605,5971,0.484191430545957,0.0127663514624012,0.312503616940011,0.674730031597588
14,"Sachsen",14521600,"Stützengrün",3517,1743,1774,0.495592834802388,3546,1755,1791,0.49492385786802,0.0127663514624012,0.312503616940011,0.674730031597588
14,"Sachsen",14521610,"Tannenberg",1154,579,575,0.501733102253033,1182,599,583,0.506768189509306,0.0127663514624012,0.312503616940011,0.674730031597588
14,"Sachsen",14521620,"Thalheim/Erzgeb., Stadt",6809,3323,3486,0.488030547804377,6922,3386,3536,0.489164981219301,0.0127663514624012,0.312503616940011,0.674730031597588
14,"Sachsen",14521630,"Thermalbad Wiesenbad",3497,1732,1765,0.49528167000286,3493,1732,1761,0.495848840538219,0.0127663514624012,0.312503616940011,0.674730031597588
14,"Sachsen",14521640,"Thum, Stadt",5459,2693,2766,0.493313793735116,5468,2687,2781,0.491404535479151,0.0127663514624012,0.312503616940011,0.674730031597588
14,"Sachsen",14521670,"Wolkenstein, Stadt",4018,1963,2055,0.488551518168243,4034,1959,2075,0.48562221120476,0.0127663514624012,0.312503616940011,0.674730031597588
14,"Sachsen",14521680,"Zöblitz, Stadt",2828,1410,1418,0.498585572842999,2810,1406,1404,0.500355871886121,0.0127663514624012,0.312503616940011,0.674730031597588
14,"Sachsen",14521690,"Zschopau, Stadt",9975,4822,5153,0.483408521303258,10115,4944,5171,0.488779041028176,0.0127663514624012,0.312503616940011,0.674730031597588
14,"Sachsen",14521700,"Zschorlau",5568,2716,2852,0.487787356321839,5504,2686,2818,0.488008720930233,0.0127663514624012,0.312503616940011,0.674730031597588
14,"Sachsen",14521710,"Zwönitz, Stadt",11058,5383,5675,0.486796889130042,11173,5499,5674,0.492168620782243,0.0127663514624012,0.312503616940011,0.674730031597588
14,"Sachsen",14522010,"Altmittweida",1992,997,995,0.500502008032129,2022,1010,1012,0.499505440158259,0.0127663514624012,0.312503616940011,0.674730031597588
14,"Sachsen",14522020,"Augustusburg, Stadt",4811,2373,2438,0.493244647682395,4826,2384,2442,0.493990882718608,0.0127663514624012,0.312503616940011,0.674730031597588
14,"Sachsen",14522030,"Bobritzsch",4534,2272,2262,0.501102779003088,4556,2302,2254,0.505267778753292,0.0127663514624012,0.312503616940011,0.674730031597588
14,"Sachsen",14522040,"Bockelwitz",2436,1237,1199,0.507799671592775,2540,1291,1249,0.508267716535433,0.0127663514624012,0.312503616940011,0.674730031597588
14,"Sachsen",14522050,"Brand-Erbisdorf, Stadt",10208,4968,5240,0.486677115987461,10418,5055,5363,0.48521789210981,0.0127663514624012,0.312503616940011,0.674730031597588
14,"Sachsen",14522060,"Burgstädt, Stadt",11176,5387,5789,0.482015032211883,11387,5458,5929,0.479318521120576,0.0127663514624012,0.312503616940011,0.674730031597588
14,"Sachsen",14522070,"Claußnitz",3268,1622,1646,0.496328029375765,3287,1616,1671,0.491633708548829,0.0127663514624012,0.312503616940011,0.674730031597588
14,"Sachsen",14522080,"Döbeln, Stadt",20930,10097,10833,0.482417582417582,21077,10221,10856,0.484936186364283,0.0127663514624012,0.312503616940011,0.674730031597588
14,"Sachsen",14522090,"Dorfchemnitz",1635,831,804,0.508256880733945,1647,840,807,0.510018214936248,0.0127663514624012,0.312503616940011,0.674730031597588
14,"Sachsen",14522110,"Eppendorf",4433,2144,2289,0.483645386871193,4468,2155,2313,0.482318710832587,0.0127663514624012,0.312503616940011,0.674730031597588
14,"Sachsen",14522120,"Erlau",3327,1686,1641,0.506762849413886,3385,1732,1653,0.511669128508124,0.0127663514624012,0.312503616940011,0.674730031597588
14,"Sachsen",14522140,"Flöha, Stadt",11432,5479,5953,0.479268719384185,11501,5513,5988,0.47934962177202,0.0127663514624012,0.312503616940011,0.674730031597588
14,"Sachsen",14522150,"Frankenberg/Sa., Stadt",14899,7361,7538,0.494060004027116,15588,7738,7850,0.49640749294329,0.0127663514624012,0.312503616940011,0.674730031597588
14,"Sachsen",14522160,"Frankenstein",1116,564,552,0.505376344086022,1103,556,547,0.504079782411605,0.0127663514624012,0.312503616940011,0.674730031597588
14,"Sachsen",14522170,"Frauenstein, Stadt",3030,1513,1517,0.499339933993399,3038,1512,1526,0.497695852534562,0.0127663514624012,0.312503616940011,0.674730031597588
14,"Sachsen",14522180,"Freiberg, Stadt",40020,19519,20501,0.487731134432784,41498,20516,20982,0.494385271579353,0.0127663514624012,0.312503616940011,0.674730031597588
14,"Sachsen",14522190,"Geringswalde, Stadt",4583,2261,2322,0.493344970543312,4522,2230,2292,0.493144626271561,0.0127663514624012,0.312503616940011,0.674730031597588
14,"Sachsen",14522200,"Großhartmannsdorf",2600,1324,1276,0.509230769230769,2579,1324,1255,0.513377278014734,0.0127663514624012,0.312503616940011,0.674730031597588
14,"Sachsen",14522210,"Großschirma, Stadt",5807,2941,2866,0.506457723437231,5896,2985,2911,0.506275440976934,0.0127663514624012,0.312503616940011,0.674730031597588
14,"Sachsen",14522220,"Großweitzschen",2950,1498,1452,0.507796610169492,3027,1520,1507,0.502147340601255,0.0127663514624012,0.312503616940011,0.674730031597588
14,"Sachsen",14522230,"Hainichen, Stadt",8825,4334,4491,0.491104815864023,8812,4324,4488,0.490694507489787,0.0127663514624012,0.312503616940011,0.674730031597588
14,"Sachsen",14522240,"Halsbrücke",5328,2689,2639,0.504692192192192,5368,2709,2659,0.504657228017884,0.0127663514624012,0.312503616940011,0.674730031597588
14,"Sachsen",14522250,"Hartha, Stadt",7659,3702,3957,0.483352918135527,7627,3686,3941,0.483283073292251,0.0127663514624012,0.312503616940011,0.674730031597588
14,"Sachsen",14522260,"Hartmannsdorf",4505,2178,2327,0.4834628190899,4517,2176,2341,0.481735665264556,0.0127663514624012,0.312503616940011,0.674730031597588
14,"Sachsen",14522270,"Hilbersdorf",1433,719,714,0.501744591765527,1404,704,700,0.501424501424501,0.0127663514624012,0.312503616940011,0.674730031597588
14,"Sachsen",14522280,"Königsfeld",1563,808,755,0.516954574536148,1584,823,761,0.519570707070707,0.0127663514624012,0.312503616940011,0.674730031597588
14,"Sachsen",14522290,"Königshain-Wiederau",2741,1384,1357,0.504925209777453,2785,1396,1389,0.501256732495512,0.0127663514624012,0.312503616940011,0.674730031597588
14,"Sachsen",14522300,"Kriebstein",2298,1133,1165,0.493037423846823,2355,1156,1199,0.490870488322718,0.0127663514624012,0.312503616940011,0.674730031597588
14,"Sachsen",14522310,"Leisnig, Stadt",6317,3040,3277,0.481241095456704,6369,3080,3289,0.483592400690846,0.0127663514624012,0.312503616940011,0.674730031597588
14,"Sachsen",14522320,"Leubsdorf",3519,1776,1743,0.504688832054561,3618,1827,1791,0.504975124378109,0.0127663514624012,0.312503616940011,0.674730031597588
14,"Sachsen",14522330,"Lichtenau",7504,3764,3740,0.501599147121535,7586,3789,3797,0.49947271289217,0.0127663514624012,0.312503616940011,0.674730031597588
14,"Sachsen",14522340,"Lichtenberg/Erzgeb.",2794,1390,1404,0.497494631352899,2746,1361,1385,0.495630007283321,0.0127663514624012,0.312503616940011,0.674730031597588
14,"Sachsen",14522350,"Lunzenau, Stadt",4671,2265,2406,0.484906872190109,4694,2277,2417,0.485087345547507,0.0127663514624012,0.312503616940011,0.674730031597588
14,"Sachsen",14522360,"Mittweida, Stadt",15286,7523,7763,0.492149679445244,15341,7423,7918,0.483866762271038,0.0127663514624012,0.312503616940011,0.674730031597588
14,"Sachsen",14522370,"Mochau",2405,1229,1176,0.511018711018711,2508,1282,1226,0.511164274322169,0.0127663514624012,0.312503616940011,0.674730031597588
14,"Sachsen",14522380,"Mühlau",2180,1114,1066,0.511009174311927,2211,1127,1084,0.509724106739032,0.0127663514624012,0.312503616940011,0.674730031597588
14,"Sachsen",14522390,"Mulda/Sa.",2677,1348,1329,0.503548748599178,2725,1384,1341,0.507889908256881,0.0127663514624012,0.312503616940011,0.674730031597588
14,"Sachsen",14522400,"Neuhausen/Erzgeb.",2890,1474,1416,0.510034602076125,2964,1507,1457,0.508434547908232,0.0127663514624012,0.312503616940011,0.674730031597588
14,"Sachsen",14522410,"Niederstriegis",1138,576,562,0.506151142355009,1184,598,586,0.505067567567568,0.0127663514624012,0.312503616940011,0.674730031597588
14,"Sachsen",14522420,"Niederwiesa",5046,2483,2563,0.492072929052715,5035,2477,2558,0.491956305858987,0.0127663514624012,0.312503616940011,0.674730031597588
14,"Sachsen",14522430,"Oberschöna",3440,1756,1684,0.51046511627907,3535,1825,1710,0.516265912305516,0.0127663514624012,0.312503616940011,0.674730031597588
14,"Sachsen",14522440,"Oederan, Stadt",7391,3618,3773,0.48951427411717,7434,3624,3810,0.487489911218725,0.0127663514624012,0.312503616940011,0.674730031597588
14,"Sachsen",14522450,"Ostrau",3875,1984,1891,0.512,3912,2009,1903,0.513548057259714,0.0127663514624012,0.312503616940011,0.674730031597588
14,"Sachsen",14522460,"Penig, Stadt",9449,4576,4873,0.484284051222352,9544,4622,4922,0.484283319362951,0.0127663514624012,0.312503616940011,0.674730031597588
14,"Sachsen",14522470,"Rechenberg-Bienenmühle",2084,1040,1044,0.499040307101727,2079,1040,1039,0.5002405002405,0.0127663514624012,0.312503616940011,0.674730031597588
14,"Sachsen",14522480,"Reinsberg",3014,1533,1481,0.508626410086264,3030,1543,1487,0.509240924092409,0.0127663514624012,0.312503616940011,0.674730031597588
14,"Sachsen",14522490,"Rochlitz, Stadt",6212,2949,3263,0.474726336123632,6221,2935,3286,0.471789101430638,0.0127663514624012,0.312503616940011,0.674730031597588
14,"Sachsen",14522500,"Rossau",3613,1822,1791,0.504290063659009,3654,1845,1809,0.504926108374384,0.0127663514624012,0.312503616940011,0.674730031597588
14,"Sachsen",14522510,"Roßwein, Stadt",6732,3252,3480,0.483065953654189,6807,3270,3537,0.480387836051124,0.0127663514624012,0.312503616940011,0.674730031597588
14,"Sachsen",14522520,"Sayda, Stadt",1985,978,1007,0.492695214105793,2000,985,1015,0.4925,0.0127663514624012,0.312503616940011,0.674730031597588
14,"Sachsen",14522530,"Seelitz",1867,946,921,0.506695232994108,1901,964,937,0.507101525512888,0.0127663514624012,0.312503616940011,0.674730031597588
14,"Sachsen",14522540,"Striegistal",4955,2512,2443,0.506962663975782,5236,2684,2552,0.512605042016807,0.0127663514624012,0.312503616940011,0.674730031597588
14,"Sachsen",14522550,"Taura",2477,1215,1262,0.490512716996367,2494,1237,1257,0.495990376904571,0.0127663514624012,0.312503616940011,0.674730031597588
14,"Sachsen",14522570,"Waldheim, Stadt",8261,4194,4067,0.507686720735988,8348,4229,4119,0.506588404408241,0.0127663514624012,0.312503616940011,0.674730031597588
14,"Sachsen",14522580,"Wechselburg",1968,994,974,0.505081300813008,2002,1014,988,0.506493506493506,0.0127663514624012,0.312503616940011,0.674730031597588
14,"Sachsen",14522590,"Weißenborn/Erzgeb.",2596,1315,1281,0.506548536209553,2626,1324,1302,0.504188880426504,0.0127663514624012,0.312503616940011,0.674730031597588
14,"Sachsen",14522600,"Zettlitz",788,399,389,0.506345177664975,800,403,397,0.50375,0.0127663514624012,0.312503616940011,0.674730031597588
14,"Sachsen",14522610,"Ziegra-Knobelsdorf",2026,1032,994,0.509378084896348,2143,1098,1045,0.512365842277182,0.0127663514624012,0.312503616940011,0.674730031597588
14,"Sachsen",14522620,"Zschaitz-Ottewig",1363,689,674,0.505502567865004,1340,668,672,0.498507462686567,0.0127663514624012,0.312503616940011,0.674730031597588
14,"Sachsen",14523010,"Adorf/Vogtl., Stadt",5302,2555,2747,0.481893625047152,5251,2527,2724,0.481241668253666,0.0127663514624012,0.312503616940011,0.674730031597588
14,"Sachsen",14523020,"Auerbach/Vogtl., Stadt",19474,9322,10152,0.478689534764301,19838,9515,10323,0.479635043855227,0.0127663514624012,0.312503616940011,0.674730031597588
14,"Sachsen",14523030,"Bad Brambach",2051,961,1090,0.46855192588981,2030,957,1073,0.471428571428571,0.0127663514624012,0.312503616940011,0.674730031597588
14,"Sachsen",14523040,"Bad Elster, Stadt",3698,1739,1959,0.47025419145484,3667,1732,1935,0.472320698118353,0.0127663514624012,0.312503616940011,0.674730031597588
14,"Sachsen",14523050,"Bergen",1028,502,526,0.488326848249027,1001,490,511,0.48951048951049,0.0127663514624012,0.312503616940011,0.674730031597588
14,"Sachsen",14523060,"Bösenbrunn",1250,605,645,0.484,1307,629,678,0.481254781943382,0.0127663514624012,0.312503616940011,0.674730031597588
14,"Sachsen",14523080,"Eichigt",1285,660,625,0.513618677042802,1279,657,622,0.513682564503518,0.0127663514624012,0.312503616940011,0.674730031597588
14,"Sachsen",14523090,"Ellefeld",2760,1317,1443,0.477173913043478,2782,1331,1451,0.4784327821711,0.0127663514624012,0.312503616940011,0.674730031597588
14,"Sachsen",14523100,"Elsterberg, Stadt",4425,2150,2275,0.485875706214689,4542,2217,2325,0.488110964332893,0.0127663514624012,0.312503616940011,0.674730031597588
14,"Sachsen",14523110,"Erlbach",1713,842,871,0.491535318155283,1775,880,895,0.495774647887324,0.0127663514624012,0.312503616940011,0.674730031597588
14,"Sachsen",14523120,"Falkenstein/Vogtl., Stadt",8561,4044,4517,0.472374722579138,8551,4005,4546,0.468366272950532,0.0127663514624012,0.312503616940011,0.674730031597588
14,"Sachsen",14523130,"Grünbach, Höhenluftkurort",1816,894,922,0.492290748898678,1813,870,943,0.479867622724766,0.0127663514624012,0.312503616940011,0.674730031597588
14,"Sachsen",14523150,"Heinsdorfergrund",2172,1056,1116,0.486187845303867,2198,1069,1129,0.486351228389445,0.0127663514624012,0.312503616940011,0.674730031597588
14,"Sachsen",14523160,"Klingenthal, Stadt",7941,3819,4122,0.480921798262184,8139,3899,4240,0.479051480525863,0.0127663514624012,0.312503616940011,0.674730031597588
14,"Sachsen",14523170,"Lengenfeld, Stadt",7530,3684,3846,0.489243027888446,7472,3660,3812,0.48982869379015,0.0127663514624012,0.312503616940011,0.674730031597588
14,"Sachsen",14523190,"Limbach",1523,725,798,0.476034143138542,1554,734,820,0.472329472329472,0.0127663514624012,0.312503616940011,0.674730031597588
14,"Sachsen",14523200,"Markneukirchen, Stadt",6450,3158,3292,0.489612403100775,6512,3190,3322,0.489864864864865,0.0127663514624012,0.312503616940011,0.674730031597588
14,"Sachsen",14523230,"Mühlental",1370,704,666,0.513868613138686,1521,778,743,0.511505588428665,0.0127663514624012,0.312503616940011,0.674730031597588
14,"Sachsen",14523240,"Mühltroff, Stadt",1751,871,880,0.497430039977156,1775,875,900,0.492957746478873,0.0127663514624012,0.312503616940011,0.674730031597588
14,"Sachsen",14523245,"Muldenhammer",3324,1657,1667,0.49849578820698,3415,1714,1701,0.50190336749634,0.0127663514624012,0.312503616940011,0.674730031597588
14,"Sachsen",14523250,"Mylau, Stadt",2746,1379,1367,0.502184996358339,2794,1408,1386,0.503937007874016,0.0127663514624012,0.312503616940011,0.674730031597588
14,"Sachsen",14523260,"Netzschkau, Stadt",4164,2014,2150,0.483669548511047,4125,1972,2153,0.478060606060606,0.0127663514624012,0.312503616940011,0.674730031597588
14,"Sachsen",14523270,"Neuensalz",2265,1129,1136,0.498454746136865,2316,1153,1163,0.497841105354059,0.0127663514624012,0.312503616940011,0.674730031597588
14,"Sachsen",14523280,"Neumark",3026,1508,1518,0.498347653668209,3052,1531,1521,0.501638269986894,0.0127663514624012,0.312503616940011,0.674730031597588
14,"Sachsen",14523290,"Neustadt/Vogtl.",1014,491,523,0.48422090729783,1046,515,531,0.492351816443595,0.0127663514624012,0.312503616940011,0.674730031597588
14,"Sachsen",14523300,"Oelsnitz/Vogtl., Stadt",11109,5374,5735,0.483751912863444,11159,5433,5726,0.486871583475222,0.0127663514624012,0.312503616940011,0.674730031597588
14,"Sachsen",14523310,"Pausa/Vogtl., Stadt",3580,1748,1832,0.488268156424581,3618,1770,1848,0.48922056384743,0.0127663514624012,0.312503616940011,0.674730031597588
14,"Sachsen",14523320,"Plauen, Stadt",64321,30914,33407,0.48062063711696,65738,31784,33954,0.483495086555721,0.0127663514624012,0.312503616940011,0.674730031597588
14,"Sachsen",14523330,"Pöhl",2614,1284,1330,0.491201224177506,2685,1322,1363,0.492364990689013,0.0127663514624012,0.312503616940011,0.674730031597588
14,"Sachsen",14523340,"Reichenbach im Vogtland, Stadt",19454,9220,10234,0.473938521640794,19836,9386,10450,0.473180076628352,0.0127663514624012,0.312503616940011,0.674730031597588
14,"Sachsen",14523350,"Reuth",1040,534,506,0.513461538461538,1036,523,513,0.504826254826255,0.0127663514624012,0.312503616940011,0.674730031597588
14,"Sachsen",14523360,"Rodewisch, Stadt",6747,3267,3480,0.484215206758559,6857,3327,3530,0.485197608283506,0.0127663514624012,0.312503616940011,0.674730031597588
14,"Sachsen",14523365,"Rosenbach/Vogtl.",4364,2160,2204,0.494958753437214,4293,2143,2150,0.499184719310505,0.0127663514624012,0.312503616940011,0.674730031597588
14,"Sachsen",14523370,"Schöneck/Vogtl., Stadt",3405,1632,1773,0.479295154185022,3385,1627,1758,0.480649926144756,0.0127663514624012,0.312503616940011,0.674730031597588
14,"Sachsen",14523380,"Steinberg",2901,1404,1497,0.483971044467425,2790,1371,1419,0.491397849462366,0.0127663514624012,0.312503616940011,0.674730031597588
14,"Sachsen",14523410,"Theuma",1037,511,526,0.492767598842816,1050,515,535,0.49047619047619,0.0127663514624012,0.312503616940011,0.674730031597588
14,"Sachsen",14523420,"Tirpersdorf",1430,714,716,0.499300699300699,1429,709,720,0.496151154653604,0.0127663514624012,0.312503616940011,0.674730031597588
14,"Sachsen",14523430,"Treuen, Stadt",8355,4066,4289,0.486654697785757,8388,4087,4301,0.48724368144969,0.0127663514624012,0.312503616940011,0.674730031597588
14,"Sachsen",14523440,"Triebel/Vogtl.",1340,677,663,0.505223880597015,1403,696,707,0.49607982893799,0.0127663514624012,0.312503616940011,0.674730031597588
14,"Sachsen",14523450,"Weischlitz",5194,2580,2614,0.496726992683866,5285,2629,2656,0.497445600756859,0.0127663514624012,0.312503616940011,0.674730031597588
14,"Sachsen",14523460,"Werda",1557,764,793,0.490687219010918,1570,781,789,0.497452229299363,0.0127663514624012,0.312503616940011,0.674730031597588
14,"Sachsen",14523470,"Zwota",1356,672,684,0.495575221238938,1366,676,690,0.494875549048316,0.0127663514624012,0.312503616940011,0.674730031597588
14,"Sachsen",14524010,"Bernsdorf",2373,1213,1160,0.511167298777918,2365,1203,1162,0.508668076109937,0.0127663514624012,0.312503616940011,0.674730031597588
14,"Sachsen",14524020,"Callenberg",5271,2601,2670,0.493454752418896,5337,2625,2712,0.491849353569421,0.0127663514624012,0.312503616940011,0.674730031597588
14,"Sachsen",14524030,"Crimmitschau, Stadt",19853,9523,10330,0.479675615775953,20535,9917,10618,0.482931580228877,0.0127663514624012,0.312503616940011,0.674730031597588
14,"Sachsen",14524040,"Crinitzberg",2068,1031,1037,0.498549323017408,2174,1096,1078,0.504139834406624,0.0127663514624012,0.312503616940011,0.674730031597588
14,"Sachsen",14524050,"Dennheritz",1386,688,698,0.496392496392496,1400,699,701,0.499285714285714,0.0127663514624012,0.312503616940011,0.674730031597588
14,"Sachsen",14524060,"Fraureuth",5304,2580,2724,0.486425339366516,5327,2607,2720,0.489393654965271,0.0127663514624012,0.312503616940011,0.674730031597588
14,"Sachsen",14524070,"Gersdorf",4199,2056,2143,0.489640390569183,4227,2072,2155,0.49018216229004,0.0127663514624012,0.312503616940011,0.674730031597588
14,"Sachsen",14524080,"Glauchau, Stadt",23446,11399,12047,0.486181011686428,24234,11858,12376,0.489312536106297,0.0127663514624012,0.312503616940011,0.674730031597588
14,"Sachsen",14524090,"Hartenstein, Stadt",4773,2302,2471,0.48229624973811,4831,2328,2503,0.481887807907266,0.0127663514624012,0.312503616940011,0.674730031597588
14,"Sachsen",14524100,"Hartmannsdorf b. Kirchberg",1391,669,722,0.480948957584472,1426,689,737,0.483169705469846,0.0127663514624012,0.312503616940011,0.674730031597588
14,"Sachsen",14524110,"Hirschfeld",1209,606,603,0.501240694789082,1208,609,599,0.504139072847682,0.0127663514624012,0.312503616940011,0.674730031597588
14,"Sachsen",14524120,"Hohenstein-Ernstthal, Stadt",15380,7381,7999,0.479908972691808,15550,7573,7977,0.487009646302251,0.0127663514624012,0.312503616940011,0.674730031597588
14,"Sachsen",14524130,"Kirchberg, Stadt",8635,4099,4536,0.47469600463231,8617,4089,4528,0.474527097597772,0.0127663514624012,0.312503616940011,0.674730031597588
14,"Sachsen",14524140,"Langenbernsdorf",3715,1854,1861,0.499057873485868,3753,1878,1875,0.500399680255795,0.0127663514624012,0.312503616940011,0.674730031597588
14,"Sachsen",14524150,"Langenweißbach",2625,1306,1319,0.49752380952381,2673,1335,1338,0.499438832772166,0.0127663514624012,0.312503616940011,0.674730031597588
14,"Sachsen",14524160,"Lichtenstein/Sa., Stadt",12341,5876,6465,0.476136455716717,12613,6052,6561,0.47982240545469,0.0127663514624012,0.312503616940011,0.674730031597588
14,"Sachsen",14524170,"Lichtentanne",6645,3197,3448,0.481113619262603,6719,3232,3487,0.481023961899092,0.0127663514624012,0.312503616940011,0.674730031597588
14,"Sachsen",14524180,"Limbach-Oberfrohna, Stadt",24571,11836,12735,0.481706076268772,25141,12121,13020,0.482120838471023,0.0127663514624012,0.312503616940011,0.674730031597588
14,"Sachsen",14524190,"Meerane, Stadt",15454,7367,8087,0.476705060178595,15942,7632,8310,0.478735415882574,0.0127663514624012,0.312503616940011,0.674730031597588
14,"Sachsen",14524200,"Mülsen",11822,5796,6026,0.490272373540856,11830,5835,5995,0.49323753169907,0.0127663514624012,0.312503616940011,0.674730031597588
14,"Sachsen",14524210,"Neukirchen/Pleiße",4167,2052,2115,0.49244060475162,4168,2043,2125,0.490163147792706,0.0127663514624012,0.312503616940011,0.674730031597588
14,"Sachsen",14524220,"Niederfrohna",2336,1172,1164,0.501712328767123,2359,1186,1173,0.502755404832556,0.0127663514624012,0.312503616940011,0.674730031597588
14,"Sachsen",14524230,"Oberlungwitz, Stadt",6194,3026,3168,0.488537294155634,6292,3075,3217,0.488715829624921,0.0127663514624012,0.312503616940011,0.674730031597588
14,"Sachsen",14524240,"Oberwiera",1093,545,548,0.498627630375114,1131,562,569,0.496905393457118,0.0127663514624012,0.312503616940011,0.674730031597588
14,"Sachsen",14524250,"Reinsdorf",7955,3919,4036,0.4926461345066,8056,3987,4069,0.494910625620655,0.0127663514624012,0.312503616940011,0.674730031597588
14,"Sachsen",14524260,"Remse",1742,861,881,0.494259471871412,1794,893,901,0.497770345596433,0.0127663514624012,0.312503616940011,0.674730031597588
14,"Sachsen",14524270,"Schönberg",966,489,477,0.506211180124224,953,474,479,0.497376705141658,0.0127663514624012,0.312503616940011,0.674730031597588
14,"Sachsen",14524280,"St. Egidien",3421,1688,1733,0.493422975738088,3308,1617,1691,0.488814993954051,0.0127663514624012,0.312503616940011,0.674730031597588
14,"Sachsen",14524290,"Waldenburg, Stadt",4212,2060,2152,0.489078822412156,4261,2093,2168,0.491199249002582,0.0127663514624012,0.312503616940011,0.674730031597588
14,"Sachsen",14524300,"Werdau, Stadt",21546,10431,11115,0.484126984126984,22303,10844,11459,0.486212617136708,0.0127663514624012,0.312503616940011,0.674730031597588
14,"Sachsen",14524310,"Wildenfels, Stadt",3861,1924,1937,0.498316498316498,3843,1916,1927,0.498568826437679,0.0127663514624012,0.312503616940011,0.674730031597588
14,"Sachsen",14524320,"Wilkau-Haßlau, Stadt",10511,4954,5557,0.471315764437256,10774,5113,5661,0.474568405420457,0.0127663514624012,0.312503616940011,0.674730031597588
14,"Sachsen",14524330,"Zwickau, Stadt",92826,44890,47936,0.483592958869282,93128,45036,48092,0.483592474873293,0.0127663514624012,0.312503616940011,0.674730031597588
14,"Sachsen",14612000,"Dresden, Stadt",517765,254096,263669,0.490755458557454,529781,260936,268845,0.492535594896759,0.0127663514624012,0.312503616940011,0.674730031597588
14,"Sachsen",14625010,"Arnsdorf",4731,2453,2278,0.518495032762629,4649,2372,2277,0.510217251021725,0.0127663514624012,0.312503616940011,0.674730031597588
14,"Sachsen",14625020,"Bautzen, Stadt",40140,19331,20809,0.481589436970603,40457,19409,21048,0.479743925649455,0.0127663514624012,0.312503616940011,0.674730031597588
14,"Sachsen",14625030,"Bernsdorf, Stadt",5826,2887,2939,0.495537246824579,5878,2958,2920,0.503232391970058,0.0127663514624012,0.312503616940011,0.674730031597588
14,"Sachsen",14625040,"Bischofswerda, Stadt",11797,5677,6120,0.481224040010172,11964,5760,6204,0.481444332998997,0.0127663514624012,0.312503616940011,0.674730031597588
14,"Sachsen",14625050,"Bretnig-Hauswalde",2987,1478,1509,0.494810847003683,3051,1512,1539,0.495575221238938,0.0127663514624012,0.312503616940011,0.674730031597588
14,"Sachsen",14625060,"Burkau",2771,1411,1360,0.50920245398773,2838,1437,1401,0.506342494714588,0.0127663514624012,0.312503616940011,0.674730031597588
14,"Sachsen",14625080,"Crostwitz",1039,526,513,0.506256015399423,1051,533,518,0.507136060894386,0.0127663514624012,0.312503616940011,0.674730031597588
14,"Sachsen",14625090,"Cunewalde",4979,2450,2529,0.492066680056236,5050,2508,2542,0.496633663366337,0.0127663514624012,0.312503616940011,0.674730031597588
14,"Sachsen",14625100,"Demitz-Thumitz",2811,1411,1400,0.501956599075062,2810,1402,1408,0.498932384341637,0.0127663514624012,0.312503616940011,0.674730031597588
14,"Sachsen",14625110,"Doberschau-Gaußig",4276,2203,2073,0.515201122544434,4368,2236,2132,0.511904761904762,0.0127663514624012,0.312503616940011,0.674730031597588
14,"Sachsen",14625120,"Elsterheide",3707,1877,1830,0.506339357971406,3757,1901,1856,0.505988820867714,0.0127663514624012,0.312503616940011,0.674730031597588
14,"Sachsen",14625130,"Elstra, Stadt",2909,1466,1443,0.503953248539017,2940,1481,1459,0.503741496598639,0.0127663514624012,0.312503616940011,0.674730031597588
14,"Sachsen",14625140,"Frankenthal",973,486,487,0.499486125385406,957,474,483,0.495297805642633,0.0127663514624012,0.312503616940011,0.674730031597588
14,"Sachsen",14625150,"Göda",3201,1607,1594,0.502030615432677,3224,1629,1595,0.505272952853598,0.0127663514624012,0.312503616940011,0.674730031597588
14,"Sachsen",14625160,"Großdubrau",4357,2201,2156,0.505164103741106,4399,2236,2163,0.508297340304615,0.0127663514624012,0.312503616940011,0.674730031597588
14,"Sachsen",14625170,"Großharthau",2992,1547,1445,0.517045454545455,3218,1721,1497,0.53480422622747,0.0127663514624012,0.312503616940011,0.674730031597588
14,"Sachsen",14625180,"Großnaundorf",999,491,508,0.491491491491492,1001,488,513,0.487512487512487,0.0127663514624012,0.312503616940011,0.674730031597588
14,"Sachsen",14625190,"Großpostwitz/O.L.",2802,1375,1427,0.490720913633119,2815,1387,1428,0.492717584369449,0.0127663514624012,0.312503616940011,0.674730031597588
14,"Sachsen",14625200,"Großröhrsdorf, Stadt",6647,3221,3426,0.484579509553182,6773,3287,3486,0.485309316403366,0.0127663514624012,0.312503616940011,0.674730031597588
14,"Sachsen",14625210,"Guttau",1560,790,770,0.506410256410256,1581,798,783,0.504743833017078,0.0127663514624012,0.312503616940011,0.674730031597588
14,"Sachsen",14625220,"Haselbachtal",4178,2131,2047,0.510052656773576,4221,2161,2060,0.51196398957593,0.0127663514624012,0.312503616940011,0.674730031597588
14,"Sachsen",14625230,"Hochkirch",2393,1217,1176,0.50856665273715,2430,1230,1200,0.506172839506173,0.0127663514624012,0.312503616940011,0.674730031597588
14,"Sachsen",14625240,"Hoyerswerda, Stadt",35673,17095,18578,0.479213971350882,36687,17669,19018,0.481614740916401,0.0127663514624012,0.312503616940011,0.674730031597588
14,"Sachsen",14625250,"Kamenz, Stadt",15483,7611,7872,0.4915714008913,16817,8577,8240,0.510019623000535,0.0127663514624012,0.312503616940011,0.674730031597588
14,"Sachsen",14625270,"Königsbrück, Stadt",4362,2127,2235,0.487620357634113,4414,2129,2285,0.482328953330313,0.0127663514624012,0.312503616940011,0.674730031597588
14,"Sachsen",14625280,"Königswartha",3695,1829,1866,0.494993234100135,3701,1823,1878,0.492569575790327,0.0127663514624012,0.312503616940011,0.674730031597588
14,"Sachsen",14625290,"Kubschütz",2677,1351,1326,0.50466940605155,2719,1371,1348,0.504229496138286,0.0127663514624012,0.312503616940011,0.674730031597588
14,"Sachsen",14625300,"Laußnitz",1932,987,945,0.510869565217391,1945,1017,928,0.522879177377892,0.0127663514624012,0.312503616940011,0.674730031597588
14,"Sachsen",14625310,"Lauta, Stadt",9084,4470,4614,0.492073976221929,9247,4573,4674,0.494538769330594,0.0127663514624012,0.312503616940011,0.674730031597588
14,"Sachsen",14625320,"Lichtenberg",1652,830,822,0.502421307506053,1649,830,819,0.503335354760461,0.0127663514624012,0.312503616940011,0.674730031597588
14,"Sachsen",14625330,"Lohsa",5685,2809,2876,0.494107299912049,5695,2839,2856,0.498507462686567,0.0127663514624012,0.312503616940011,0.674730031597588
14,"Sachsen",14625340,"Malschwitz",3456,1732,1724,0.501157407407407,3489,1732,1757,0.496417311550588,0.0127663514624012,0.312503616940011,0.674730031597588
14,"Sachsen",14625350,"Nebelschütz",1196,622,574,0.520066889632107,1205,625,580,0.518672199170125,0.0127663514624012,0.312503616940011,0.674730031597588
14,"Sachsen",14625360,"Neschwitz",2512,1278,1234,0.508757961783439,2486,1251,1235,0.503218020917136,0.0127663514624012,0.312503616940011,0.674730031597588
14,"Sachsen",14625370,"Neukirch",1725,872,853,0.505507246376812,1661,847,814,0.509933774834437,0.0127663514624012,0.312503616940011,0.674730031597588
14,"Sachsen",14625380,"Neukirch/Lausitz",5153,2524,2629,0.489811760139724,5204,2551,2653,0.490199846272098,0.0127663514624012,0.312503616940011,0.674730031597588
14,"Sachsen",14625390,"Obergurig",2079,1057,1022,0.508417508417508,2112,1078,1034,0.510416666666667,0.0127663514624012,0.312503616940011,0.674730031597588
14,"Sachsen",14625410,"Ohorn",2383,1195,1188,0.501468736886278,2387,1210,1177,0.506912442396313,0.0127663514624012,0.312503616940011,0.674730031597588
14,"Sachsen",14625420,"Oßling",2394,1246,1148,0.52046783625731,2438,1289,1149,0.528712059064807,0.0127663514624012,0.312503616940011,0.674730031597588
14,"Sachsen",14625430,"Ottendorf-Okrilla",9843,4914,4929,0.499238037183785,9826,4892,4934,0.497862812945247,0.0127663514624012,0.312503616940011,0.674730031597588
14,"Sachsen",14625440,"Panschwitz-Kuckau",2128,1024,1104,0.481203007518797,2103,1007,1096,0.478839752734189,0.0127663514624012,0.312503616940011,0.674730031597588
14,"Sachsen",14625450,"Pulsnitz, Stadt",7615,3696,3919,0.485357846355877,7663,3727,3936,0.486363043194571,0.0127663514624012,0.312503616940011,0.674730031597588
14,"Sachsen",14625460,"Puschwitz",861,438,423,0.508710801393728,906,456,450,0.503311258278146,0.0127663514624012,0.312503616940011,0.674730031597588
14,"Sachsen",14625470,"Räckelwitz",1118,549,569,0.491055456171735,1160,572,588,0.493103448275862,0.0127663514624012,0.312503616940011,0.674730031597588
14,"Sachsen",14625480,"Radeberg, Stadt",18097,8819,9278,0.487318340056363,18374,9001,9373,0.489877000108849,0.0127663514624012,0.312503616940011,0.674730031597588
14,"Sachsen",14625490,"Radibor",3268,1664,1604,0.509179926560588,3316,1685,1631,0.508142340168878,0.0127663514624012,0.312503616940011,0.674730031597588
14,"Sachsen",14625500,"Ralbitz-Rosenthal",1718,911,807,0.530267753201397,1735,912,823,0.525648414985591,0.0127663514624012,0.312503616940011,0.674730031597588
14,"Sachsen",14625510,"Rammenau",1437,713,724,0.496172581767571,1437,712,725,0.495476687543493,0.0127663514624012,0.312503616940011,0.674730031597588
14,"Sachsen",14625525,"Schirgiswalde-Kirschau, Stadt",6701,3345,3356,0.499179226981048,6759,3373,3386,0.499038319278,0.0127663514624012,0.312503616940011,0.674730031597588
14,"Sachsen",14625530,"Schmölln-Putzkau",3164,1573,1591,0.497155499367889,3182,1592,1590,0.500314267756128,0.0127663514624012,0.312503616940011,0.674730031597588
14,"Sachsen",14625540,"Schönteichen",2211,1112,1099,0.502939846223428,2224,1119,1105,0.503147482014389,0.0127663514624012,0.312503616940011,0.674730031597588
14,"Sachsen",14625550,"Schwepnitz",2570,1309,1261,0.509338521400778,2591,1308,1283,0.504824392126592,0.0127663514624012,0.312503616940011,0.674730031597588
14,"Sachsen",14625560,"Sohland a. d. Spree",7076,3493,3583,0.493640474844545,7147,3528,3619,0.493633692458374,0.0127663514624012,0.312503616940011,0.674730031597588
14,"Sachsen",14625570,"Spreetal",1978,1011,967,0.511122345803842,2005,1026,979,0.511720698254364,0.0127663514624012,0.312503616940011,0.674730031597588
14,"Sachsen",14625580,"Steina",1714,857,857,0.5,1724,864,860,0.501160092807425,0.0127663514624012,0.312503616940011,0.674730031597588
14,"Sachsen",14625590,"Steinigtwolmsdorf",3015,1519,1496,0.503814262023217,3094,1562,1532,0.504848093083387,0.0127663514624012,0.312503616940011,0.674730031597588
14,"Sachsen",14625600,"Wachau",4350,2229,2121,0.512413793103448,4384,2255,2129,0.514370437956204,0.0127663514624012,0.312503616940011,0.674730031597588
14,"Sachsen",14625610,"Weißenberg, Stadt",3343,1719,1624,0.514208794495962,3345,1728,1617,0.516591928251121,0.0127663514624012,0.312503616940011,0.674730031597588
14,"Sachsen",14625620,"Wiednitz",890,436,454,0.489887640449438,948,478,470,0.5042194092827,0.0127663514624012,0.312503616940011,0.674730031597588
14,"Sachsen",14625630,"Wilthen, Stadt",5431,2603,2828,0.479285582765605,5499,2642,2857,0.480450991089289,0.0127663514624012,0.312503616940011,0.674730031597588
14,"Sachsen",14625640,"Wittichenau, Stadt",5874,2917,2957,0.496595165134491,5908,2939,2969,0.497461069735951,0.0127663514624012,0.312503616940011,0.674730031597588
14,"Sachsen",14626010,"Bad Muskau, Stadt",3691,1826,1865,0.494716878894609,3802,1882,1920,0.495002630194634,0.0127663514624012,0.312503616940011,0.674730031597588
14,"Sachsen",14626020,"Beiersdorf",1225,620,605,0.506122448979592,1233,626,607,0.507704785077048,0.0127663514624012,0.312503616940011,0.674730031597588
14,"Sachsen",14626030,"Bernstadt a. d. Eigen, Stadt",3617,1808,1809,0.499861763892729,3711,1865,1846,0.502559956884937,0.0127663514624012,0.312503616940011,0.674730031597588
14,"Sachsen",14626040,"Berthelsdorf",1612,777,835,0.482009925558313,1630,787,843,0.482822085889571,0.0127663514624012,0.312503616940011,0.674730031597588
14,"Sachsen",14626050,"Bertsdorf-Hörnitz",2227,1128,1099,0.506511001347104,2276,1155,1121,0.507469244288225,0.0127663514624012,0.312503616940011,0.674730031597588
14,"Sachsen",14626060,"Boxberg/O.L.",4922,2477,2445,0.503250711093052,5045,2538,2507,0.503072348860258,0.0127663514624012,0.312503616940011,0.674730031597588
14,"Sachsen",14626070,"Dürrhennersdorf",1069,531,538,0.496725912067353,1101,541,560,0.491371480472298,0.0127663514624012,0.312503616940011,0.674730031597588
14,"Sachsen",14626085,"Ebersbach-Neugersdorf, Stadt",13492,6551,6941,0.485546990809369,13662,6679,6983,0.488874249743815,0.0127663514624012,0.312503616940011,0.674730031597588
14,"Sachsen",14626090,"Eibau",4420,2142,2278,0.484615384615385,4481,2179,2302,0.486275384958715,0.0127663514624012,0.312503616940011,0.674730031597588
14,"Sachsen",14626100,"Gablenz",1724,875,849,0.50754060324826,1753,896,857,0.511123787792356,0.0127663514624012,0.312503616940011,0.674730031597588
14,"Sachsen",14626110,"Görlitz, Stadt",54283,25841,28442,0.47604222316379,55350,26565,28785,0.479945799457995,0.0127663514624012,0.312503616940011,0.674730031597588
14,"Sachsen",14626120,"Groß Düben",1136,584,552,0.514084507042254,1220,617,603,0.505737704918033,0.0127663514624012,0.312503616940011,0.674730031597588
14,"Sachsen",14626140,"Großschönau",5871,2863,3008,0.487651166751831,5929,2916,3013,0.491819868443245,0.0127663514624012,0.312503616940011,0.674730031597588
14,"Sachsen",14626150,"Großschweidnitz",1342,693,649,0.516393442622951,1369,711,658,0.519357195032871,0.0127663514624012,0.312503616940011,0.674730031597588
14,"Sachsen",14626160,"Hähnichen",1344,683,661,0.508184523809524,1350,683,667,0.505925925925926,0.0127663514624012,0.312503616940011,0.674730031597588
14,"Sachsen",14626170,"Hainewalde",1611,818,793,0.507759155803849,1638,837,801,0.510989010989011,0.0127663514624012,0.312503616940011,0.674730031597588
14,"Sachsen",14626180,"Herrnhut, Stadt",4807,2349,2458,0.488662367380903,4924,2407,2517,0.488830219333875,0.0127663514624012,0.312503616940011,0.674730031597588
14,"Sachsen",14626190,"Hohendubrau",2011,1011,1000,0.502734957732471,2084,1051,1033,0.504318618042226,0.0127663514624012,0.312503616940011,0.674730031597588
14,"Sachsen",14626200,"Horka",1870,949,921,0.507486631016043,1869,949,920,0.507758159443553,0.0127663514624012,0.312503616940011,0.674730031597588
14,"Sachsen",14626210,"Jonsdorf, Kurort",1687,810,877,0.48014226437463,1722,821,901,0.476771196283391,0.0127663514624012,0.312503616940011,0.674730031597588
14,"Sachsen",14626230,"Kodersdorf",2564,1303,1261,0.508190327613105,2579,1306,1273,0.506397828615743,0.0127663514624012,0.312503616940011,0.674730031597588
14,"Sachsen",14626240,"Königshain",1233,624,609,0.506082725060827,1244,621,623,0.4991961414791,0.0127663514624012,0.312503616940011,0.674730031597588
14,"Sachsen",14626250,"Krauschwitz",3627,1787,1840,0.492693686242073,3622,1783,1839,0.492269464384318,0.0127663514624012,0.312503616940011,0.674730031597588
14,"Sachsen",14626260,"Kreba-Neudorf",954,475,479,0.4979035639413,975,493,482,0.505641025641026,0.0127663514624012,0.312503616940011,0.674730031597588
14,"Sachsen",14626270,"Lawalde",1964,959,1005,0.488289205702648,1985,969,1016,0.48816120906801,0.0127663514624012,0.312503616940011,0.674730031597588
14,"Sachsen",14626280,"Leutersdorf",3806,1876,1930,0.492905937992643,3851,1885,1966,0.489483251103609,0.0127663514624012,0.312503616940011,0.674730031597588
14,"Sachsen",14626290,"Löbau, Stadt",15748,7541,8207,0.478854457708915,15944,7645,8299,0.47949071751129,0.0127663514624012,0.312503616940011,0.674730031597588
14,"Sachsen",14626300,"Markersdorf",4071,2092,1979,0.513878653893392,4111,2104,2007,0.511797616151788,0.0127663514624012,0.312503616940011,0.674730031597588
14,"Sachsen",14626310,"Mittelherwigsdorf",3744,1896,1848,0.506410256410256,3829,1952,1877,0.509793679811961,0.0127663514624012,0.312503616940011,0.674730031597588
14,"Sachsen",14626320,"Mücka",1057,540,517,0.510879848628193,1101,565,536,0.513169845594914,0.0127663514624012,0.312503616940011,0.674730031597588
14,"Sachsen",14626330,"Neißeaue",1811,895,916,0.494202098288239,1844,911,933,0.494034707158351,0.0127663514624012,0.312503616940011,0.674730031597588
14,"Sachsen",14626350,"Neusalza-Spremberg, Stadt",3497,1704,1793,0.487274806977409,3536,1744,1792,0.493212669683258,0.0127663514624012,0.312503616940011,0.674730031597588
14,"Sachsen",14626360,"Niedercunnersdorf",1543,778,765,0.504212572909916,1576,795,781,0.504441624365482,0.0127663514624012,0.312503616940011,0.674730031597588
14,"Sachsen",14626370,"Niesky, Stadt",9829,4777,5052,0.48601078441347,9901,4828,5073,0.487627512372488,0.0127663514624012,0.312503616940011,0.674730031597588
14,"Sachsen",14626380,"Obercunnersdorf",2026,967,1059,0.477295162882527,2029,967,1062,0.476589452932479,0.0127663514624012,0.312503616940011,0.674730031597588
14,"Sachsen",14626390,"Oderwitz",5454,2664,2790,0.488448844884488,5494,2671,2823,0.486166727338915,0.0127663514624012,0.312503616940011,0.674730031597588
14,"Sachsen",14626400,"Olbersdorf",5391,2572,2819,0.477091448710814,5444,2582,2862,0.474283614988979,0.0127663514624012,0.312503616940011,0.674730031597588
14,"Sachsen",14626410,"Oppach",2552,1239,1313,0.485501567398119,2725,1340,1385,0.491743119266055,0.0127663514624012,0.312503616940011,0.674730031597588
14,"Sachsen",14626420,"Ostritz, Stadt",2487,1213,1274,0.487736228387616,2517,1227,1290,0.487485101311085,0.0127663514624012,0.312503616940011,0.674730031597588
14,"Sachsen",14626430,"Oybin",1496,726,770,0.485294117647059,1510,752,758,0.498013245033113,0.0127663514624012,0.312503616940011,0.674730031597588
14,"Sachsen",14626440,"Quitzdorf am See",1301,640,661,0.491929285165257,1345,666,679,0.495167286245353,0.0127663514624012,0.312503616940011,0.674730031597588
14,"Sachsen",14626450,"Reichenbach/O.L., Stadt",3883,1906,1977,0.490857584342004,3870,1916,1954,0.495090439276486,0.0127663514624012,0.312503616940011,0.674730031597588
14,"Sachsen",14626460,"Rietschen",2738,1323,1415,0.483199415631848,2790,1353,1437,0.48494623655914,0.0127663514624012,0.312503616940011,0.674730031597588
14,"Sachsen",14626470,"Rosenbach",1675,833,842,0.497313432835821,1684,842,842,0.5,0.0127663514624012,0.312503616940011,0.674730031597588
14,"Sachsen",14626480,"Rothenburg/O.L., Stadt",5011,2566,2445,0.512073438435442,5097,2594,2503,0.508926819697861,0.0127663514624012,0.312503616940011,0.674730031597588
14,"Sachsen",14626490,"Schleife",2658,1327,1331,0.499247554552295,2697,1339,1358,0.496477567667779,0.0127663514624012,0.312503616940011,0.674730031597588
14,"Sachsen",14626500,"Schönau-Berzdorf a. d. Eigen",1570,793,777,0.505095541401274,1577,805,772,0.510462904248573,0.0127663514624012,0.312503616940011,0.674730031597588
14,"Sachsen",14626510,"Schönbach",1164,586,578,0.503436426116838,1232,621,611,0.504058441558442,0.0127663514624012,0.312503616940011,0.674730031597588
14,"Sachsen",14626520,"Schöpstal",2514,1269,1245,0.504773269689737,2519,1267,1252,0.502977371973005,0.0127663514624012,0.312503616940011,0.674730031597588
14,"Sachsen",14626530,"Seifhennersdorf, Stadt",4013,1976,2037,0.492399700971841,4128,2045,2083,0.495397286821705,0.0127663514624012,0.312503616940011,0.674730031597588
14,"Sachsen",14626540,"Sohland a. Rotstein",1320,664,656,0.503030303030303,1348,680,668,0.504451038575668,0.0127663514624012,0.312503616940011,0.674730031597588
14,"Sachsen",14626560,"Trebendorf",979,485,494,0.495403472931563,986,489,497,0.495943204868154,0.0127663514624012,0.312503616940011,0.674730031597588
14,"Sachsen",14626570,"Vierkirchen",1782,897,885,0.503367003367003,1835,922,913,0.502452316076294,0.0127663514624012,0.312503616940011,0.674730031597588
14,"Sachsen",14626580,"Waldhufen",2647,1379,1268,0.520967132602947,2670,1408,1262,0.527340823970037,0.0127663514624012,0.312503616940011,0.674730031597588
14,"Sachsen",14626590,"Weißkeißel",1317,685,632,0.520121488230828,1330,691,639,0.519548872180451,0.0127663514624012,0.312503616940011,0.674730031597588
14,"Sachsen",14626600,"Weißwasser/O.L., Stadt",17887,8626,9261,0.482249678537485,18592,9095,9497,0.489188898450947,0.0127663514624012,0.312503616940011,0.674730031597588
14,"Sachsen",14626610,"Zittau, Stadt",26541,12745,13796,0.480200444595155,27845,13470,14375,0.483749326629556,0.0127663514624012,0.312503616940011,0.674730031597588
14,"Sachsen",14627010,"Coswig, Stadt",20669,9827,10842,0.475446320576709,21157,10165,10992,0.480455641158955,0.0127663514624012,0.312503616940011,0.674730031597588
14,"Sachsen",14627020,"Diera-Zehren",3416,1730,1686,0.506440281030445,3505,1771,1734,0.50527817403709,0.0127663514624012,0.312503616940011,0.674730031597588
14,"Sachsen",14627030,"Ebersbach",4548,2301,2247,0.505936675461741,4617,2357,2260,0.510504656703487,0.0127663514624012,0.312503616940011,0.674730031597588
14,"Sachsen",14627040,"Glaubitz",2083,1149,934,0.551608257321171,2032,1091,941,0.536909448818898,0.0127663514624012,0.312503616940011,0.674730031597588
14,"Sachsen",14627050,"Gröditz, Stadt",6766,3294,3472,0.486845994679279,6919,3405,3514,0.492123139181963,0.0127663514624012,0.312503616940011,0.674730031597588
14,"Sachsen",14627060,"Großenhain, Stadt",18691,9140,9551,0.489005403670216,19324,9527,9797,0.493013868764231,0.0127663514624012,0.312503616940011,0.674730031597588
14,"Sachsen",14627070,"Hirschstein",2180,1108,1072,0.508256880733945,2257,1138,1119,0.504209127159947,0.0127663514624012,0.312503616940011,0.674730031597588
14,"Sachsen",14627080,"Käbschütztal",2755,1408,1347,0.511070780399274,2831,1447,1384,0.511126810314377,0.0127663514624012,0.312503616940011,0.674730031597588
14,"Sachsen",14627090,"Ketzerbachtal",2585,1336,1249,0.516827852998066,2660,1369,1291,0.514661654135338,0.0127663514624012,0.312503616940011,0.674730031597588
14,"Sachsen",14627100,"Klipphausen",6080,3092,2988,0.508552631578947,6200,3166,3034,0.510645161290323,0.0127663514624012,0.312503616940011,0.674730031597588
14,"Sachsen",14627110,"Lampertswalde",1846,945,901,0.511917659804984,1888,974,914,0.515889830508475,0.0127663514624012,0.312503616940011,0.674730031597588
14,"Sachsen",14627120,"Leuben-Schleinitz",1333,668,665,0.50112528132033,1390,693,697,0.498561151079137,0.0127663514624012,0.312503616940011,0.674730031597588
14,"Sachsen",14627130,"Lommatzsch, Stadt",5357,2568,2789,0.479372783274221,5346,2573,2773,0.48129442573887,0.0127663514624012,0.312503616940011,0.674730031597588
14,"Sachsen",14627140,"Meißen, Stadt",27112,12986,14126,0.47897609914429,27555,13259,14296,0.481183088368717,0.0127663514624012,0.312503616940011,0.674730031597588
14,"Sachsen",14627150,"Moritzburg",8266,4089,4177,0.494676990079845,8311,4135,4176,0.497533389483817,0.0127663514624012,0.312503616940011,0.674730031597588
14,"Sachsen",14627160,"Nauwalde",1022,525,497,0.513698630136986,1025,515,510,0.502439024390244,0.0127663514624012,0.312503616940011,0.674730031597588
14,"Sachsen",14627170,"Niederau",3976,1983,1993,0.49874245472837,4013,2006,2007,0.499875404933965,0.0127663514624012,0.312503616940011,0.674730031597588
14,"Sachsen",14627180,"Nossen, Stadt",7038,3378,3660,0.47996589940324,7117,3413,3704,0.479555992693551,0.0127663514624012,0.312503616940011,0.674730031597588
14,"Sachsen",14627190,"Nünchritz",5877,2893,2984,0.492257954738812,6023,2978,3045,0.494437987713764,0.0127663514624012,0.312503616940011,0.674730031597588
14,"Sachsen",14627200,"Priestewitz",3291,1701,1590,0.516864175022789,3351,1739,1612,0.518949567293345,0.0127663514624012,0.312503616940011,0.674730031597588
14,"Sachsen",14627210,"Radebeul, Stadt",33259,16116,17143,0.484560570071259,33769,16429,17340,0.486511297343718,0.0127663514624012,0.312503616940011,0.674730031597588
14,"Sachsen",14627220,"Radeburg, Stadt",7476,3718,3758,0.497324772605671,7526,3758,3768,0.499335636460271,0.0127663514624012,0.312503616940011,0.674730031597588
14,"Sachsen",14627230,"Riesa, Stadt",32283,15666,16617,0.485270885605427,33549,16338,17211,0.486989180005365,0.0127663514624012,0.312503616940011,0.674730031597588
14,"Sachsen",14627240,"Röderaue",2899,1465,1434,0.505346671265954,2905,1465,1440,0.504302925989673,0.0127663514624012,0.312503616940011,0.674730031597588
14,"Sachsen",14627250,"Schönfeld",1901,927,974,0.487638085218306,1912,930,982,0.486401673640167,0.0127663514624012,0.312503616940011,0.674730031597588
14,"Sachsen",14627260,"Stauchitz",3233,1633,1600,0.505103618929787,3304,1682,1622,0.5090799031477,0.0127663514624012,0.312503616940011,0.674730031597588
14,"Sachsen",14627270,"Strehla, Stadt",3901,1905,1996,0.488336324019482,3979,1929,2050,0.484795174667002,0.0127663514624012,0.312503616940011,0.674730031597588
14,"Sachsen",14627280,"Tauscha",1442,736,706,0.510402219140083,1460,744,716,0.50958904109589,0.0127663514624012,0.312503616940011,0.674730031597588
14,"Sachsen",14627290,"Thiendorf",2216,1146,1070,0.517148014440433,2214,1157,1057,0.522583559168925,0.0127663514624012,0.312503616940011,0.674730031597588
14,"Sachsen",14627300,"Triebischtal",4154,2110,2044,0.507944150216659,4258,2162,2096,0.507750117426022,0.0127663514624012,0.312503616940011,0.674730031597588
14,"Sachsen",14627310,"Weinböhla",10068,4916,5152,0.488279698053238,10328,5079,5249,0.491769945778466,0.0127663514624012,0.312503616940011,0.674730031597588
14,"Sachsen",14627320,"Weißig a. Raschütz",874,450,424,0.51487414187643,895,453,442,0.506145251396648,0.0127663514624012,0.312503616940011,0.674730031597588
14,"Sachsen",14627340,"Wülknitz",1657,845,812,0.509957754978878,1700,856,844,0.503529411764706,0.0127663514624012,0.312503616940011,0.674730031597588
14,"Sachsen",14627360,"Zeithain",5983,3002,2981,0.501754972421862,6008,3008,3000,0.500665778961385,0.0127663514624012,0.312503616940011,0.674730031597588
14,"Sachsen",14628010,"Altenberg, Stadt",8429,4229,4200,0.501720251512635,8548,4347,4201,0.508540009358914,0.0127663514624012,0.312503616940011,0.674730031597588
14,"Sachsen",14628020,"Bad Gottleuba-Berggießhübel, Stadt",5741,2849,2892,0.496255007838356,5761,2878,2883,0.499566047561187,0.0127663514624012,0.312503616940011,0.674730031597588
14,"Sachsen",14628030,"Bad Schandau, Stadt",2814,1394,1420,0.495380241648898,2794,1370,1424,0.490336435218325,0.0127663514624012,0.312503616940011,0.674730031597588
14,"Sachsen",14628040,"Bahretal",2219,1114,1105,0.502027940513745,2202,1107,1095,0.502724795640327,0.0127663514624012,0.312503616940011,0.674730031597588
14,"Sachsen",14628050,"Bannewitz",10354,5032,5322,0.485995750434615,10643,5242,5401,0.49253030160669,0.0127663514624012,0.312503616940011,0.674730031597588
14,"Sachsen",14628060,"Dippoldiswalde, Stadt",10114,4897,5217,0.484180344077516,10228,5004,5224,0.489245209229566,0.0127663514624012,0.312503616940011,0.674730031597588
14,"Sachsen",14628070,"Dohma",1968,991,977,0.503556910569106,2046,1041,1005,0.508797653958944,0.0127663514624012,0.312503616940011,0.674730031597588
14,"Sachsen",14628080,"Dohna, Stadt",6108,3047,3061,0.498853962017027,6118,3048,3070,0.498202026806146,0.0127663514624012,0.312503616940011,0.674730031597588
14,"Sachsen",14628090,"Dorfhain",1114,545,569,0.489228007181329,1132,560,572,0.49469964664311,0.0127663514624012,0.312503616940011,0.674730031597588
14,"Sachsen",14628100,"Dürrröhrsdorf-Dittersbach",4268,2155,2113,0.504920337394564,4325,2163,2162,0.500115606936416,0.0127663514624012,0.312503616940011,0.674730031597588
14,"Sachsen",14628110,"Freital, Stadt",38449,18665,19784,0.485448256131499,39329,19377,19952,0.492689872613085,0.0127663514624012,0.312503616940011,0.674730031597588
14,"Sachsen",14628130,"Glashütte, Stadt",6969,3526,3443,0.505954943320419,7071,3570,3501,0.504879083580823,0.0127663514624012,0.312503616940011,0.674730031597588
14,"Sachsen",14628140,"Gohrisch",2045,1017,1028,0.497310513447433,2114,1054,1060,0.498580889309366,0.0127663514624012,0.312503616940011,0.674730031597588
14,"Sachsen",14628150,"Hartmannsdorf-Reichenau",1122,564,558,0.502673796791444,1127,556,571,0.493345164152618,0.0127663514624012,0.312503616940011,0.674730031597588
14,"Sachsen",14628160,"Heidenau, Stadt",15981,7836,8145,0.490332269570114,16423,8180,8243,0.498081958229313,0.0127663514624012,0.312503616940011,0.674730031597588
14,"Sachsen",14628170,"Hermsdorf/Erzgeb.",857,431,426,0.50291715285881,899,454,445,0.505005561735261,0.0127663514624012,0.312503616940011,0.674730031597588
14,"Sachsen",14628180,"Höckendorf",2942,1451,1491,0.493201903467029,2950,1458,1492,0.494237288135593,0.0127663514624012,0.312503616940011,0.674730031597588
14,"Sachsen",14628190,"Hohnstein, Stadt",3471,1727,1744,0.497551138000576,3468,1733,1735,0.499711649365629,0.0127663514624012,0.312503616940011,0.674730031597588
14,"Sachsen",14628200,"Kirnitzschtal",2004,1019,985,0.508483033932136,2083,1056,1027,0.506961113778205,0.0127663514624012,0.312503616940011,0.674730031597588
14,"Sachsen",14628210,"Königstein/Sächs. Schw., Stadt",2248,1137,1111,0.505782918149466,2253,1142,1111,0.50687971593431,0.0127663514624012,0.312503616940011,0.674730031597588
14,"Sachsen",14628220,"Kreischa",4383,2164,2219,0.493725758612822,4434,2194,2240,0.494812810103744,0.0127663514624012,0.312503616940011,0.674730031597588
14,"Sachsen",14628230,"Liebstadt, Stadt",1369,710,659,0.518626734842951,1321,697,624,0.527630582891749,0.0127663514624012,0.312503616940011,0.674730031597588
14,"Sachsen",14628240,"Lohmen",3135,1516,1619,0.483572567783094,3155,1526,1629,0.483676703645008,0.0127663514624012,0.312503616940011,0.674730031597588
14,"Sachsen",14628250,"Müglitztal",1997,1006,991,0.503755633450175,2042,1037,1005,0.507835455435847,0.0127663514624012,0.312503616940011,0.674730031597588
14,"Sachsen",14628260,"Neustadt i. Sa., Stadt",13134,6426,6708,0.489264504339881,13514,6660,6854,0.492822258398698,0.0127663514624012,0.312503616940011,0.674730031597588
14,"Sachsen",14628270,"Pirna, Stadt",37579,18068,19511,0.480800447058197,38735,18765,19970,0.484445591842003,0.0127663514624012,0.312503616940011,0.674730031597588
14,"Sachsen",14628280,"Porschdorf",1174,584,590,0.497444633730835,1215,610,605,0.502057613168724,0.0127663514624012,0.312503616940011,0.674730031597588
14,"Sachsen",14628290,"Pretzschendorf",4020,2046,1974,0.508955223880597,4069,2077,1992,0.510444826738756,0.0127663514624012,0.312503616940011,0.674730031597588
14,"Sachsen",14628300,"Rabenau, Stadt",4346,2211,2135,0.508743672342384,4420,2246,2174,0.50814479638009,0.0127663514624012,0.312503616940011,0.674730031597588
14,"Sachsen",14628310,"Rathen, Kurort",362,181,181,0.5,375,186,189,0.496,0.0127663514624012,0.312503616940011,0.674730031597588
14,"Sachsen",14628320,"Rathmannsdorf",1001,471,530,0.470529470529471,1006,477,529,0.474155069582505,0.0127663514624012,0.312503616940011,0.674730031597588
14,"Sachsen",14628330,"Reinhardtsdorf-Schöna",1417,722,695,0.509527170077629,1454,746,708,0.513067400275103,0.0127663514624012,0.312503616940011,0.674730031597588
14,"Sachsen",14628340,"Rosenthal-Bielatal",1723,859,864,0.498549042367963,1638,768,870,0.468864468864469,0.0127663514624012,0.312503616940011,0.674730031597588
14,"Sachsen",14628350,"Schmiedeberg",4432,2218,2214,0.500451263537906,4490,2245,2245,0.5,0.0127663514624012,0.312503616940011,0.674730031597588
14,"Sachsen",14628360,"Sebnitz, Stadt",8252,3999,4253,0.484609791565681,8292,4048,4244,0.488181379643029,0.0127663514624012,0.312503616940011,0.674730031597588
14,"Sachsen",14628370,"Stadt Wehlen, Stadt",1665,851,814,0.511111111111111,1676,859,817,0.512529832935561,0.0127663514624012,0.312503616940011,0.674730031597588
14,"Sachsen",14628380,"Stolpen, Stadt",5720,2839,2881,0.496328671328671,5742,2851,2891,0.496516893068617,0.0127663514624012,0.312503616940011,0.674730031597588
14,"Sachsen",14628390,"Struppen",2515,1267,1248,0.503777335984095,2572,1294,1278,0.503110419906687,0.0127663514624012,0.312503616940011,0.674730031597588
14,"Sachsen",14628400,"Tharandt, Stadt",5310,2664,2646,0.501694915254237,5429,2747,2682,0.505986369497145,0.0127663514624012,0.312503616940011,0.674730031597588
14,"Sachsen",14628410,"Wilsdruff, Stadt",13524,6721,6803,0.496968352558415,13767,6883,6884,0.499963681266797,0.0127663514624012,0.312503616940011,0.674730031597588
14,"Sachsen",14713000,"Leipzig, Stadt",510043,245075,264968,0.480498703050527,531809,258599,273210,0.486262925223153,0.0127663514624012,0.312503616940011,0.674730031597588
14,"Sachsen",14729010,"Bad Lausick, Stadt",8279,4031,4248,0.486894552482184,8364,4051,4313,0.484337637494022,0.0127663514624012,0.312503616940011,0.674730031597588
14,"Sachsen",14729020,"Belgershain",3324,1658,1666,0.498796630565584,3388,1697,1691,0.500885478158205,0.0127663514624012,0.312503616940011,0.674730031597588
14,"Sachsen",14729030,"Bennewitz",5014,2515,2499,0.501595532508975,5024,2528,2496,0.503184713375796,0.0127663514624012,0.312503616940011,0.674730031597588
14,"Sachsen",14729040,"Böhlen, Stadt",6718,3266,3452,0.486156594224472,6904,3427,3477,0.496378910776362,0.0127663514624012,0.312503616940011,0.674730031597588
14,"Sachsen",14729050,"Borna, Stadt",19642,9351,10291,0.476071683127991,20405,9910,10495,0.485665278118108,0.0127663514624012,0.312503616940011,0.674730031597588
14,"Sachsen",14729060,"Borsdorf",8225,3987,4238,0.484741641337386,8202,3990,4212,0.48646671543526,0.0127663514624012,0.312503616940011,0.674730031597588
14,"Sachsen",14729070,"Brandis, Stadt",9335,4580,4755,0.490626673808249,9482,4656,4826,0.491035646488083,0.0127663514624012,0.312503616940011,0.674730031597588
14,"Sachsen",14729080,"Colditz, Stadt",9151,4507,4644,0.492514479291881,9283,4571,4712,0.492405472368846,0.0127663514624012,0.312503616940011,0.674730031597588
14,"Sachsen",14729090,"Deutzen",1667,827,840,0.496100779844031,1807,922,885,0.510237963475374,0.0127663514624012,0.312503616940011,0.674730031597588
14,"Sachsen",14729100,"Elstertrebnitz",1332,666,666,0.5,1379,680,699,0.493110949963742,0.0127663514624012,0.312503616940011,0.674730031597588
14,"Sachsen",14729110,"Espenhain",2366,1213,1153,0.512679628064243,2453,1270,1183,0.517733387688545,0.0127663514624012,0.312503616940011,0.674730031597588
14,"Sachsen",14729130,"Falkenhain",3572,1765,1807,0.494120940649496,3675,1828,1847,0.497414965986395,0.0127663514624012,0.312503616940011,0.674730031597588
14,"Sachsen",14729140,"Frohburg, Stadt",10559,5288,5271,0.50080500047353,10732,5407,5325,0.503820350354081,0.0127663514624012,0.312503616940011,0.674730031597588
14,"Sachsen",14729150,"Geithain, Stadt",5716,2769,2947,0.48442967109867,5657,2738,2919,0.484002121265689,0.0127663514624012,0.312503616940011,0.674730031597588
14,"Sachsen",14729160,"Grimma, Stadt",26993,13208,13785,0.489312043863224,27590,13578,14012,0.492134831460674,0.0127663514624012,0.312503616940011,0.674730031597588
14,"Sachsen",14729170,"Groitzsch, Stadt",7700,3754,3946,0.487532467532468,7967,3925,4042,0.492657210995356,0.0127663514624012,0.312503616940011,0.674730031597588
14,"Sachsen",14729190,"Großpösna",5316,2651,2665,0.498683220466516,5447,2724,2723,0.50009179364788,0.0127663514624012,0.312503616940011,0.674730031597588
14,"Sachsen",14729200,"Hohburg",2728,1383,1345,0.506964809384164,2759,1405,1354,0.509242479159116,0.0127663514624012,0.312503616940011,0.674730031597588
14,"Sachsen",14729210,"Kitzen",1869,954,915,0.510433386837881,1880,989,891,0.526063829787234,0.0127663514624012,0.312503616940011,0.674730031597588
14,"Sachsen",14729220,"Kitzscher, Stadt",5290,2585,2705,0.488657844990548,5466,2675,2791,0.489388949871936,0.0127663514624012,0.312503616940011,0.674730031597588
14,"Sachsen",14729230,"Kohren-Sahlis, Stadt",2794,1405,1389,0.50286327845383,2789,1417,1372,0.508067407673001,0.0127663514624012,0.312503616940011,0.674730031597588
14,"Sachsen",14729250,"Machern",6621,3229,3392,0.487690681165987,6643,3224,3419,0.4853228962818,0.0127663514624012,0.312503616940011,0.674730031597588
14,"Sachsen",14729260,"Markkleeberg, Stadt",23754,11436,12318,0.481434705733771,24402,11748,12654,0.481435947873125,0.0127663514624012,0.312503616940011,0.674730031597588
14,"Sachsen",14729270,"Markranstädt, Stadt",14747,7133,7614,0.483691598291178,14941,7319,7622,0.489860116458068,0.0127663514624012,0.312503616940011,0.674730031597588
14,"Sachsen",14729280,"Mutzschen, Stadt",2111,1080,1031,0.511605873993368,2189,1115,1074,0.509365006852444,0.0127663514624012,0.312503616940011,0.674730031597588
14,"Sachsen",14729290,"Narsdorf",1717,873,844,0.508444962143273,1757,895,862,0.509391007398976,0.0127663514624012,0.312503616940011,0.674730031597588
14,"Sachsen",14729300,"Naunhof, Stadt",8435,4146,4289,0.491523414344991,8486,4204,4282,0.495404195144945,0.0127663514624012,0.312503616940011,0.674730031597588
14,"Sachsen",14729320,"Neukieritzsch",5417,2635,2782,0.486431604208972,5514,2701,2813,0.489844033369605,0.0127663514624012,0.312503616940011,0.674730031597588
14,"Sachsen",14729330,"Otterwisch",1443,715,728,0.495495495495495,1464,728,736,0.497267759562842,0.0127663514624012,0.312503616940011,0.674730031597588
14,"Sachsen",14729340,"Parthenstein",3503,1762,1741,0.502997430773623,3606,1821,1785,0.504991680532446,0.0127663514624012,0.312503616940011,0.674730031597588
14,"Sachsen",14729350,"Pegau, Stadt",4580,2188,2392,0.477729257641921,4552,2212,2340,0.485940246045694,0.0127663514624012,0.312503616940011,0.674730031597588
14,"Sachsen",14729360,"Regis-Breitingen, Stadt",4099,2085,2014,0.508660648938766,4014,2032,1982,0.506228201295466,0.0127663514624012,0.312503616940011,0.674730031597588
14,"Sachsen",14729370,"Rötha, Stadt",3670,1808,1862,0.492643051771117,3911,2011,1900,0.514190744055229,0.0127663514624012,0.312503616940011,0.674730031597588
14,"Sachsen",14729380,"Thallwitz",3662,1853,1809,0.50600764609503,3683,1872,1811,0.508281292424654,0.0127663514624012,0.312503616940011,0.674730031597588
14,"Sachsen",14729400,"Trebsen/Mulde, Stadt",4029,2000,2029,0.496401092082403,4034,1999,2035,0.49553792761527,0.0127663514624012,0.312503616940011,0.674730031597588
14,"Sachsen",14729410,"Wurzen, Stadt",16774,8011,8763,0.477584356742578,16680,8040,8640,0.482014388489209,0.0127663514624012,0.312503616940011,0.674730031597588
14,"Sachsen",14729430,"Zwenkau, Stadt",8773,4261,4512,0.485694745241081,8721,4231,4490,0.485150785460383,0.0127663514624012,0.312503616940011,0.674730031597588
14,"Sachsen",14730010,"Arzberg",2032,1031,1001,0.50738188976378,2064,1028,1036,0.498062015503876,0.0127663514624012,0.312503616940011,0.674730031597588
14,"Sachsen",14730020,"Bad Düben, Stadt",8064,3906,4158,0.484375,8150,3974,4176,0.48760736196319,0.0127663514624012,0.312503616940011,0.674730031597588
14,"Sachsen",14730030,"Beilrode",4401,2213,2188,0.50284026357646,4439,2225,2214,0.501239017796801,0.0127663514624012,0.312503616940011,0.674730031597588
14,"Sachsen",14730040,"Belgern, Stadt",4644,2293,2351,0.493755383290267,4735,2332,2403,0.492502639915523,0.0127663514624012,0.312503616940011,0.674730031597588
14,"Sachsen",14730050,"Cavertitz",2342,1201,1141,0.512809564474808,2346,1194,1152,0.508951406649616,0.0127663514624012,0.312503616940011,0.674730031597588
14,"Sachsen",14730060,"Dahlen, Stadt",4547,2208,2339,0.48559489773477,4568,2213,2355,0.484457092819615,0.0127663514624012,0.312503616940011,0.674730031597588
14,"Sachsen",14730070,"Delitzsch, Stadt",25162,12296,12866,0.488673396391384,26035,12810,13225,0.492029959669675,0.0127663514624012,0.312503616940011,0.674730031597588
14,"Sachsen",14730080,"Doberschütz",4180,2119,2061,0.506937799043062,4262,2183,2079,0.512200844673862,0.0127663514624012,0.312503616940011,0.674730031597588
14,"Sachsen",14730090,"Dommitzsch, Stadt",2655,1302,1353,0.490395480225989,2638,1302,1336,0.493555724033359,0.0127663514624012,0.312503616940011,0.674730031597588
14,"Sachsen",14730100,"Dreiheide",2167,1107,1060,0.510844485463775,2307,1172,1135,0.508019072388383,0.0127663514624012,0.312503616940011,0.674730031597588
14,"Sachsen",14730110,"Eilenburg, Stadt",15681,7557,8124,0.48192079586761,16334,8012,8322,0.490510591404432,0.0127663514624012,0.312503616940011,0.674730031597588
14,"Sachsen",14730120,"Elsnig",1484,775,709,0.522237196765499,1586,843,743,0.531525851197982,0.0127663514624012,0.312503616940011,0.674730031597588
14,"Sachsen",14730140,"Jesewitz",3014,1516,1498,0.502986065029861,3053,1530,1523,0.501146413363904,0.0127663514624012,0.312503616940011,0.674730031597588
14,"Sachsen",14730150,"Krostitz",3722,1885,1837,0.50644814615798,3766,1920,1846,0.509824747742963,0.0127663514624012,0.312503616940011,0.674730031597588
14,"Sachsen",14730160,"Laußig",3916,1959,1957,0.500255362614913,4070,2026,2044,0.497788697788698,0.0127663514624012,0.312503616940011,0.674730031597588
14,"Sachsen",14730170,"Liebschützberg",3197,1626,1571,0.508601814200813,3193,1624,1569,0.508612590040714,0.0127663514624012,0.312503616940011,0.674730031597588
14,"Sachsen",14730180,"Löbnitz",2095,1019,1076,0.486396181384248,2140,1040,1100,0.485981308411215,0.0127663514624012,0.312503616940011,0.674730031597588
14,"Sachsen",14730190,"Mockrehna",5149,2593,2556,0.503592930666149,5230,2641,2589,0.504971319311664,0.0127663514624012,0.312503616940011,0.674730031597588
14,"Sachsen",14730200,"Mügeln, Stadt",6399,3160,3239,0.493827160493827,6478,3193,3285,0.49289904291448,0.0127663514624012,0.312503616940011,0.674730031597588
14,"Sachsen",14730210,"Naundorf",2396,1229,1167,0.512938230383973,2488,1276,1212,0.512861736334405,0.0127663514624012,0.312503616940011,0.674730031597588
14,"Sachsen",14730220,"Neukyhna",2256,1130,1126,0.500886524822695,2379,1208,1171,0.507776376628836,0.0127663514624012,0.312503616940011,0.674730031597588
14,"Sachsen",14730230,"Oschatz, Stadt",14991,7323,7668,0.488493095857514,15014,7263,7751,0.483748501398695,0.0127663514624012,0.312503616940011,0.674730031597588
14,"Sachsen",14730250,"Rackwitz",4963,2511,2452,0.505943985492646,5025,2595,2430,0.516417910447761,0.0127663514624012,0.312503616940011,0.674730031597588
14,"Sachsen",14730260,"Schildau, Gneisenaustadt, Stadt",3531,1799,1732,0.509487397337865,3522,1796,1726,0.509937535491198,0.0127663514624012,0.312503616940011,0.674730031597588
14,"Sachsen",14730270,"Schkeuditz, Stadt",16953,8421,8532,0.496726243142807,17463,8779,8684,0.502720036648915,0.0127663514624012,0.312503616940011,0.674730031597588
14,"Sachsen",14730280,"Schönwölkau",2489,1247,1242,0.501004419445561,2532,1262,1270,0.498420221169036,0.0127663514624012,0.312503616940011,0.674730031597588
14,"Sachsen",14730300,"Taucha, Stadt",14142,6776,7366,0.479140149908075,14340,6850,7490,0.47768479776848,0.0127663514624012,0.312503616940011,0.674730031597588
14,"Sachsen",14730310,"Torgau, Stadt",19068,9356,9712,0.490664988462345,19412,9622,9790,0.495672779723882,0.0127663514624012,0.312503616940011,0.674730031597588
14,"Sachsen",14730320,"Trossin",1349,672,677,0.498146775389177,1351,673,678,0.498149518874907,0.0127663514624012,0.312503616940011,0.674730031597588
14,"Sachsen",14730330,"Wermsdorf",5478,2672,2806,0.487769258853596,5519,2677,2842,0.485051639789817,0.0127663514624012,0.312503616940011,0.674730031597588
14,"Sachsen",14730340,"Wiedemar",2054,1044,1010,0.508276533592989,2114,1085,1029,0.513245033112583,0.0127663514624012,0.312503616940011,0.674730031597588
14,"Sachsen",14730350,"Zinna",1455,716,739,0.492096219931271,1475,720,755,0.488135593220339,0.0127663514624012,0.312503616940011,0.674730031597588
14,"Sachsen",14730360,"Zschepplin",3026,1501,1525,0.496034368803701,3053,1523,1530,0.498853586636096,0.0127663514624012,0.312503616940011,0.674730031597588
14,"Sachsen",14730370,"Zwochau",1060,518,542,0.488679245283019,1080,532,548,0.492592592592593,0.0127663514624012,0.312503616940011,0.674730031597588
15,"Sachsen-Anhalt",15001000,"Dessau-Roßlau, Stadt",85488,41240,44248,0.482406887516377,85838,41347,44491,0.481686432582306,0.0261909803091256,0.325365233961465,0.648443785729409
15,"Sachsen-Anhalt",15002000,"Halle (Saale), Stadt",230494,109472,121022,0.474945117877255,233705,111343,122362,0.476425408099955,0.0261909803091256,0.325365233961465,0.648443785729409
15,"Sachsen-Anhalt",15003000,"Magdeburg, Landeshauptstadt",228910,111270,117640,0.486086234764755,232364,113076,119288,0.486633041262846,0.0261909803091256,0.325365233961465,0.648443785729409
15,"Sachsen-Anhalt",15081026,"Apenburg-Winterfeld, Flecken",1776,911,865,0.51295045045045,1784,927,857,0.519618834080718,0.0261909803091256,0.325365233961465,0.648443785729409
15,"Sachsen-Anhalt",15081030,"Arendsee (Altmark), Stadt",7237,3637,3600,0.502556307862374,7299,3662,3637,0.501712563364844,0.0261909803091256,0.325365233961465,0.648443785729409
15,"Sachsen-Anhalt",15081045,"Beetzendorf",3274,1666,1608,0.508857666463042,3299,1665,1634,0.504698393452561,0.0261909803091256,0.325365233961465,0.648443785729409
15,"Sachsen-Anhalt",15081095,"Dähre",1516,770,746,0.507915567282322,1537,775,762,0.504229017566688,0.0261909803091256,0.325365233961465,0.648443785729409
15,"Sachsen-Anhalt",15081105,"Diesdorf, Flecken",2442,1201,1241,0.491809991809992,2466,1228,1238,0.497972424979724,0.0261909803091256,0.325365233961465,0.648443785729409
15,"Sachsen-Anhalt",15081135,"Gardelegen, Hansestadt",23329,11665,11664,0.50002143255176,23628,11850,11778,0.501523616048756,0.0261909803091256,0.325365233961465,0.648443785729409
15,"Sachsen-Anhalt",15081225,"Jübar",1743,890,853,0.51061388410786,1763,906,857,0.513896766874645,0.0261909803091256,0.325365233961465,0.648443785729409
15,"Sachsen-Anhalt",15081240,"Kalbe (Milde), Stadt",8044,4088,3956,0.508204873197414,8069,4108,3961,0.5091089354319,0.0261909803091256,0.325365233961465,0.648443785729409
15,"Sachsen-Anhalt",15081280,"Klötze, Stadt",10468,5175,5293,0.494363775315246,10660,5323,5337,0.499343339587242,0.0261909803091256,0.325365233961465,0.648443785729409
15,"Sachsen-Anhalt",15081290,"Kuhfelde",1162,587,575,0.505163511187608,1185,596,589,0.50295358649789,0.0261909803091256,0.325365233961465,0.648443785729409
15,"Sachsen-Anhalt",15081440,"Rohrberg",1131,581,550,0.513704686118479,1153,606,547,0.525585429314831,0.0261909803091256,0.325365233961465,0.648443785729409
15,"Sachsen-Anhalt",15081455,"Salzwedel, Hansestadt",24588,12096,12492,0.49194729136164,24631,12204,12427,0.495473184198774,0.0261909803091256,0.325365233961465,0.648443785729409
15,"Sachsen-Anhalt",15081545,"Wallstawe",914,463,451,0.506564551422319,964,484,480,0.50207468879668,0.0261909803091256,0.325365233961465,0.648443785729409
15,"Sachsen-Anhalt",15082005,"Aken (Elbe), Stadt",8161,3945,4216,0.483396642568313,8202,3992,4210,0.48671055840039,0.0261909803091256,0.325365233961465,0.648443785729409
15,"Sachsen-Anhalt",15082015,"Bitterfeld-Wolfen, Stadt",42800,20475,22325,0.47838785046729,44343,21252,23091,0.479263919897165,0.0261909803091256,0.325365233961465,0.648443785729409
15,"Sachsen-Anhalt",15082180,"Köthen (Anhalt), Stadt",27410,13233,14177,0.482780007296607,27861,13464,14397,0.483256164531065,0.0261909803091256,0.325365233961465,0.648443785729409
15,"Sachsen-Anhalt",15082241,"Muldestausee",12043,6001,6042,0.498297766337291,12252,6121,6131,0.499591903362716,0.0261909803091256,0.325365233961465,0.648443785729409
15,"Sachsen-Anhalt",15082256,"Osternienburger Land",9203,4652,4551,0.505487341084429,9300,4696,4604,0.50494623655914,0.0261909803091256,0.325365233961465,0.648443785729409
15,"Sachsen-Anhalt",15082301,"Raguhn-Jeßnitz, Stadt",9613,4766,4847,0.495786955164881,9841,4926,4915,0.500558886292043,0.0261909803091256,0.325365233961465,0.648443785729409
15,"Sachsen-Anhalt",15082340,"Sandersdorf-Brehna, Stadt",15016,7318,7698,0.487346830047949,15298,7467,7831,0.488103020002615,0.0261909803091256,0.325365233961465,0.648443785729409
15,"Sachsen-Anhalt",15082377,"Südliches Anhalt, Stadt",14440,7182,7258,0.497368421052632,14503,7263,7240,0.50079293939185,0.0261909803091256,0.325365233961465,0.648443785729409
15,"Sachsen-Anhalt",15082430,"Zerbst/Anhalt, Stadt",22468,10976,11492,0.488517001958341,22920,11228,11692,0.489877835951134,0.0261909803091256,0.325365233961465,0.648443785729409
15,"Sachsen-Anhalt",15082440,"Zörbig, Stadt",9673,4813,4860,0.497570557221131,9715,4825,4890,0.496654657745754,0.0261909803091256,0.325365233961465,0.648443785729409
15,"Sachsen-Anhalt",15083020,"Altenhausen",1127,567,560,0.503105590062112,1070,533,537,0.498130841121495,0.0261909803091256,0.325365233961465,0.648443785729409
15,"Sachsen-Anhalt",15083025,"Am Großen Bruch",2278,1132,1146,0.496927129060579,2266,1131,1135,0.499117387466902,0.0261909803091256,0.325365233961465,0.648443785729409
15,"Sachsen-Anhalt",15083030,"Angern",2076,1059,1017,0.510115606936416,2100,1062,1038,0.505714285714286,0.0261909803091256,0.325365233961465,0.648443785729409
15,"Sachsen-Anhalt",15083035,"Ausleben",1738,882,856,0.507479861910242,1762,896,866,0.508513053348468,0.0261909803091256,0.325365233961465,0.648443785729409
15,"Sachsen-Anhalt",15083040,"Barleben",9030,4463,4567,0.494241417497231,9131,4541,4590,0.497316832767495,0.0261909803091256,0.325365233961465,0.648443785729409
15,"Sachsen-Anhalt",15083060,"Beendorf",897,449,448,0.500557413600892,890,452,438,0.507865168539326,0.0261909803091256,0.325365233961465,0.648443785729409
15,"Sachsen-Anhalt",15083115,"Bülstringen",922,464,458,0.503253796095445,923,465,458,0.503791982665222,0.0261909803091256,0.325365233961465,0.648443785729409
15,"Sachsen-Anhalt",15083120,"Burgstall",1612,785,827,0.48697270471464,1648,802,846,0.486650485436893,0.0261909803091256,0.325365233961465,0.648443785729409
15,"Sachsen-Anhalt",15083125,"Calvörde",3628,1796,1832,0.495038588754135,3678,1795,1883,0.488036976617727,0.0261909803091256,0.325365233961465,0.648443785729409
15,"Sachsen-Anhalt",15083130,"Colbitz",3231,1644,1587,0.508820798514392,3291,1669,1622,0.507140686721361,0.0261909803091256,0.325365233961465,0.648443785729409
15,"Sachsen-Anhalt",15083190,"Eilsleben",3862,1929,1933,0.499482133609529,3897,1942,1955,0.498332050295099,0.0261909803091256,0.325365233961465,0.648443785729409
15,"Sachsen-Anhalt",15083205,"Erxleben",2991,1508,1483,0.504179204279505,3042,1539,1503,0.505917159763314,0.0261909803091256,0.325365233961465,0.648443785729409
15,"Sachsen-Anhalt",15083230,"Flechtingen",2816,1401,1415,0.497514204545455,2776,1379,1397,0.496757925072046,0.0261909803091256,0.325365233961465,0.648443785729409
15,"Sachsen-Anhalt",15083245,"Gröningen, Stadt",3674,1838,1836,0.500272182906913,3718,1879,1839,0.505379236148467,0.0261909803091256,0.325365233961465,0.648443785729409
15,"Sachsen-Anhalt",15083270,"Haldensleben, Stadt",18452,8956,9496,0.485367439843919,18758,9176,9582,0.489177950741017,0.0261909803091256,0.325365233961465,0.648443785729409
15,"Sachsen-Anhalt",15083275,"Harbke",1691,889,802,0.525724423418096,1749,997,752,0.570040022870212,0.0261909803091256,0.325365233961465,0.648443785729409
15,"Sachsen-Anhalt",15083298,"Hohe Börde",18062,9091,8971,0.503321891263426,18327,9205,9122,0.502264418617341,0.0261909803091256,0.325365233961465,0.648443785729409
15,"Sachsen-Anhalt",15083320,"Hötensleben",3767,1912,1855,0.507565702150252,3802,1922,1880,0.505523408732246,0.0261909803091256,0.325365233961465,0.648443785729409
15,"Sachsen-Anhalt",15083323,"Ingersleben",1464,738,726,0.504098360655738,1472,753,719,0.511548913043478,0.0261909803091256,0.325365233961465,0.648443785729409
15,"Sachsen-Anhalt",15083355,"Kroppenstedt, Stadt",1513,751,762,0.496364838070059,1519,753,766,0.495720868992758,0.0261909803091256,0.325365233961465,0.648443785729409
15,"Sachsen-Anhalt",15083361,"Loitsche-Heinrichsberg",1002,530,472,0.528942115768463,991,513,478,0.51765893037336,0.0261909803091256,0.325365233961465,0.648443785729409
15,"Sachsen-Anhalt",15083390,"Niedere Börde",7172,3648,3524,0.508644729503625,7246,3669,3577,0.506348330113166,0.0261909803091256,0.325365233961465,0.648443785729409
15,"Sachsen-Anhalt",15083411,"Oebisfelde-Weferlingen, Stadt",13805,6862,6943,0.497066280333213,14197,7167,7030,0.504824963020356,0.0261909803091256,0.325365233961465,0.648443785729409
15,"Sachsen-Anhalt",15083415,"Oschersleben (Bode), Stadt",20393,9914,10479,0.48614720737508,20485,9983,10502,0.487332194288504,0.0261909803091256,0.325365233961465,0.648443785729409
15,"Sachsen-Anhalt",15083440,"Rogätz",2168,1063,1105,0.490313653136531,2171,1074,1097,0.494702901888531,0.0261909803091256,0.325365233961465,0.648443785729409
15,"Sachsen-Anhalt",15083485,"Sommersdorf",1451,741,710,0.510682288077188,1449,748,701,0.516218081435473,0.0261909803091256,0.325365233961465,0.648443785729409
15,"Sachsen-Anhalt",15083490,"Sülzetal",9191,4546,4645,0.494614296594495,9215,4544,4671,0.493109061313077,0.0261909803091256,0.325365233961465,0.648443785729409
15,"Sachsen-Anhalt",15083495,"Süplingen",946,482,464,0.509513742071882,961,495,466,0.515088449531738,0.0261909803091256,0.325365233961465,0.648443785729409
15,"Sachsen-Anhalt",15083505,"Ummendorf",1009,496,513,0.491575817641229,997,489,508,0.490471414242728,0.0261909803091256,0.325365233961465,0.648443785729409
15,"Sachsen-Anhalt",15083515,"Völpke",1422,705,717,0.4957805907173,1448,722,726,0.498618784530387,0.0261909803091256,0.325365233961465,0.648443785729409
15,"Sachsen-Anhalt",15083531,"Wanzleben-Börde, Stadt",14713,7326,7387,0.497927003330388,14949,7449,7500,0.498294200280955,0.0261909803091256,0.325365233961465,0.648443785729409
15,"Sachsen-Anhalt",15083535,"Wefensleben",1879,952,927,0.506652474720596,1849,954,895,0.515954570037858,0.0261909803091256,0.325365233961465,0.648443785729409
15,"Sachsen-Anhalt",15083557,"Westheide",1724,872,852,0.505800464037123,1738,884,854,0.508630609896433,0.0261909803091256,0.325365233961465,0.648443785729409
15,"Sachsen-Anhalt",15083565,"Wolmirstedt, Stadt",11623,5642,5981,0.485416845908974,11891,5795,6096,0.487343368934488,0.0261909803091256,0.325365233961465,0.648443785729409
15,"Sachsen-Anhalt",15083580,"Zielitz",1869,952,917,0.50936329588015,1896,962,934,0.507383966244726,0.0261909803091256,0.325365233961465,0.648443785729409
15,"Sachsen-Anhalt",15084012,"An der Poststraße",1746,888,858,0.508591065292096,1759,890,869,0.505969300739056,0.0261909803091256,0.325365233961465,0.648443785729409
15,"Sachsen-Anhalt",15084013,"Meineweh",1061,556,505,0.524033930254477,1063,561,502,0.527751646284102,0.0261909803091256,0.325365233961465,0.648443785729409
15,"Sachsen-Anhalt",15084015,"Bad Bibra, Stadt",2928,1463,1465,0.499658469945355,2865,1421,1444,0.495986038394415,0.0261909803091256,0.325365233961465,0.648443785729409
15,"Sachsen-Anhalt",15084025,"Balgstädt",1185,612,573,0.516455696202532,1201,624,577,0.519567027477102,0.0261909803091256,0.325365233961465,0.648443785729409
15,"Sachsen-Anhalt",15084115,"Droyßig",2062,1015,1047,0.492240543161979,2028,985,1043,0.485700197238659,0.0261909803091256,0.325365233961465,0.648443785729409
15,"Sachsen-Anhalt",15084125,"Eckartsberga, Stadt",2398,1203,1195,0.501668056713928,2415,1216,1199,0.50351966873706,0.0261909803091256,0.325365233961465,0.648443785729409
15,"Sachsen-Anhalt",15084130,"Elsteraue",8805,4401,4404,0.499829642248722,8981,4464,4517,0.49704932635564,0.0261909803091256,0.325365233961465,0.648443785729409
15,"Sachsen-Anhalt",15084132,"Finne",1265,648,617,0.512252964426878,1256,633,623,0.503980891719745,0.0261909803091256,0.325365233961465,0.648443785729409
15,"Sachsen-Anhalt",15084133,"Finneland",1169,595,574,0.508982035928144,1152,584,568,0.506944444444444,0.0261909803091256,0.325365233961465,0.648443785729409
15,"Sachsen-Anhalt",15084135,"Freyburg (Unstrut), Stadt",4879,2369,2510,0.485550317688051,4848,2330,2518,0.480610561056106,0.0261909803091256,0.325365233961465,0.648443785729409
15,"Sachsen-Anhalt",15084150,"Gleina",1313,683,630,0.52018278750952,1297,670,627,0.516576715497301,0.0261909803091256,0.325365233961465,0.648443785729409
15,"Sachsen-Anhalt",15084170,"Goseck",1037,519,518,0.500482160077146,1052,528,524,0.501901140684411,0.0261909803091256,0.325365233961465,0.648443785729409
15,"Sachsen-Anhalt",15084207,"Gutenborn",1916,993,923,0.518267223382046,1952,1017,935,0.521004098360656,0.0261909803091256,0.325365233961465,0.648443785729409
15,"Sachsen-Anhalt",15084235,"Hohenmölsen, Stadt",10246,4964,5282,0.48448174897521,10419,5080,5339,0.487570784144352,0.0261909803091256,0.325365233961465,0.648443785729409
15,"Sachsen-Anhalt",15084246,"Kaiserpfalz",1697,864,833,0.509133765468474,1755,888,867,0.505982905982906,0.0261909803091256,0.325365233961465,0.648443785729409
15,"Sachsen-Anhalt",15084250,"Karsdorf",1787,902,885,0.504756575265809,1810,912,898,0.503867403314917,0.0261909803091256,0.325365233961465,0.648443785729409
15,"Sachsen-Anhalt",15084275,"Kretzschau",2701,1327,1374,0.491299518696779,2753,1376,1377,0.499818379949146,0.0261909803091256,0.325365233961465,0.648443785729409
15,"Sachsen-Anhalt",15084282,"Lanitz-Hassel-Tal",1173,584,589,0.497868712702472,1175,582,593,0.49531914893617,0.0261909803091256,0.325365233961465,0.648443785729409
15,"Sachsen-Anhalt",15084285,"Laucha an der Unstrut, Stadt",3115,1566,1549,0.502728731942215,3097,1560,1537,0.50371327090733,0.0261909803091256,0.325365233961465,0.648443785729409
15,"Sachsen-Anhalt",15084315,"Lützen, Stadt",9053,4476,4577,0.494421738650171,9083,4507,4576,0.496201695475063,0.0261909803091256,0.325365233961465,0.648443785729409
15,"Sachsen-Anhalt",15084335,"Mertendorf",1735,877,858,0.505475504322767,1745,888,857,0.508882521489971,0.0261909803091256,0.325365233961465,0.648443785729409
15,"Sachsen-Anhalt",15084341,"Molauer Land",1130,585,545,0.517699115044248,1139,583,556,0.511852502194908,0.0261909803091256,0.325365233961465,0.648443785729409
15,"Sachsen-Anhalt",15084355,"Naumburg (Saale), Stadt",33085,15895,17190,0.480429197521535,34053,16513,17540,0.484920565001615,0.0261909803091256,0.325365233961465,0.648443785729409
15,"Sachsen-Anhalt",15084360,"Nebra (Unstrut), Stadt",3488,1744,1744,0.5,3452,1726,1726,0.5,0.0261909803091256,0.325365233961465,0.648443785729409
15,"Sachsen-Anhalt",15084375,"Osterfeld, Stadt",2634,1317,1317,0.5,2627,1323,1304,0.503616292348687,0.0261909803091256,0.325365233961465,0.648443785729409
15,"Sachsen-Anhalt",15084442,"Schnaudertal",959,505,454,0.526590198123045,997,529,468,0.530591775325978,0.0261909803091256,0.325365233961465,0.648443785729409
15,"Sachsen-Anhalt",15084445,"Schönburg",1060,542,518,0.511320754716981,1058,547,511,0.517013232514178,0.0261909803091256,0.325365233961465,0.648443785729409
15,"Sachsen-Anhalt",15084470,"Stößen, Stadt",953,457,496,0.479538300104932,957,450,507,0.470219435736677,0.0261909803091256,0.325365233961465,0.648443785729409
15,"Sachsen-Anhalt",15084490,"Teuchern, Stadt",8724,4386,4338,0.502751031636864,8728,4376,4352,0.501374885426214,0.0261909803091256,0.325365233961465,0.648443785729409
15,"Sachsen-Anhalt",15084550,"Weißenfels, Stadt",39837,19603,20234,0.492080226924718,40861,20309,20552,0.497026504490835,0.0261909803091256,0.325365233961465,0.648443785729409
15,"Sachsen-Anhalt",15084560,"Wethau",1009,503,506,0.498513379583746,998,513,485,0.514028056112224,0.0261909803091256,0.325365233961465,0.648443785729409
15,"Sachsen-Anhalt",15084565,"Wetterzeube",1851,900,951,0.486223662884927,1887,927,960,0.491255961844197,0.0261909803091256,0.325365233961465,0.648443785729409
15,"Sachsen-Anhalt",15084590,"Zeitz, Stadt",30148,14300,15848,0.474326655167839,31021,14792,16229,0.47683827084878,0.0261909803091256,0.325365233961465,0.648443785729409
15,"Sachsen-Anhalt",15085040,"Ballenstedt, Stadt",7749,3754,3995,0.484449606400826,7770,3781,3989,0.486615186615187,0.0261909803091256,0.325365233961465,0.648443785729409
15,"Sachsen-Anhalt",15085055,"Blankenburg (Harz), Stadt",20971,10106,10865,0.481903581135854,21654,10550,11104,0.487207906160525,0.0261909803091256,0.325365233961465,0.648443785729409
15,"Sachsen-Anhalt",15085090,"Ditfurt",1640,812,828,0.495121951219512,1636,814,822,0.497555012224939,0.0261909803091256,0.325365233961465,0.648443785729409
15,"Sachsen-Anhalt",15085110,"Falkenstein/Harz, Stadt",5716,2897,2819,0.506822953114066,5746,2914,2832,0.507135398538114,0.0261909803091256,0.325365233961465,0.648443785729409
15,"Sachsen-Anhalt",15085125,"Groß Quenstedt",973,486,487,0.499486125385406,961,477,484,0.496357960457856,0.0261909803091256,0.325365233961465,0.648443785729409
15,"Sachsen-Anhalt",15085135,"Halberstadt, Stadt",40717,19712,21005,0.484122111157502,41842,20187,21655,0.482457817503943,0.0261909803091256,0.325365233961465,0.648443785729409
15,"Sachsen-Anhalt",15085140,"Harsleben",2204,1084,1120,0.491833030852995,2195,1063,1132,0.484282460136674,0.0261909803091256,0.325365233961465,0.648443785729409
15,"Sachsen-Anhalt",15085145,"Harzgerode, Stadt",8580,4280,4300,0.498834498834499,8493,4278,4215,0.503708936771459,0.0261909803091256,0.325365233961465,0.648443785729409
15,"Sachsen-Anhalt",15085160,"Hedersleben",1471,742,729,0.504418762746431,1530,775,755,0.506535947712418,0.0261909803091256,0.325365233961465,0.648443785729409
15,"Sachsen-Anhalt",15085185,"Huy",7772,3879,3893,0.499099330931549,7812,3911,3901,0.500640040962622,0.0261909803091256,0.325365233961465,0.648443785729409
15,"Sachsen-Anhalt",15085190,"Ilsenburg (Harz), Stadt",9488,4698,4790,0.495151770657673,9579,4739,4840,0.494728050944775,0.0261909803091256,0.325365233961465,0.648443785729409
15,"Sachsen-Anhalt",15085227,"Nordharz",8095,4056,4039,0.501050030883261,8149,4073,4076,0.499815928334765,0.0261909803091256,0.325365233961465,0.648443785729409
15,"Sachsen-Anhalt",15085228,"Oberharz am Brocken, Stadt",11548,5593,5955,0.484326290266713,11973,5870,6103,0.490269773657396,0.0261909803091256,0.325365233961465,0.648443785729409
15,"Sachsen-Anhalt",15085230,"Osterwieck, Stadt",11548,5810,5738,0.503117422930378,11750,5921,5829,0.503914893617021,0.0261909803091256,0.325365233961465,0.648443785729409
15,"Sachsen-Anhalt",15085235,"Quedlinburg, Stadt",27578,13124,14454,0.475886576256436,28137,13514,14623,0.480292852827238,0.0261909803091256,0.325365233961465,0.648443785729409
15,"Sachsen-Anhalt",15085285,"Schwanebeck, Stadt",2576,1287,1289,0.499611801242236,2520,1252,1268,0.496825396825397,0.0261909803091256,0.325365233961465,0.648443785729409
15,"Sachsen-Anhalt",15085287,"Selke-Aue",1486,737,749,0.495962314939435,1513,757,756,0.500330469266358,0.0261909803091256,0.325365233961465,0.648443785729409
15,"Sachsen-Anhalt",15085330,"Thale, Stadt",18380,9080,9300,0.494015233949946,18878,9315,9563,0.493431507574955,0.0261909803091256,0.325365233961465,0.648443785729409
15,"Sachsen-Anhalt",15085365,"Wegeleben, Stadt",2794,1408,1386,0.503937007874016,2783,1404,1379,0.504491555874955,0.0261909803091256,0.325365233961465,0.648443785729409
15,"Sachsen-Anhalt",15085370,"Wernigerode, Stadt",33905,16064,17841,0.473794425600944,34255,16329,17926,0.476689534374544,0.0261909803091256,0.325365233961465,0.648443785729409
15,"Sachsen-Anhalt",15086005,"Biederitz",8503,4156,4347,0.488768669881218,8438,4136,4302,0.490163545863949,0.0261909803091256,0.325365233961465,0.648443785729409
15,"Sachsen-Anhalt",15086015,"Burg, Stadt",22977,11384,11593,0.495451973712843,23874,11803,12071,0.494387199463852,0.0261909803091256,0.325365233961465,0.648443785729409
15,"Sachsen-Anhalt",15086035,"Elbe-Parey",7032,3495,3537,0.497013651877133,7115,3514,3601,0.493886156008433,0.0261909803091256,0.325365233961465,0.648443785729409
15,"Sachsen-Anhalt",15086040,"Genthin, Stadt",14813,7335,7478,0.495173158711942,15131,7493,7638,0.495208512325689,0.0261909803091256,0.325365233961465,0.648443785729409
15,"Sachsen-Anhalt",15086055,"Gommern, Stadt",10821,5227,5594,0.483042232695684,10923,5328,5595,0.487778082944246,0.0261909803091256,0.325365233961465,0.648443785729409
15,"Sachsen-Anhalt",15086080,"Jerichow, Stadt",7289,3687,3602,0.505830703800247,7374,3728,3646,0.505560075942501,0.0261909803091256,0.325365233961465,0.648443785729409
15,"Sachsen-Anhalt",15086140,"Möckern, Stadt",13477,6817,6660,0.505824738443274,13934,7077,6857,0.507894359121573,0.0261909803091256,0.325365233961465,0.648443785729409
15,"Sachsen-Anhalt",15086145,"Möser",8080,4030,4050,0.498762376237624,8136,4067,4069,0.499877089478859,0.0261909803091256,0.325365233961465,0.648443785729409
15,"Sachsen-Anhalt",15086210,"Schopsdorf",250,122,128,0.488,254,125,129,0.492125984251969,0.0261909803091256,0.325365233961465,0.648443785729409
15,"Sachsen-Anhalt",15087010,"Ahlsdorf",1713,853,860,0.497956800934034,1730,852,878,0.492485549132948,0.0261909803091256,0.325365233961465,0.648443785729409
15,"Sachsen-Anhalt",15087015,"Allstedt, Stadt",8339,4180,4159,0.501259143782228,8342,4168,4174,0.499640374011029,0.0261909803091256,0.325365233961465,0.648443785729409
15,"Sachsen-Anhalt",15087031,"Arnstein, Stadt",7271,3630,3641,0.499243570347958,7262,3612,3650,0.497383640870284,0.0261909803091256,0.325365233961465,0.648443785729409
15,"Sachsen-Anhalt",15087045,"Benndorf",2179,1014,1165,0.465351078476365,2220,1049,1171,0.472522522522523,0.0261909803091256,0.325365233961465,0.648443785729409
15,"Sachsen-Anhalt",15087055,"Berga",1789,896,893,0.500838457238681,1750,883,867,0.504571428571429,0.0261909803091256,0.325365233961465,0.648443785729409
15,"Sachsen-Anhalt",15087070,"Blankenheim",1311,650,661,0.49580472921434,1313,654,659,0.498095963442498,0.0261909803091256,0.325365233961465,0.648443785729409
15,"Sachsen-Anhalt",15087075,"Bornstedt",833,430,403,0.516206482593037,828,433,395,0.522946859903382,0.0261909803091256,0.325365233961465,0.648443785729409
15,"Sachsen-Anhalt",15087101,"Brücken-Hackpfüffel",1077,544,533,0.505106778087279,1081,544,537,0.503237742830712,0.0261909803091256,0.325365233961465,0.648443785729409
15,"Sachsen-Anhalt",15087125,"Edersleben",1051,535,516,0.509039010466223,1032,532,500,0.515503875968992,0.0261909803091256,0.325365233961465,0.648443785729409
15,"Sachsen-Anhalt",15087130,"Eisleben, Lutherstadt",24556,11918,12638,0.485339631861867,25285,12333,12952,0.487759541229978,0.0261909803091256,0.325365233961465,0.648443785729409
15,"Sachsen-Anhalt",15087165,"Gerbstedt, Stadt",7904,3930,3974,0.497216599190283,7789,3897,3892,0.500320965464116,0.0261909803091256,0.325365233961465,0.648443785729409
15,"Sachsen-Anhalt",15087205,"Helbra",4233,2008,2225,0.474368060477203,4236,2006,2230,0.473559962228517,0.0261909803091256,0.325365233961465,0.648443785729409
15,"Sachsen-Anhalt",15087210,"Hergisdorf",1695,838,857,0.494395280235988,1698,838,860,0.493521790341578,0.0261909803091256,0.325365233961465,0.648443785729409
15,"Sachsen-Anhalt",15087220,"Hettstedt, Stadt",15042,7321,7721,0.486703895758543,15046,7313,7733,0.486042802073641,0.0261909803091256,0.325365233961465,0.648443785729409
15,"Sachsen-Anhalt",15087250,"Kelbra (Kyffhäuser), Stadt",3585,1757,1828,0.490097629009763,3570,1752,1818,0.490756302521008,0.0261909803091256,0.325365233961465,0.648443785729409
15,"Sachsen-Anhalt",15087260,"Klostermansfeld",2515,1220,1295,0.485089463220676,2511,1218,1293,0.485065710872162,0.0261909803091256,0.325365233961465,0.648443785729409
15,"Sachsen-Anhalt",15087275,"Mansfeld, Stadt",9552,4762,4790,0.498534338358459,9647,4828,4819,0.500466466258941,0.0261909803091256,0.325365233961465,0.648443785729409
15,"Sachsen-Anhalt",15087370,"Sangerhausen, Stadt",28627,13916,14711,0.486114507283334,29240,14297,14943,0.488953488372093,0.0261909803091256,0.325365233961465,0.648443785729409
15,"Sachsen-Anhalt",15087386,"Seegebiet Mansfelder Land",9559,4732,4827,0.495030860968721,9575,4738,4837,0.494830287206266,0.0261909803091256,0.325365233961465,0.648443785729409
15,"Sachsen-Anhalt",15087412,"Südharz",10009,4993,5016,0.498851034069338,10057,5016,5041,0.498757084617679,0.0261909803091256,0.325365233961465,0.648443785729409
15,"Sachsen-Anhalt",15087440,"Wallhausen",2559,1246,1313,0.486908948808128,2579,1247,1332,0.483520744474603,0.0261909803091256,0.325365233961465,0.648443785729409
15,"Sachsen-Anhalt",15087470,"Wimmelburg",1260,626,634,0.496825396825397,1274,637,637,0.5,0.0261909803091256,0.325365233961465,0.648443785729409
15,"Sachsen-Anhalt",15088020,"Bad Dürrenberg, Stadt",11999,5863,6136,0.488624052004334,12298,6083,6215,0.494633273703041,0.0261909803091256,0.325365233961465,0.648443785729409
15,"Sachsen-Anhalt",15088025,"Bad Lauchstädt, Goethestadt",9090,4498,4592,0.494829482948295,9152,4530,4622,0.494973776223776,0.0261909803091256,0.325365233961465,0.648443785729409
15,"Sachsen-Anhalt",15088030,"Barnstädt",1075,548,527,0.509767441860465,1089,557,532,0.51147842056933,0.0261909803091256,0.325365233961465,0.648443785729409
15,"Sachsen-Anhalt",15088065,"Braunsbedra, Stadt",11604,5924,5680,0.510513615994485,11973,6140,5833,0.512820512820513,0.0261909803091256,0.325365233961465,0.648443785729409
15,"Sachsen-Anhalt",15088100,"Farnstädt",1626,823,803,0.506150061500615,1605,815,790,0.507788161993769,0.0261909803091256,0.325365233961465,0.648443785729409
15,"Sachsen-Anhalt",15088150,"Kabelsketal",8817,4448,4369,0.504479981853238,8976,4549,4427,0.506795900178253,0.0261909803091256,0.325365233961465,0.648443785729409
15,"Sachsen-Anhalt",15088195,"Landsberg, Stadt",15241,7641,7600,0.501345056098681,15373,7669,7704,0.498861640538607,0.0261909803091256,0.325365233961465,0.648443785729409
15,"Sachsen-Anhalt",15088205,"Leuna, Stadt",14162,7042,7120,0.497246151673492,14432,7165,7267,0.496466186252772,0.0261909803091256,0.325365233961465,0.648443785729409
15,"Sachsen-Anhalt",15088216,"Wettin-Löbejün, Stadt",10482,5179,5303,0.49408509826369,10590,5267,5323,0.497355996222852,0.0261909803091256,0.325365233961465,0.648443785729409
15,"Sachsen-Anhalt",15088220,"Merseburg, Stadt",33664,15982,17682,0.474750475285171,34993,16749,18244,0.478638584859829,0.0261909803091256,0.325365233961465,0.648443785729409
15,"Sachsen-Anhalt",15088235,"Mücheln (Geiseltal), Stadt",9216,4581,4635,0.4970703125,9270,4599,4671,0.496116504854369,0.0261909803091256,0.325365233961465,0.648443785729409
15,"Sachsen-Anhalt",15088250,"Nemsdorf-Göhrendorf",880,457,423,0.519318181818182,865,452,413,0.522543352601156,0.0261909803091256,0.325365233961465,0.648443785729409
15,"Sachsen-Anhalt",15088265,"Obhausen",2382,1204,1178,0.505457598656591,2365,1194,1171,0.504862579281184,0.0261909803091256,0.325365233961465,0.648443785729409
15,"Sachsen-Anhalt",15088295,"Petersberg",10091,5016,5075,0.497076602913487,10332,5174,5158,0.50077429345722,0.0261909803091256,0.325365233961465,0.648443785729409
15,"Sachsen-Anhalt",15088305,"Querfurt, Stadt",11470,5562,5908,0.484917175239756,11746,5698,6048,0.485101311084625,0.0261909803091256,0.325365233961465,0.648443785729409
15,"Sachsen-Anhalt",15088319,"Salzatal",12012,5819,6193,0.484432234432234,12469,6193,6276,0.496671745929906,0.0261909803091256,0.325365233961465,0.648443785729409
15,"Sachsen-Anhalt",15088330,"Schkopau",11127,5573,5554,0.500853779095893,11305,5674,5631,0.501901813356922,0.0261909803091256,0.325365233961465,0.648443785729409
15,"Sachsen-Anhalt",15088340,"Schraplau, Stadt",1176,573,603,0.487244897959184,1163,562,601,0.48323301805675,0.0261909803091256,0.325365233961465,0.648443785729409
15,"Sachsen-Anhalt",15088355,"Steigra",1247,622,625,0.498797113071371,1243,625,618,0.502815768302494,0.0261909803091256,0.325365233961465,0.648443785729409
15,"Sachsen-Anhalt",15088365,"Teutschenthal",13386,6671,6715,0.498356491857164,13894,6897,6997,0.496401324312653,0.0261909803091256,0.325365233961465,0.648443785729409
15,"Sachsen-Anhalt",15089005,"Alsleben (Saale), Stadt",2573,1260,1313,0.489700738437621,2517,1235,1282,0.490663488279698,0.0261909803091256,0.325365233961465,0.648443785729409
15,"Sachsen-Anhalt",15089015,"Aschersleben, Stadt",28327,13649,14678,0.481837116531931,28706,13851,14855,0.482512366752595,0.0261909803091256,0.325365233961465,0.648443785729409
15,"Sachsen-Anhalt",15089026,"Barby, Stadt",9065,4470,4595,0.493105350248207,9070,4491,4579,0.495148842337376,0.0261909803091256,0.325365233961465,0.648443785729409
15,"Sachsen-Anhalt",15089030,"Bernburg (Saale), Stadt",34838,16811,18027,0.48254779264022,35224,17210,18014,0.488587326822621,0.0261909803091256,0.325365233961465,0.648443785729409
15,"Sachsen-Anhalt",15089041,"Bördeaue",1891,940,951,0.497091485986251,1934,959,975,0.495863495346432,0.0261909803091256,0.325365233961465,0.648443785729409
15,"Sachsen-Anhalt",15089042,"Bördeland",7913,3956,3957,0.499936812839631,8044,4027,4017,0.500621581302834,0.0261909803091256,0.325365233961465,0.648443785729409
15,"Sachsen-Anhalt",15089043,"Börde-Hakel",3254,1614,1640,0.4960049170252,3285,1611,1674,0.49041095890411,0.0261909803091256,0.325365233961465,0.648443785729409
15,"Sachsen-Anhalt",15089045,"Borne",1282,656,626,0.511700468018721,1299,663,636,0.510392609699769,0.0261909803091256,0.325365233961465,0.648443785729409
15,"Sachsen-Anhalt",15089055,"Calbe (Saale), Stadt",9481,4589,4892,0.484020672924797,9748,4743,5005,0.486561345917111,0.0261909803091256,0.325365233961465,0.648443785729409
15,"Sachsen-Anhalt",15089075,"Egeln, Stadt",3582,1768,1814,0.49357900614182,3659,1834,1825,0.501229844219732,0.0261909803091256,0.325365233961465,0.648443785729409
15,"Sachsen-Anhalt",15089130,"Giersleben",1088,518,570,0.476102941176471,1043,508,535,0.48705656759348,0.0261909803091256,0.325365233961465,0.648443785729409
15,"Sachsen-Anhalt",15089165,"Güsten, Stadt",4450,2167,2283,0.486966292134831,4460,2169,2291,0.486322869955157,0.0261909803091256,0.325365233961465,0.648443785729409
15,"Sachsen-Anhalt",15089175,"Hecklingen, Stadt",7435,3685,3750,0.495628782784129,7466,3687,3779,0.493838735601393,0.0261909803091256,0.325365233961465,0.648443785729409
15,"Sachsen-Anhalt",15089185,"Ilberstedt",1126,559,567,0.496447602131439,1146,575,571,0.50174520069808,0.0261909803091256,0.325365233961465,0.648443785729409
15,"Sachsen-Anhalt",15089195,"Könnern, Stadt",9023,4488,4535,0.497395544719051,9114,4519,4595,0.495830590300636,0.0261909803091256,0.325365233961465,0.648443785729409
15,"Sachsen-Anhalt",15089235,"Nienburg (Saale), Stadt",6865,3413,3452,0.497159504734159,6835,3380,3455,0.494513533284565,0.0261909803091256,0.325365233961465,0.648443785729409
15,"Sachsen-Anhalt",15089245,"Plötzkau",1406,691,715,0.491465149359886,1407,692,715,0.49182658137882,0.0261909803091256,0.325365233961465,0.648443785729409
15,"Sachsen-Anhalt",15089305,"Schönebeck (Elbe), Stadt",32372,15580,16792,0.481280118621031,33539,16252,17287,0.484570201854557,0.0261909803091256,0.325365233961465,0.648443785729409
15,"Sachsen-Anhalt",15089307,"Seeland, Stadt",8722,4281,4441,0.490827791790874,8791,4320,4471,0.491411671027187,0.0261909803091256,0.325365233961465,0.648443785729409
15,"Sachsen-Anhalt",15089310,"Staßfurt, Stadt",27725,13511,14214,0.487321911632101,28111,13730,14381,0.488420902849418,0.0261909803091256,0.325365233961465,0.648443785729409
15,"Sachsen-Anhalt",15089365,"Wolmirsleben",1367,673,694,0.492318946598391,1386,674,712,0.486291486291486,0.0261909803091256,0.325365233961465,0.648443785729409
15,"Sachsen-Anhalt",15090003,"Aland",1535,770,765,0.501628664495114,1542,758,784,0.491569390402075,0.0261909803091256,0.325365233961465,0.648443785729409
15,"Sachsen-Anhalt",15090007,"Altmärkische Höhe",2018,1064,954,0.527254707631318,2059,1099,960,0.533754249635745,0.0261909803091256,0.325365233961465,0.648443785729409
15,"Sachsen-Anhalt",15090008,"Altmärkische Wische",938,474,464,0.505330490405117,968,492,476,0.508264462809917,0.0261909803091256,0.325365233961465,0.648443785729409
15,"Sachsen-Anhalt",15090010,"Arneburg, Stadt",1637,793,844,0.484422724496029,1636,805,831,0.492053789731051,0.0261909803091256,0.325365233961465,0.648443785729409
15,"Sachsen-Anhalt",15090070,"Bismark (Altmark), Stadt",8901,4485,4416,0.503875968992248,8943,4505,4438,0.503745946550375,0.0261909803091256,0.325365233961465,0.648443785729409
15,"Sachsen-Anhalt",15090135,"Eichstedt (Altmark)",956,471,485,0.492677824267782,973,474,499,0.487153134635149,0.0261909803091256,0.325365233961465,0.648443785729409
15,"Sachsen-Anhalt",15090180,"Goldbeck",1505,739,766,0.491029900332226,1501,731,770,0.487008660892738,0.0261909803091256,0.325365233961465,0.648443785729409
15,"Sachsen-Anhalt",15090220,"Hassel",961,478,483,0.497398543184183,922,456,466,0.494577006507592,0.0261909803091256,0.325365233961465,0.648443785729409
15,"Sachsen-Anhalt",15090225,"Havelberg, Hansestadt",6837,3442,3395,0.503437180049729,6793,3397,3396,0.500073605181805,0.0261909803091256,0.325365233961465,0.648443785729409
15,"Sachsen-Anhalt",15090245,"Hohenberg-Krusemark",1293,645,648,0.498839907192575,1278,641,637,0.501564945226917,0.0261909803091256,0.325365233961465,0.648443785729409
15,"Sachsen-Anhalt",15090270,"Iden",945,473,472,0.5005291005291,957,489,468,0.510971786833856,0.0261909803091256,0.325365233961465,0.648443785729409
15,"Sachsen-Anhalt",15090285,"Kamern",1283,687,596,0.535463756819953,1292,696,596,0.538699690402477,0.0261909803091256,0.325365233961465,0.648443785729409
15,"Sachsen-Anhalt",15090310,"Klietz",1598,812,786,0.508135168961201,1618,813,805,0.502472187886279,0.0261909803091256,0.325365233961465,0.648443785729409
15,"Sachsen-Anhalt",15090415,"Osterburg (Altmark), Hansestadt",10509,5105,5404,0.485774098391855,10833,5352,5481,0.494045970645251,0.0261909803091256,0.325365233961465,0.648443785729409
15,"Sachsen-Anhalt",15090435,"Rochau",1126,578,548,0.513321492007105,1108,568,540,0.512635379061372,0.0261909803091256,0.325365233961465,0.648443785729409
15,"Sachsen-Anhalt",15090445,"Sandau (Elbe), Stadt",934,457,477,0.489293361884368,929,457,472,0.491926803013994,0.0261909803091256,0.325365233961465,0.648443785729409
15,"Sachsen-Anhalt",15090485,"Schollene",1276,648,628,0.507836990595611,1261,639,622,0.506740681998414,0.0261909803091256,0.325365233961465,0.648443785729409
15,"Sachsen-Anhalt",15090500,"Schönhausen (Elbe)",2299,1132,1167,0.492387994780339,2314,1132,1182,0.489196197061366,0.0261909803091256,0.325365233961465,0.648443785729409
15,"Sachsen-Anhalt",15090520,"Seehausen (Altmark), Hansestadt",5237,2563,2674,0.489402329578003,5219,2593,2626,0.496838474803602,0.0261909803091256,0.325365233961465,0.648443785729409
15,"Sachsen-Anhalt",15090535,"Stendal, Hansestadt",40726,19801,20925,0.486200461621569,41925,20541,21384,0.48994633273703,0.0261909803091256,0.325365233961465,0.648443785729409
15,"Sachsen-Anhalt",15090546,"Tangerhütte, Stadt",11603,5806,5797,0.500387830733431,11664,5810,5854,0.498113854595336,0.0261909803091256,0.325365233961465,0.648443785729409
15,"Sachsen-Anhalt",15090550,"Tangermünde, Stadt",10580,5135,5445,0.485349716446125,10820,5255,5565,0.485674676524954,0.0261909803091256,0.325365233961465,0.648443785729409
15,"Sachsen-Anhalt",15090610,"Werben (Elbe), Hansestadt",1201,616,585,0.512905911740216,1207,613,594,0.507870753935377,0.0261909803091256,0.325365233961465,0.648443785729409
15,"Sachsen-Anhalt",15090631,"Wust-Fischbeck",1413,721,692,0.510261854210899,1446,741,705,0.512448132780083,0.0261909803091256,0.325365233961465,0.648443785729409
15,"Sachsen-Anhalt",15090635,"Zehrental",957,470,487,0.491118077324974,974,479,495,0.491786447638604,0.0261909803091256,0.325365233961465,0.648443785729409
15,"Sachsen-Anhalt",15091010,"Annaburg, Stadt",7357,3666,3691,0.498300937882289,7408,3680,3728,0.496760259179266,0.0261909803091256,0.325365233961465,0.648443785729409
15,"Sachsen-Anhalt",15091020,"Bad Schmiedeberg, Stadt",8770,4342,4428,0.495096921322691,8889,4435,4454,0.498931263359208,0.0261909803091256,0.325365233961465,0.648443785729409
15,"Sachsen-Anhalt",15091060,"Coswig (Anhalt), Stadt",12612,6211,6401,0.492467491278148,13019,6469,6550,0.496889161994009,0.0261909803091256,0.325365233961465,0.648443785729409
15,"Sachsen-Anhalt",15091110,"Gräfenhainichen, Stadt",12863,6326,6537,0.491798180828734,12921,6391,6530,0.494621159352991,0.0261909803091256,0.325365233961465,0.648443785729409
15,"Sachsen-Anhalt",15091145,"Jessen (Elster), Stadt",14535,7221,7314,0.496800825593395,14784,7398,7386,0.500405844155844,0.0261909803091256,0.325365233961465,0.648443785729409
15,"Sachsen-Anhalt",15091160,"Kemberg, Stadt",10525,5226,5299,0.496532066508314,10814,5378,5436,0.497318291104124,0.0261909803091256,0.325365233961465,0.648443785729409
15,"Sachsen-Anhalt",15091241,"Oranienbaum-Wörlitz, Stadt",8630,4271,4359,0.494901506373117,8689,4304,4385,0.495338934284728,0.0261909803091256,0.325365233961465,0.648443785729409
15,"Sachsen-Anhalt",15091375,"Wittenberg, Lutherstadt",47131,22503,24628,0.477456451168021,49076,23630,25446,0.481498084603472,0.0261909803091256,0.325365233961465,0.648443785729409
15,"Sachsen-Anhalt",15091391,"Zahna-Elster, Stadt",9731,4886,4845,0.50210666940705,9795,4901,4894,0.500357325165901,0.0261909803091256,0.325365233961465,0.648443785729409
16,"Thüringen",16051000,"Erfurt, Stadt",201952,97145,104807,0.481030145777214,206384,100028,106356,0.484669354213505,0.0189120464968442,0.343595332152749,0.637492621350406
16,"Thüringen",16052000,"Gera, Stadt",95746,45837,49909,0.478735404089988,98762,47744,51018,0.483424799011766,0.0189120464968442,0.343595332152749,0.637492621350406
16,"Thüringen",16053000,"Jena, Stadt",106428,52479,53949,0.493093922651934,105463,52240,53223,0.495339597773627,0.0189120464968442,0.343595332152749,0.637492621350406
16,"Thüringen",16054000,"Suhl, Stadt",36570,17640,18930,0.482362592288761,38219,18827,19392,0.492608388497868,0.0189120464968442,0.343595332152749,0.637492621350406
16,"Thüringen",16055000,"Weimar, Stadt",62886,30310,32576,0.48198327131635,65542,31694,33848,0.483567788593574,0.0189120464968442,0.343595332152749,0.637492621350406
16,"Thüringen",16056000,"Eisenach, Stadt",41708,20207,21501,0.484487388510597,42661,20849,21812,0.488713344741098,0.0189120464968442,0.343595332152749,0.637492621350406
16,"Thüringen",16061001,"Arenshausen",1012,500,512,0.494071146245059,1021,502,519,0.491674828599412,0.0189120464968442,0.343595332152749,0.637492621350406
16,"Thüringen",16061002,"Asbach-Sickenberg",118,55,63,0.466101694915254,119,55,64,0.46218487394958,0.0189120464968442,0.343595332152749,0.637492621350406
16,"Thüringen",16061003,"Berlingerode",1201,595,606,0.495420482930891,1219,603,616,0.494667760459393,0.0189120464968442,0.343595332152749,0.637492621350406
16,"Thüringen",16061004,"Bernterode (bei Heilbad Heiligenstadt)",252,127,125,0.503968253968254,241,115,126,0.477178423236515,0.0189120464968442,0.343595332152749,0.637492621350406
16,"Thüringen",16061007,"Birkenfelde",588,297,291,0.505102040816326,591,309,282,0.522842639593909,0.0189120464968442,0.343595332152749,0.637492621350406
16,"Thüringen",16061012,"Bodenrode-Westhausen",1159,580,579,0.500431406384815,1155,569,586,0.492640692640693,0.0189120464968442,0.343595332152749,0.637492621350406
16,"Thüringen",16061014,"Bornhagen",275,136,139,0.494545454545455,295,146,149,0.494915254237288,0.0189120464968442,0.343595332152749,0.637492621350406
16,"Thüringen",16061015,"Brehme",1097,559,538,0.509571558796718,1115,571,544,0.512107623318386,0.0189120464968442,0.343595332152749,0.637492621350406
16,"Thüringen",16061017,"Breitenworbis",3408,1697,1711,0.497946009389671,3455,1737,1718,0.502749638205499,0.0189120464968442,0.343595332152749,0.637492621350406
16,"Thüringen",16061018,"Büttstedt",859,432,427,0.50291036088475,893,448,445,0.501679731243001,0.0189120464968442,0.343595332152749,0.637492621350406
16,"Thüringen",16061019,"Buhla",519,265,254,0.510597302504817,538,272,266,0.505576208178439,0.0189120464968442,0.343595332152749,0.637492621350406
16,"Thüringen",16061021,"Burgwalde",233,124,109,0.532188841201717,222,122,100,0.54954954954955,0.0189120464968442,0.343595332152749,0.637492621350406
16,"Thüringen",16061022,"Deuna",950,487,463,0.512631578947368,961,504,457,0.524453694068678,0.0189120464968442,0.343595332152749,0.637492621350406
16,"Thüringen",16061023,"Dieterode",76,44,32,0.578947368421053,82,47,35,0.573170731707317,0.0189120464968442,0.343595332152749,0.637492621350406
16,"Thüringen",16061024,"Dietzenrode/Vatterode",128,63,65,0.4921875,138,69,69,0.5,0.0189120464968442,0.343595332152749,0.637492621350406
16,"Thüringen",16061025,"Dingelstädt, Stadt",4381,2218,2163,0.506277105683634,4631,2350,2281,0.507449794860721,0.0189120464968442,0.343595332152749,0.637492621350406
16,"Thüringen",16061026,"Ecklingerode",723,368,355,0.508990318118949,781,404,377,0.517285531370038,0.0189120464968442,0.343595332152749,0.637492621350406
16,"Thüringen",16061027,"Effelder",1270,634,636,0.499212598425197,1298,646,652,0.49768875192604,0.0189120464968442,0.343595332152749,0.637492621350406
16,"Thüringen",16061028,"Eichstruth",92,47,45,0.510869565217391,90,48,42,0.533333333333333,0.0189120464968442,0.343595332152749,0.637492621350406
16,"Thüringen",16061031,"Ferna",568,291,277,0.512323943661972,563,289,274,0.513321492007105,0.0189120464968442,0.343595332152749,0.637492621350406
16,"Thüringen",16061032,"Freienhagen",294,155,139,0.527210884353742,304,160,144,0.526315789473684,0.0189120464968442,0.343595332152749,0.637492621350406
16,"Thüringen",16061033,"Fretterode",178,96,82,0.539325842696629,181,101,80,0.558011049723757,0.0189120464968442,0.343595332152749,0.637492621350406
16,"Thüringen",16061034,"Geisleden",1009,516,493,0.511397423191278,1019,519,500,0.509322865554465,0.0189120464968442,0.343595332152749,0.637492621350406
16,"Thüringen",16061035,"Geismar",1173,592,581,0.504688832054561,1161,588,573,0.506459948320413,0.0189120464968442,0.343595332152749,0.637492621350406
16,"Thüringen",16061036,"Gerbershausen",635,310,325,0.488188976377953,647,317,330,0.489953632148377,0.0189120464968442,0.343595332152749,0.637492621350406
16,"Thüringen",16061037,"Gernrode",1587,808,779,0.509136735979836,1608,832,776,0.517412935323383,0.0189120464968442,0.343595332152749,0.637492621350406
16,"Thüringen",16061038,"Gerterode",379,185,194,0.488126649076517,379,192,187,0.506596306068602,0.0189120464968442,0.343595332152749,0.637492621350406
16,"Thüringen",16061039,"Glasehausen",171,86,85,0.502923976608187,177,87,90,0.491525423728814,0.0189120464968442,0.343595332152749,0.637492621350406
16,"Thüringen",16061041,"Großbartloff",929,499,430,0.53713670613563,941,508,433,0.539851222104144,0.0189120464968442,0.343595332152749,0.637492621350406
16,"Thüringen",16061043,"Hausen",428,215,213,0.502336448598131,435,216,219,0.496551724137931,0.0189120464968442,0.343595332152749,0.637492621350406
16,"Thüringen",16061044,"Haynrode",670,348,322,0.519402985074627,665,347,318,0.521804511278195,0.0189120464968442,0.343595332152749,0.637492621350406
16,"Thüringen",16061045,"Heilbad Heiligenstadt, Stadt",16310,7955,8355,0.487737584304108,16603,8172,8431,0.492200204782268,0.0189120464968442,0.343595332152749,0.637492621350406
16,"Thüringen",16061046,"Helmsdorf",523,266,257,0.508604206500956,536,266,270,0.496268656716418,0.0189120464968442,0.343595332152749,0.637492621350406
16,"Thüringen",16061047,"Heuthen",751,377,374,0.501997336884154,755,378,377,0.500662251655629,0.0189120464968442,0.343595332152749,0.637492621350406
16,"Thüringen",16061048,"Hohengandern",574,308,266,0.536585365853659,570,308,262,0.540350877192982,0.0189120464968442,0.343595332152749,0.637492621350406
16,"Thüringen",16061049,"Hohes Kreuz",1346,678,668,0.5037147102526,1375,690,685,0.501818181818182,0.0189120464968442,0.343595332152749,0.637492621350406
16,"Thüringen",16061052,"Hundeshagen",1201,606,595,0.504579517069109,1247,632,615,0.506816359262229,0.0189120464968442,0.343595332152749,0.637492621350406
16,"Thüringen",16061054,"Kallmerode",610,303,307,0.49672131147541,628,308,320,0.490445859872611,0.0189120464968442,0.343595332152749,0.637492621350406
16,"Thüringen",16061055,"Kefferhausen",759,388,371,0.511198945981555,777,400,377,0.514800514800515,0.0189120464968442,0.343595332152749,0.637492621350406
16,"Thüringen",16061056,"Kella",535,272,263,0.508411214953271,550,279,271,0.507272727272727,0.0189120464968442,0.343595332152749,0.637492621350406
16,"Thüringen",16061057,"Kirchgandern",588,288,300,0.489795918367347,600,291,309,0.485,0.0189120464968442,0.343595332152749,0.637492621350406
16,"Thüringen",16061058,"Kirchworbis",1387,696,691,0.501802451333814,1365,694,671,0.508424908424908,0.0189120464968442,0.343595332152749,0.637492621350406
16,"Thüringen",16061059,"Kleinbartloff",417,215,202,0.515587529976019,430,223,207,0.518604651162791,0.0189120464968442,0.343595332152749,0.637492621350406
16,"Thüringen",16061061,"Kreuzebra",745,391,354,0.524832214765101,783,411,372,0.524904214559387,0.0189120464968442,0.343595332152749,0.637492621350406
16,"Thüringen",16061062,"Krombach",192,97,95,0.505208333333333,199,101,98,0.507537688442211,0.0189120464968442,0.343595332152749,0.637492621350406
16,"Thüringen",16061063,"Küllstedt",1410,696,714,0.493617021276596,1476,730,746,0.494579945799458,0.0189120464968442,0.343595332152749,0.637492621350406
16,"Thüringen",16061065,"Lenterode",308,150,158,0.487012987012987,308,153,155,0.496753246753247,0.0189120464968442,0.343595332152749,0.637492621350406
16,"Thüringen",16061066,"Lindewerra",239,121,118,0.506276150627615,240,121,119,0.504166666666667,0.0189120464968442,0.343595332152749,0.637492621350406
16,"Thüringen",16061067,"Lutter",727,386,341,0.530949105914718,723,384,339,0.531120331950207,0.0189120464968442,0.343595332152749,0.637492621350406
16,"Thüringen",16061068,"Mackenrode",303,156,147,0.514851485148515,345,178,167,0.515942028985507,0.0189120464968442,0.343595332152749,0.637492621350406
16,"Thüringen",16061069,"Marth",343,188,155,0.548104956268222,353,194,159,0.54957507082153,0.0189120464968442,0.343595332152749,0.637492621350406
16,"Thüringen",16061074,"Niederorschel",3114,1543,1571,0.495504174694926,3251,1618,1633,0.497693017533067,0.0189120464968442,0.343595332152749,0.637492621350406
16,"Thüringen",16061075,"Pfaffschwende",294,154,140,0.523809523809524,338,170,168,0.502958579881657,0.0189120464968442,0.343595332152749,0.637492621350406
16,"Thüringen",16061076,"Reinholterode",788,405,383,0.513959390862944,792,408,384,0.515151515151515,0.0189120464968442,0.343595332152749,0.637492621350406
16,"Thüringen",16061077,"Röhrig",241,118,123,0.489626556016597,249,120,129,0.481927710843373,0.0189120464968442,0.343595332152749,0.637492621350406
16,"Thüringen",16061078,"Rohrberg",240,123,117,0.5125,232,123,109,0.530172413793103,0.0189120464968442,0.343595332152749,0.637492621350406
16,"Thüringen",16061082,"Rustenfelde",504,256,248,0.507936507936508,508,259,249,0.509842519685039,0.0189120464968442,0.343595332152749,0.637492621350406
16,"Thüringen",16061083,"Schachtebich",266,129,137,0.484962406015038,268,132,136,0.492537313432836,0.0189120464968442,0.343595332152749,0.637492621350406
16,"Thüringen",16061084,"Schönhagen",146,76,70,0.520547945205479,152,79,73,0.519736842105263,0.0189120464968442,0.343595332152749,0.637492621350406
16,"Thüringen",16061085,"Schwobfeld",120,61,59,0.508333333333333,122,63,59,0.516393442622951,0.0189120464968442,0.343595332152749,0.637492621350406
16,"Thüringen",16061086,"Sickerode",150,82,68,0.546666666666667,152,80,72,0.526315789473684,0.0189120464968442,0.343595332152749,0.637492621350406
16,"Thüringen",16061087,"Silberhausen",650,330,320,0.507692307692308,693,347,346,0.500721500721501,0.0189120464968442,0.343595332152749,0.637492621350406
16,"Thüringen",16061089,"Steinbach",560,282,278,0.503571428571429,561,279,282,0.497326203208556,0.0189120464968442,0.343595332152749,0.637492621350406
16,"Thüringen",16061091,"Steinheuterode",250,128,122,0.512,250,128,122,0.512,0.0189120464968442,0.343595332152749,0.637492621350406
16,"Thüringen",16061094,"Tastungen",255,126,129,0.494117647058824,265,130,135,0.490566037735849,0.0189120464968442,0.343595332152749,0.637492621350406
16,"Thüringen",16061096,"Thalwenden",394,191,203,0.484771573604061,381,190,191,0.498687664041995,0.0189120464968442,0.343595332152749,0.637492621350406
16,"Thüringen",16061097,"Uder",2542,1300,1242,0.51140833988985,2532,1303,1229,0.514612954186414,0.0189120464968442,0.343595332152749,0.637492621350406
16,"Thüringen",16061098,"Volkerode",235,117,118,0.497872340425532,240,122,118,0.508333333333333,0.0189120464968442,0.343595332152749,0.637492621350406
16,"Thüringen",16061099,"Vollenborn",232,106,126,0.456896551724138,238,110,128,0.46218487394958,0.0189120464968442,0.343595332152749,0.637492621350406
16,"Thüringen",16061101,"Wachstedt",502,253,249,0.50398406374502,511,259,252,0.506849315068493,0.0189120464968442,0.343595332152749,0.637492621350406
16,"Thüringen",16061102,"Wahlhausen",315,152,163,0.482539682539683,334,163,171,0.488023952095808,0.0189120464968442,0.343595332152749,0.637492621350406
16,"Thüringen",16061103,"Wehnde",372,186,186,0.5,381,192,189,0.503937007874016,0.0189120464968442,0.343595332152749,0.637492621350406
16,"Thüringen",16061105,"Wiesenfeld",239,127,112,0.531380753138075,237,125,112,0.527426160337553,0.0189120464968442,0.343595332152749,0.637492621350406
16,"Thüringen",16061107,"Wingerode",1223,630,593,0.515126737530662,1225,634,591,0.517551020408163,0.0189120464968442,0.343595332152749,0.637492621350406
16,"Thüringen",16061111,"Wüstheuterode",616,306,310,0.496753246753247,606,300,306,0.495049504950495,0.0189120464968442,0.343595332152749,0.637492621350406
16,"Thüringen",16061113,"Schimberg",2306,1169,1137,0.506938421509107,2282,1154,1128,0.5056967572305,0.0189120464968442,0.343595332152749,0.637492621350406
16,"Thüringen",16061114,"Teistungen",2484,1279,1205,0.514895330112721,2500,1287,1213,0.5148,0.0189120464968442,0.343595332152749,0.637492621350406
16,"Thüringen",16061115,"Leinefelde-Worbis, Stadt",18585,9213,9372,0.495722356739306,19561,9746,9815,0.498236286488421,0.0189120464968442,0.343595332152749,0.637492621350406
16,"Thüringen",16061116,"Am Ohmberg",3829,1925,1904,0.502742230347349,3954,2004,1950,0.506828528072838,0.0189120464968442,0.343595332152749,0.637492621350406
16,"Thüringen",16061117,"Sonnenstein",4824,2436,2388,0.504975124378109,4946,2495,2451,0.504448038819248,0.0189120464968442,0.343595332152749,0.637492621350406
16,"Thüringen",16062002,"Bleicherode, Stadt",6477,3207,3270,0.495136637332098,6677,3236,3441,0.484648794368728,0.0189120464968442,0.343595332152749,0.637492621350406
16,"Thüringen",16062004,"Buchholz",232,129,103,0.556034482758621,216,115,101,0.532407407407407,0.0189120464968442,0.343595332152749,0.637492621350406
16,"Thüringen",16062005,"Ellrich, Stadt",5602,2773,2829,0.495001785076758,5609,2790,2819,0.497414868960599,0.0189120464968442,0.343595332152749,0.637492621350406
16,"Thüringen",16062006,"Etzelsrode",98,51,47,0.520408163265306,97,50,47,0.515463917525773,0.0189120464968442,0.343595332152749,0.637492621350406
16,"Thüringen",16062007,"Friedrichsthal",233,118,115,0.506437768240343,230,116,114,0.504347826086956,0.0189120464968442,0.343595332152749,0.637492621350406
16,"Thüringen",16062008,"Görsbach",1058,537,521,0.507561436672968,1085,547,538,0.504147465437788,0.0189120464968442,0.343595332152749,0.637492621350406
16,"Thüringen",16062009,"Großlohra",938,478,460,0.509594882729211,960,495,465,0.515625,0.0189120464968442,0.343595332152749,0.637492621350406
16,"Thüringen",16062014,"Hainrode/Hainleite",375,180,195,0.48,371,178,193,0.479784366576819,0.0189120464968442,0.343595332152749,0.637492621350406
16,"Thüringen",16062016,"Harzungen",214,101,113,0.47196261682243,211,97,114,0.459715639810427,0.0189120464968442,0.343595332152749,0.637492621350406
16,"Thüringen",16062018,"Herrmannsacker",379,194,185,0.511873350923483,390,202,188,0.517948717948718,0.0189120464968442,0.343595332152749,0.637492621350406
16,"Thüringen",16062022,"Ilfeld",2959,1423,1536,0.480905711388983,2973,1456,1517,0.489741002354524,0.0189120464968442,0.343595332152749,0.637492621350406
16,"Thüringen",16062024,"Kehmstedt",480,242,238,0.504166666666667,477,243,234,0.509433962264151,0.0189120464968442,0.343595332152749,0.637492621350406
16,"Thüringen",16062025,"Kleinbodungen",374,195,179,0.521390374331551,378,197,181,0.521164021164021,0.0189120464968442,0.343595332152749,0.637492621350406
16,"Thüringen",16062026,"Kleinfurra",1148,581,567,0.50609756097561,1162,583,579,0.501721170395869,0.0189120464968442,0.343595332152749,0.637492621350406
16,"Thüringen",16062029,"Kraja",297,155,142,0.521885521885522,310,159,151,0.512903225806452,0.0189120464968442,0.343595332152749,0.637492621350406
16,"Thüringen",16062033,"Lipprechterode",566,288,278,0.508833922261484,584,296,288,0.506849315068493,0.0189120464968442,0.343595332152749,0.637492621350406
16,"Thüringen",16062036,"Neustadt/Harz",1123,571,552,0.508459483526269,1127,573,554,0.508429458740018,0.0189120464968442,0.343595332152749,0.637492621350406
16,"Thüringen",16062037,"Niedergebra",720,362,358,0.502777777777778,697,330,367,0.473457675753228,0.0189120464968442,0.343595332152749,0.637492621350406
16,"Thüringen",16062038,"Niedersachswerfen",3174,1532,1642,0.482671707624449,3225,1551,1674,0.48093023255814,0.0189120464968442,0.343595332152749,0.637492621350406
16,"Thüringen",16062039,"Nohra",895,444,451,0.49608938547486,852,427,425,0.501173708920188,0.0189120464968442,0.343595332152749,0.637492621350406
16,"Thüringen",16062041,"Nordhausen, Stadt",42191,20566,21625,0.487449930079875,43943,21591,22352,0.491341055458207,0.0189120464968442,0.343595332152749,0.637492621350406
16,"Thüringen",16062049,"Sollstedt",3120,1561,1559,0.500320512820513,3185,1602,1583,0.50298273155416,0.0189120464968442,0.343595332152749,0.637492621350406
16,"Thüringen",16062054,"Urbach",910,462,448,0.507692307692308,925,476,449,0.514594594594595,0.0189120464968442,0.343595332152749,0.637492621350406
16,"Thüringen",16062058,"Wipperdorf",1399,704,695,0.503216583273767,1418,721,697,0.508462623413258,0.0189120464968442,0.343595332152749,0.637492621350406
16,"Thüringen",16062059,"Wolkramshausen",998,523,475,0.524048096192385,1012,536,476,0.529644268774704,0.0189120464968442,0.343595332152749,0.637492621350406
16,"Thüringen",16062062,"Hohenstein",2382,1197,1185,0.502518891687657,2563,1306,1257,0.509559110417479,0.0189120464968442,0.343595332152749,0.637492621350406
16,"Thüringen",16062063,"Werther",3329,1668,1661,0.50105136677681,3351,1676,1675,0.500149209191286,0.0189120464968442,0.343595332152749,0.637492621350406
16,"Thüringen",16062064,"Heringen/Helme, Stadt",5063,2539,2524,0.501481335176773,5164,2581,2583,0.499806351665376,0.0189120464968442,0.343595332152749,0.637492621350406
16,"Thüringen",16063001,"Andenhausen",209,108,101,0.516746411483254,209,108,101,0.516746411483254,0.0189120464968442,0.343595332152749,0.637492621350406
16,"Thüringen",16063002,"Bad Liebenstein, Stadt",3983,1848,2135,0.463971880492091,3971,1856,2115,0.467388567111559,0.0189120464968442,0.343595332152749,0.637492621350406
16,"Thüringen",16063003,"Bad Salzungen, Stadt",15600,7560,8040,0.484615384615385,15773,7670,8103,0.486274012553097,0.0189120464968442,0.343595332152749,0.637492621350406
16,"Thüringen",16063004,"Barchfeld",3178,1587,1591,0.499370673379484,3144,1570,1574,0.499363867684478,0.0189120464968442,0.343595332152749,0.637492621350406
16,"Thüringen",16063006,"Berka v. d. Hainich",787,390,397,0.495552731893266,805,396,409,0.491925465838509,0.0189120464968442,0.343595332152749,0.637492621350406
16,"Thüringen",16063007,"Berka/Werra, Stadt",4356,2187,2169,0.502066115702479,4341,2189,2152,0.504261690854642,0.0189120464968442,0.343595332152749,0.637492621350406
16,"Thüringen",16063008,"Bischofroda",680,336,344,0.494117647058824,687,342,345,0.497816593886463,0.0189120464968442,0.343595332152749,0.637492621350406
16,"Thüringen",16063009,"Brunnhartshausen",381,195,186,0.511811023622047,385,194,191,0.503896103896104,0.0189120464968442,0.343595332152749,0.637492621350406
16,"Thüringen",16063011,"Buttlar",1319,676,643,0.512509476876422,1378,713,665,0.517416545718433,0.0189120464968442,0.343595332152749,0.637492621350406
16,"Thüringen",16063013,"Creuzburg, Stadt",2459,1205,1254,0.490036600244002,2431,1193,1238,0.490744549568079,0.0189120464968442,0.343595332152749,0.637492621350406
16,"Thüringen",16063014,"Dankmarshausen",1015,517,498,0.50935960591133,1041,532,509,0.51104707012488,0.0189120464968442,0.343595332152749,0.637492621350406
16,"Thüringen",16063015,"Dermbach",3098,1520,1578,0.490639122014203,3066,1516,1550,0.494455316373125,0.0189120464968442,0.343595332152749,0.637492621350406
16,"Thüringen",16063016,"Diedorf/Rhön",374,199,175,0.532085561497326,376,192,184,0.51063829787234,0.0189120464968442,0.343595332152749,0.637492621350406
16,"Thüringen",16063017,"Dippach",1094,571,523,0.521937842778793,1083,565,518,0.521698984302862,0.0189120464968442,0.343595332152749,0.637492621350406
16,"Thüringen",16063018,"Dorndorf",2542,1271,1271,0.5,2581,1287,1294,0.498643936458737,0.0189120464968442,0.343595332152749,0.637492621350406
16,"Thüringen",16063019,"Ebenshausen",288,149,139,0.517361111111111,289,150,139,0.519031141868512,0.0189120464968442,0.343595332152749,0.637492621350406
16,"Thüringen",16063023,"Empfertshausen",599,306,293,0.510851419031719,595,299,296,0.502521008403361,0.0189120464968442,0.343595332152749,0.637492621350406
16,"Thüringen",16063024,"Ettenhausen a.d. Suhl",424,217,207,0.511792452830189,455,228,227,0.501098901098901,0.0189120464968442,0.343595332152749,0.637492621350406
16,"Thüringen",16063026,"Fischbach/Rhön",558,288,270,0.516129032258065,566,286,280,0.50530035335689,0.0189120464968442,0.343595332152749,0.637492621350406
16,"Thüringen",16063028,"Frankenroda",337,170,167,0.504451038575668,337,168,169,0.498516320474777,0.0189120464968442,0.343595332152749,0.637492621350406
16,"Thüringen",16063029,"Frauensee",856,443,413,0.517523364485981,868,449,419,0.517281105990783,0.0189120464968442,0.343595332152749,0.637492621350406
16,"Thüringen",16063032,"Geisa, Stadt",4671,2345,2326,0.502033825733248,4735,2401,2334,0.507074973600845,0.0189120464968442,0.343595332152749,0.637492621350406
16,"Thüringen",16063033,"Gerstengrund",60,33,27,0.55,61,33,28,0.540983606557377,0.0189120464968442,0.343595332152749,0.637492621350406
16,"Thüringen",16063036,"Großensee",193,95,98,0.492227979274611,200,90,110,0.45,0.0189120464968442,0.343595332152749,0.637492621350406
16,"Thüringen",16063037,"Hallungen",217,112,105,0.516129032258065,220,108,112,0.490909090909091,0.0189120464968442,0.343595332152749,0.637492621350406
16,"Thüringen",16063039,"Ifta",1161,595,566,0.512489233419466,1184,602,582,0.508445945945946,0.0189120464968442,0.343595332152749,0.637492621350406
16,"Thüringen",16063041,"Immelborn",1603,808,795,0.504054897067998,1648,830,818,0.503640776699029,0.0189120464968442,0.343595332152749,0.637492621350406
16,"Thüringen",16063043,"Kaltenlengsfeld",427,225,202,0.526932084309134,425,232,193,0.545882352941176,0.0189120464968442,0.343595332152749,0.637492621350406
16,"Thüringen",16063044,"Kaltennordheim, Stadt",1717,843,874,0.490972626674432,1722,859,863,0.49883855981417,0.0189120464968442,0.343595332152749,0.637492621350406
16,"Thüringen",16063045,"Klings",467,236,231,0.505353319057816,467,241,226,0.516059957173448,0.0189120464968442,0.343595332152749,0.637492621350406
16,"Thüringen",16063046,"Krauthausen",1610,833,777,0.517391304347826,1632,836,796,0.512254901960784,0.0189120464968442,0.343595332152749,0.637492621350406
16,"Thüringen",16063049,"Lauterbach",668,327,341,0.489520958083832,664,326,338,0.490963855421687,0.0189120464968442,0.343595332152749,0.637492621350406
16,"Thüringen",16063051,"Leimbach",1753,886,867,0.505419281232173,1773,887,886,0.500282007896221,0.0189120464968442,0.343595332152749,0.637492621350406
16,"Thüringen",16063052,"Marksuhl",2947,1518,1429,0.515100101798439,2991,1534,1457,0.512871949180876,0.0189120464968442,0.343595332152749,0.637492621350406
16,"Thüringen",16063053,"Martinroda",275,143,132,0.52,268,139,129,0.51865671641791,0.0189120464968442,0.343595332152749,0.637492621350406
16,"Thüringen",16063054,"Merkers-Kieselbach",2902,1460,1442,0.503101309441764,2977,1503,1474,0.504870675176352,0.0189120464968442,0.343595332152749,0.637492621350406
16,"Thüringen",16063055,"Mihla",2234,1149,1085,0.514324082363474,2240,1141,1099,0.509375,0.0189120464968442,0.343595332152749,0.637492621350406
16,"Thüringen",16063058,"Nazza",569,297,272,0.521968365553603,581,306,275,0.526678141135972,0.0189120464968442,0.343595332152749,0.637492621350406
16,"Thüringen",16063059,"Neidhartshausen",329,157,172,0.477203647416413,322,155,167,0.481366459627329,0.0189120464968442,0.343595332152749,0.637492621350406
16,"Thüringen",16063062,"Oechsen",653,319,334,0.488514548238897,628,319,309,0.50796178343949,0.0189120464968442,0.343595332152749,0.637492621350406
16,"Thüringen",16063066,"Ruhla, Stadt",5949,2901,3048,0.487644982349975,5984,2887,3097,0.48245320855615,0.0189120464968442,0.343595332152749,0.637492621350406
16,"Thüringen",16063068,"Schleid",1028,532,496,0.517509727626459,1056,544,512,0.515151515151515,0.0189120464968442,0.343595332152749,0.637492621350406
16,"Thüringen",16063069,"Schweina",2900,1470,1430,0.506896551724138,2946,1497,1449,0.508146639511202,0.0189120464968442,0.343595332152749,0.637492621350406
16,"Thüringen",16063071,"Seebach",2083,1030,1053,0.494479116658665,2159,1069,1090,0.495136637332098,0.0189120464968442,0.343595332152749,0.637492621350406
16,"Thüringen",16063072,"Stadtlengsfeld, Stadt",2473,1243,1230,0.50262838657501,2499,1264,1235,0.505802320928371,0.0189120464968442,0.343595332152749,0.637492621350406
16,"Thüringen",16063073,"Steinbach",1183,600,583,0.507185122569738,1185,613,572,0.517299578059072,0.0189120464968442,0.343595332152749,0.637492621350406
16,"Thüringen",16063075,"Tiefenort",4037,2048,1989,0.507307406489968,4052,2055,1997,0.50715695952616,0.0189120464968442,0.343595332152749,0.637492621350406
16,"Thüringen",16063076,"Treffurt, Stadt",5342,2662,2680,0.498315237738675,5545,2781,2764,0.501532912533814,0.0189120464968442,0.343595332152749,0.637492621350406
16,"Thüringen",16063078,"Unterbreizbach",3648,1847,1801,0.506304824561403,3719,1879,1840,0.505243344985211,0.0189120464968442,0.343595332152749,0.637492621350406
16,"Thüringen",16063081,"Urnshausen",763,401,362,0.525557011795544,762,395,367,0.518372703412074,0.0189120464968442,0.343595332152749,0.637492621350406
16,"Thüringen",16063082,"Vacha, Stadt",3650,1784,1866,0.488767123287671,3709,1831,1878,0.493664060393637,0.0189120464968442,0.343595332152749,0.637492621350406
16,"Thüringen",16063083,"Völkershausen",1191,584,607,0.490344248530647,1170,571,599,0.488034188034188,0.0189120464968442,0.343595332152749,0.637492621350406
16,"Thüringen",16063084,"Weilar",883,416,467,0.471121177802944,883,409,474,0.463193657984145,0.0189120464968442,0.343595332152749,0.637492621350406
16,"Thüringen",16063086,"Wiesenthal",798,409,389,0.512531328320802,756,398,358,0.526455026455027,0.0189120464968442,0.343595332152749,0.637492621350406
16,"Thüringen",16063087,"Wölferbütt",381,189,192,0.496062992125984,394,197,197,0.5,0.0189120464968442,0.343595332152749,0.637492621350406
16,"Thüringen",16063089,"Wolfsburg-Unkeroda",696,341,355,0.489942528735632,718,353,365,0.491643454038997,0.0189120464968442,0.343595332152749,0.637492621350406
16,"Thüringen",16063092,"Wutha-Farnroda",6350,3260,3090,0.513385826771654,6572,3389,3183,0.515672550213025,0.0189120464968442,0.343595332152749,0.637492621350406
16,"Thüringen",16063093,"Zella/Rhön",462,224,238,0.484848484848485,453,222,231,0.490066225165563,0.0189120464968442,0.343595332152749,0.637492621350406
16,"Thüringen",16063094,"Moorgrund",3451,1725,1726,0.499855114459577,3487,1730,1757,0.496128477201032,0.0189120464968442,0.343595332152749,0.637492621350406
16,"Thüringen",16063097,"Gerstungen",5917,2998,2919,0.506675680243367,6003,3107,2896,0.517574546060303,0.0189120464968442,0.343595332152749,0.637492621350406
16,"Thüringen",16063098,"Hörselberg-Hainich",6327,3233,3094,0.510984668879406,6313,3235,3078,0.5124346586409,0.0189120464968442,0.343595332152749,0.637492621350406
16,"Thüringen",16064001,"Altengottern",1041,507,534,0.487031700288184,1040,508,532,0.488461538461538,0.0189120464968442,0.343595332152749,0.637492621350406
16,"Thüringen",16064003,"Bad Langensalza, Stadt",17744,8657,9087,0.487883228133454,17801,8698,9103,0.488624234593562,0.0189120464968442,0.343595332152749,0.637492621350406
16,"Thüringen",16064004,"Bad Tennstedt, Stadt",2525,1271,1254,0.503366336633663,2527,1262,1265,0.499406410763751,0.0189120464968442,0.343595332152749,0.637492621350406
16,"Thüringen",16064005,"Ballhausen",895,448,447,0.500558659217877,893,440,453,0.492721164613662,0.0189120464968442,0.343595332152749,0.637492621350406
16,"Thüringen",16064007,"Blankenburg",166,80,86,0.481927710843373,144,72,72,0.5,0.0189120464968442,0.343595332152749,0.637492621350406
16,"Thüringen",16064008,"Bothenheilingen",474,244,230,0.514767932489452,487,246,241,0.505133470225873,0.0189120464968442,0.343595332152749,0.637492621350406
16,"Thüringen",16064009,"Bruchstedt",257,125,132,0.486381322957198,252,118,134,0.468253968253968,0.0189120464968442,0.343595332152749,0.637492621350406
16,"Thüringen",16064014,"Dünwald",2351,1188,1163,0.505316886431306,2332,1177,1155,0.504716981132076,0.0189120464968442,0.343595332152749,0.637492621350406
16,"Thüringen",16064017,"Flarchheim",428,223,205,0.521028037383178,432,226,206,0.523148148148148,0.0189120464968442,0.343595332152749,0.637492621350406
16,"Thüringen",16064018,"Großengottern",2250,1122,1128,0.498666666666667,2250,1116,1134,0.496,0.0189120464968442,0.343595332152749,0.637492621350406
16,"Thüringen",16064019,"Großvargula",758,367,391,0.484168865435356,721,349,372,0.484049930651872,0.0189120464968442,0.343595332152749,0.637492621350406
16,"Thüringen",16064021,"Haussömmern",248,121,127,0.487903225806452,242,126,116,0.520661157024793,0.0189120464968442,0.343595332152749,0.637492621350406
16,"Thüringen",16064022,"Herbsleben",3032,1526,1506,0.503298153034301,3016,1509,1507,0.500331564986737,0.0189120464968442,0.343595332152749,0.637492621350406
16,"Thüringen",16064023,"Heroldishausen",203,98,105,0.482758620689655,209,102,107,0.488038277511962,0.0189120464968442,0.343595332152749,0.637492621350406
16,"Thüringen",16064027,"Hornsömmern",148,73,75,0.493243243243243,146,72,74,0.493150684931507,0.0189120464968442,0.343595332152749,0.637492621350406
16,"Thüringen",16064029,"Issersheilingen",125,64,61,0.512,125,60,65,0.48,0.0189120464968442,0.343595332152749,0.637492621350406
16,"Thüringen",16064032,"Kammerforst",850,425,425,0.5,855,430,425,0.502923976608187,0.0189120464968442,0.343595332152749,0.637492621350406
16,"Thüringen",16064033,"Kirchheilingen",803,410,393,0.510585305105853,821,424,397,0.516443361753959,0.0189120464968442,0.343595332152749,0.637492621350406
16,"Thüringen",16064035,"Kleinwelsbach",138,76,62,0.550724637681159,129,71,58,0.550387596899225,0.0189120464968442,0.343595332152749,0.637492621350406
16,"Thüringen",16064036,"Klettstedt",216,110,106,0.509259259259259,213,108,105,0.507042253521127,0.0189120464968442,0.343595332152749,0.637492621350406
16,"Thüringen",16064037,"Körner",1765,875,890,0.495750708215297,1784,885,899,0.496076233183857,0.0189120464968442,0.343595332152749,0.637492621350406
16,"Thüringen",16064038,"Kutzleben",646,333,313,0.515479876160991,632,325,307,0.514240506329114,0.0189120464968442,0.343595332152749,0.637492621350406
16,"Thüringen",16064039,"Langula",1013,510,503,0.503455083909181,1037,525,512,0.506268081002893,0.0189120464968442,0.343595332152749,0.637492621350406
16,"Thüringen",16064043,"Marolterode",321,169,152,0.526479750778816,321,170,151,0.529595015576324,0.0189120464968442,0.343595332152749,0.637492621350406
16,"Thüringen",16064045,"Mittelsömmern",228,109,119,0.478070175438596,223,111,112,0.497757847533632,0.0189120464968442,0.343595332152749,0.637492621350406
16,"Thüringen",16064046,"Mühlhausen/Thüringen, Stadt",33395,16044,17351,0.48043120227579,35875,17787,18088,0.49580487804878,0.0189120464968442,0.343595332152749,0.637492621350406
16,"Thüringen",16064047,"Mülverstedt",698,352,346,0.504297994269341,704,350,354,0.497159090909091,0.0189120464968442,0.343595332152749,0.637492621350406
16,"Thüringen",16064048,"Neunheilingen",495,239,256,0.482828282828283,496,241,255,0.485887096774194,0.0189120464968442,0.343595332152749,0.637492621350406
16,"Thüringen",16064049,"Niederdorla",1343,674,669,0.501861504095309,1352,683,669,0.505177514792899,0.0189120464968442,0.343595332152749,0.637492621350406
16,"Thüringen",16064051,"Oberdorla",2120,1058,1062,0.499056603773585,2105,1057,1048,0.502137767220903,0.0189120464968442,0.343595332152749,0.637492621350406
16,"Thüringen",16064052,"Obermehler",904,475,429,0.525442477876106,910,477,433,0.524175824175824,0.0189120464968442,0.343595332152749,0.637492621350406
16,"Thüringen",16064053,"Oppershausen",314,156,158,0.496815286624204,317,157,160,0.495268138801262,0.0189120464968442,0.343595332152749,0.637492621350406
16,"Thüringen",16064055,"Rodeberg",2064,1074,990,0.520348837209302,2109,1099,1010,0.521100047415837,0.0189120464968442,0.343595332152749,0.637492621350406
16,"Thüringen",16064057,"Schlotheim, Stadt",3876,1872,2004,0.48297213622291,3897,1902,1995,0.488067744418784,0.0189120464968442,0.343595332152749,0.637492621350406
16,"Thüringen",16064058,"Schönstedt",1405,719,686,0.511743772241993,1400,715,685,0.510714285714286,0.0189120464968442,0.343595332152749,0.637492621350406
16,"Thüringen",16064061,"Sundhausen",385,193,192,0.501298701298701,379,186,193,0.490765171503958,0.0189120464968442,0.343595332152749,0.637492621350406
16,"Thüringen",16064062,"Tottleben",151,75,76,0.496688741721854,149,78,71,0.523489932885906,0.0189120464968442,0.343595332152749,0.637492621350406
16,"Thüringen",16064064,"Urleben",435,218,217,0.501149425287356,418,212,206,0.507177033492823,0.0189120464968442,0.343595332152749,0.637492621350406
16,"Thüringen",16064065,"Weberstedt",593,294,299,0.495784148397976,579,288,291,0.49740932642487,0.0189120464968442,0.343595332152749,0.637492621350406
16,"Thüringen",16064066,"Weinbergen",3130,1574,1556,0.502875399361022,3090,1576,1514,0.510032362459547,0.0189120464968442,0.343595332152749,0.637492621350406
16,"Thüringen",16064071,"Unstruttal",3254,1651,1603,0.507375537799631,3267,1655,1612,0.506580961126416,0.0189120464968442,0.343595332152749,0.637492621350406
16,"Thüringen",16064072,"Menteroda",2171,1077,1094,0.496084753569783,2151,1072,1079,0.498372849837285,0.0189120464968442,0.343595332152749,0.637492621350406
16,"Thüringen",16064073,"Anrode",3334,1685,1649,0.505398920215957,3311,1678,1633,0.506795530051344,0.0189120464968442,0.343595332152749,0.637492621350406
16,"Thüringen",16064074,"Südeichsfeld",6991,3522,3469,0.503790587898727,6899,3495,3404,0.506595158718655,0.0189120464968442,0.343595332152749,0.637492621350406
16,"Thüringen",16065001,"Abtsbessingen",508,263,245,0.517716535433071,516,265,251,0.513565891472868,0.0189120464968442,0.343595332152749,0.637492621350406
16,"Thüringen",16065002,"Artern/Unstrut, Stadt",5742,2777,2965,0.483629397422501,5700,2751,2949,0.482631578947368,0.0189120464968442,0.343595332152749,0.637492621350406
16,"Thüringen",16065003,"Bad Frankenhausen/Kyffhäuser, Stadt",8677,4250,4427,0.489800622334908,8844,4332,4512,0.489823609226594,0.0189120464968442,0.343595332152749,0.637492621350406
16,"Thüringen",16065004,"Badra",560,284,276,0.507142857142857,569,289,280,0.507908611599297,0.0189120464968442,0.343595332152749,0.637492621350406
16,"Thüringen",16065005,"Bellstedt",171,91,80,0.532163742690059,170,91,79,0.535294117647059,0.0189120464968442,0.343595332152749,0.637492621350406
16,"Thüringen",16065006,"Bendeleben",681,320,361,0.469897209985316,688,331,357,0.481104651162791,0.0189120464968442,0.343595332152749,0.637492621350406
16,"Thüringen",16065008,"Borxleben",293,143,150,0.488054607508532,292,143,149,0.48972602739726,0.0189120464968442,0.343595332152749,0.637492621350406
16,"Thüringen",16065011,"Bretleben",577,292,285,0.506065857885615,579,292,287,0.504317789291883,0.0189120464968442,0.343595332152749,0.637492621350406
16,"Thüringen",16065012,"Clingen, Stadt",1052,529,523,0.502851711026616,1057,533,524,0.504257332071902,0.0189120464968442,0.343595332152749,0.637492621350406
16,"Thüringen",16065013,"Donndorf",826,412,414,0.498789346246973,825,410,415,0.496969696969697,0.0189120464968442,0.343595332152749,0.637492621350406
16,"Thüringen",16065014,"Ebeleben, Stadt",2869,1463,1406,0.509933774834437,2915,1506,1409,0.51663807890223,0.0189120464968442,0.343595332152749,0.637492621350406
16,"Thüringen",16065016,"Etzleben",289,146,143,0.505190311418685,285,145,140,0.508771929824561,0.0189120464968442,0.343595332152749,0.637492621350406
16,"Thüringen",16065018,"Freienbessingen",249,149,100,0.598393574297189,308,178,130,0.577922077922078,0.0189120464968442,0.343595332152749,0.637492621350406
16,"Thüringen",16065019,"Gehofen",689,351,338,0.509433962264151,689,351,338,0.509433962264151,0.0189120464968442,0.343595332152749,0.637492621350406
16,"Thüringen",16065021,"Göllingen",685,349,336,0.509489051094891,709,356,353,0.502115655853315,0.0189120464968442,0.343595332152749,0.637492621350406
16,"Thüringen",16065022,"Gorsleben",539,288,251,0.534322820037106,542,289,253,0.533210332103321,0.0189120464968442,0.343595332152749,0.637492621350406
16,"Thüringen",16065023,"Greußen, Stadt",3713,1832,1881,0.493401562079181,3725,1836,1889,0.492885906040268,0.0189120464968442,0.343595332152749,0.637492621350406
16,"Thüringen",16065027,"Günserode",164,84,80,0.51219512195122,161,81,80,0.503105590062112,0.0189120464968442,0.343595332152749,0.637492621350406
16,"Thüringen",16065029,"Hachelbich",597,303,294,0.507537688442211,599,306,293,0.510851419031719,0.0189120464968442,0.343595332152749,0.637492621350406
16,"Thüringen",16065031,"Hauteroda",549,273,276,0.497267759562842,550,276,274,0.501818181818182,0.0189120464968442,0.343595332152749,0.637492621350406
16,"Thüringen",16065032,"Helbedündorf",2530,1300,1230,0.513833992094862,2574,1325,1249,0.514763014763015,0.0189120464968442,0.343595332152749,0.637492621350406
16,"Thüringen",16065033,"Heldrungen, Stadt",2274,1085,1189,0.477132805628848,2223,1057,1166,0.475483580746739,0.0189120464968442,0.343595332152749,0.637492621350406
16,"Thüringen",16065034,"Hemleben",228,120,108,0.526315789473684,239,126,113,0.527196652719665,0.0189120464968442,0.343595332152749,0.637492621350406
16,"Thüringen",16065035,"Heygendorf",575,292,283,0.507826086956522,592,306,286,0.516891891891892,0.0189120464968442,0.343595332152749,0.637492621350406
16,"Thüringen",16065038,"Holzsußra",276,133,143,0.481884057971014,286,136,150,0.475524475524476,0.0189120464968442,0.343595332152749,0.637492621350406
16,"Thüringen",16065039,"Ichstedt",606,312,294,0.514851485148515,614,318,296,0.517915309446254,0.0189120464968442,0.343595332152749,0.637492621350406
16,"Thüringen",16065042,"Kalbsrieth",705,351,354,0.497872340425532,739,370,369,0.500676589986468,0.0189120464968442,0.343595332152749,0.637492621350406
16,"Thüringen",16065046,"Mönchpfiffel-Nikolausrieth",347,182,165,0.524495677233429,374,198,176,0.529411764705882,0.0189120464968442,0.343595332152749,0.637492621350406
16,"Thüringen",16065047,"Nausitz",167,90,77,0.538922155688623,172,95,77,0.552325581395349,0.0189120464968442,0.343595332152749,0.637492621350406
16,"Thüringen",16065048,"Niederbösa",133,70,63,0.526315789473684,134,68,66,0.507462686567164,0.0189120464968442,0.343595332152749,0.637492621350406
16,"Thüringen",16065051,"Oberbösa",397,206,191,0.518891687657431,387,199,188,0.51421188630491,0.0189120464968442,0.343595332152749,0.637492621350406
16,"Thüringen",16065052,"Oberheldrungen",848,436,412,0.514150943396226,872,459,413,0.526376146788991,0.0189120464968442,0.343595332152749,0.637492621350406
16,"Thüringen",16065054,"Oldisleben",2227,1134,1093,0.509205208801078,2261,1154,1107,0.510393631136665,0.0189120464968442,0.343595332152749,0.637492621350406
16,"Thüringen",16065056,"Reinsdorf",782,391,391,0.5,799,396,403,0.495619524405507,0.0189120464968442,0.343595332152749,0.637492621350406
16,"Thüringen",16065057,"Ringleben",898,439,459,0.488864142538975,924,460,464,0.497835497835498,0.0189120464968442,0.343595332152749,0.637492621350406
16,"Thüringen",16065058,"Rockstedt",252,126,126,0.5,248,122,126,0.491935483870968,0.0189120464968442,0.343595332152749,0.637492621350406
16,"Thüringen",16065061,"Roßleben, Stadt",5418,2654,2764,0.48984865263935,5418,2668,2750,0.492432631967516,0.0189120464968442,0.343595332152749,0.637492621350406
16,"Thüringen",16065062,"Rottleben",638,332,306,0.520376175548589,630,327,303,0.519047619047619,0.0189120464968442,0.343595332152749,0.637492621350406
16,"Thüringen",16065066,"Seega",415,208,207,0.501204819277108,411,200,211,0.48661800486618,0.0189120464968442,0.343595332152749,0.637492621350406
16,"Thüringen",16065067,"Sondershausen, Stadt",22395,10947,11448,0.48881446751507,22860,11187,11673,0.489370078740157,0.0189120464968442,0.343595332152749,0.637492621350406
16,"Thüringen",16065068,"Steinthaleben",473,235,238,0.496828752642706,481,239,242,0.496881496881497,0.0189120464968442,0.343595332152749,0.637492621350406
16,"Thüringen",16065072,"Thüringenhausen",121,66,55,0.545454545454545,103,56,47,0.543689320388349,0.0189120464968442,0.343595332152749,0.637492621350406
16,"Thüringen",16065074,"Topfstedt",603,304,299,0.504145936981758,614,314,300,0.511400651465798,0.0189120464968442,0.343595332152749,0.637492621350406
16,"Thüringen",16065075,"Trebra",309,167,142,0.540453074433657,297,166,131,0.558922558922559,0.0189120464968442,0.343595332152749,0.637492621350406
16,"Thüringen",16065076,"Voigtstedt",926,480,446,0.518358531317495,948,490,458,0.516877637130802,0.0189120464968442,0.343595332152749,0.637492621350406
16,"Thüringen",16065077,"Wasserthaleben",429,205,224,0.477855477855478,410,193,217,0.470731707317073,0.0189120464968442,0.343595332152749,0.637492621350406
16,"Thüringen",16065079,"Westgreußen",385,197,188,0.511688311688312,395,201,194,0.508860759493671,0.0189120464968442,0.343595332152749,0.637492621350406
16,"Thüringen",16065081,"Wiehe, Stadt",1982,971,1011,0.489909182643794,2023,1002,1021,0.495304003954523,0.0189120464968442,0.343595332152749,0.637492621350406
16,"Thüringen",16065082,"Wolferschwenda",146,67,79,0.458904109589041,145,66,79,0.455172413793103,0.0189120464968442,0.343595332152749,0.637492621350406
16,"Thüringen",16065084,"Großenehrich, Stadt",2549,1294,1255,0.507650058846607,2575,1298,1277,0.504077669902913,0.0189120464968442,0.343595332152749,0.637492621350406
16,"Thüringen",16066001,"Altersbach",516,255,261,0.494186046511628,523,260,263,0.497131931166348,0.0189120464968442,0.343595332152749,0.637492621350406
16,"Thüringen",16066002,"Aschenhausen",172,90,82,0.523255813953488,170,87,83,0.511764705882353,0.0189120464968442,0.343595332152749,0.637492621350406
16,"Thüringen",16066003,"Bauerbach",273,135,138,0.494505494505495,256,129,127,0.50390625,0.0189120464968442,0.343595332152749,0.637492621350406
16,"Thüringen",16066005,"Belrieth",366,191,175,0.521857923497268,364,187,177,0.513736263736264,0.0189120464968442,0.343595332152749,0.637492621350406
16,"Thüringen",16066006,"Benshausen",2461,1287,1174,0.522958147094677,2496,1313,1183,0.526041666666667,0.0189120464968442,0.343595332152749,0.637492621350406
16,"Thüringen",16066008,"Bermbach",555,289,266,0.520720720720721,541,280,261,0.517560073937153,0.0189120464968442,0.343595332152749,0.637492621350406
16,"Thüringen",16066012,"Birx",176,89,87,0.505681818181818,170,85,85,0.5,0.0189120464968442,0.343595332152749,0.637492621350406
16,"Thüringen",16066013,"Breitungen/Werra",4886,2451,2435,0.501637331150225,4864,2456,2408,0.504934210526316,0.0189120464968442,0.343595332152749,0.637492621350406
16,"Thüringen",16066015,"Christes",620,293,327,0.47258064516129,628,294,334,0.468152866242038,0.0189120464968442,0.343595332152749,0.637492621350406
16,"Thüringen",16066016,"Dillstädt",826,417,409,0.504842615012107,835,422,413,0.505389221556886,0.0189120464968442,0.343595332152749,0.637492621350406
16,"Thüringen",16066017,"Einhausen",450,232,218,0.515555555555556,433,218,215,0.503464203233256,0.0189120464968442,0.343595332152749,0.637492621350406
16,"Thüringen",16066018,"Ellingshausen",251,124,127,0.49402390438247,254,125,129,0.492125984251969,0.0189120464968442,0.343595332152749,0.637492621350406
16,"Thüringen",16066019,"Erbenhausen",561,291,270,0.518716577540107,560,294,266,0.525,0.0189120464968442,0.343595332152749,0.637492621350406
16,"Thüringen",16066022,"Fambach",2192,1106,1086,0.50456204379562,2219,1113,1106,0.501577287066246,0.0189120464968442,0.343595332152749,0.637492621350406
16,"Thüringen",16066023,"Floh-Seligenthal",6264,3106,3158,0.495849297573435,6247,3118,3129,0.499119577397151,0.0189120464968442,0.343595332152749,0.637492621350406
16,"Thüringen",16066024,"Frankenheim/Rhön",1170,600,570,0.512820512820513,1180,607,573,0.514406779661017,0.0189120464968442,0.343595332152749,0.637492621350406
16,"Thüringen",16066025,"Friedelshausen",309,173,136,0.559870550161812,309,170,139,0.550161812297735,0.0189120464968442,0.343595332152749,0.637492621350406
16,"Thüringen",16066028,"Henneberg",625,318,307,0.5088,624,316,308,0.506410256410256,0.0189120464968442,0.343595332152749,0.637492621350406
16,"Thüringen",16066033,"Hümpfershausen",431,207,224,0.480278422273782,428,208,220,0.485981308411215,0.0189120464968442,0.343595332152749,0.637492621350406
16,"Thüringen",16066035,"Kaltensundheim",803,414,389,0.515566625155666,787,406,381,0.515883100381194,0.0189120464968442,0.343595332152749,0.637492621350406
16,"Thüringen",16066036,"Kaltenwestheim",962,500,462,0.51975051975052,968,493,475,0.509297520661157,0.0189120464968442,0.343595332152749,0.637492621350406
16,"Thüringen",16066038,"Kühndorf",998,508,490,0.509018036072144,1029,513,516,0.498542274052478,0.0189120464968442,0.343595332152749,0.637492621350406
16,"Thüringen",16066039,"Leutersdorf",263,127,136,0.482889733840304,266,127,139,0.477443609022556,0.0189120464968442,0.343595332152749,0.637492621350406
16,"Thüringen",16066041,"Mehmels",348,175,173,0.502873563218391,354,181,173,0.511299435028249,0.0189120464968442,0.343595332152749,0.637492621350406
16,"Thüringen",16066042,"Meiningen, Stadt",20770,10051,10719,0.483919114106885,21423,10378,11045,0.484432619147645,0.0189120464968442,0.343595332152749,0.637492621350406
16,"Thüringen",16066043,"Melpers",95,52,43,0.547368421052632,87,50,37,0.574712643678161,0.0189120464968442,0.343595332152749,0.637492621350406
16,"Thüringen",16066044,"Metzels",684,348,336,0.508771929824561,691,353,338,0.510853835021708,0.0189120464968442,0.343595332152749,0.637492621350406
16,"Thüringen",16066045,"Neubrunn",558,284,274,0.508960573476703,559,282,277,0.504472271914132,0.0189120464968442,0.343595332152749,0.637492621350406
16,"Thüringen",16066047,"Oberhof, Stadt",1576,764,812,0.484771573604061,1527,753,774,0.493123772102161,0.0189120464968442,0.343595332152749,0.637492621350406
16,"Thüringen",16066048,"Oberkatz",278,142,136,0.510791366906475,281,144,137,0.512455516014235,0.0189120464968442,0.343595332152749,0.637492621350406
16,"Thüringen",16066049,"Obermaßfeld-Grimmenthal",1223,622,601,0.508585445625511,1235,631,604,0.510931174089069,0.0189120464968442,0.343595332152749,0.637492621350406
16,"Thüringen",16066051,"Oberschönau, Kurort",825,408,417,0.494545454545455,839,419,420,0.499404052443385,0.0189120464968442,0.343595332152749,0.637492621350406
16,"Thüringen",16066052,"Oberweid",537,266,271,0.495344506517691,528,264,264,0.5,0.0189120464968442,0.343595332152749,0.637492621350406
16,"Thüringen",16066053,"Oepfershausen",486,242,244,0.497942386831276,484,240,244,0.495867768595041,0.0189120464968442,0.343595332152749,0.637492621350406
16,"Thüringen",16066056,"Rippershausen",877,435,442,0.496009122006841,869,430,439,0.49482163406214,0.0189120464968442,0.343595332152749,0.637492621350406
16,"Thüringen",16066057,"Ritschenhausen",354,182,172,0.514124293785311,351,180,171,0.512820512820513,0.0189120464968442,0.343595332152749,0.637492621350406
16,"Thüringen",16066058,"Rohr",972,492,480,0.506172839506173,977,495,482,0.506653019447288,0.0189120464968442,0.343595332152749,0.637492621350406
16,"Thüringen",16066059,"Rosa",753,366,387,0.48605577689243,759,378,381,0.49802371541502,0.0189120464968442,0.343595332152749,0.637492621350406
16,"Thüringen",16066061,"Roßdorf",683,363,320,0.531478770131772,676,363,313,0.53698224852071,0.0189120464968442,0.343595332152749,0.637492621350406
16,"Thüringen",16066062,"Rotterode",757,376,381,0.49669749009247,790,403,387,0.510126582278481,0.0189120464968442,0.343595332152749,0.637492621350406
16,"Thüringen",16066063,"Schmalkalden, Kurort, Stadt",19476,9823,9653,0.504364345861573,19798,9922,9876,0.501161733508435,0.0189120464968442,0.343595332152749,0.637492621350406
16,"Thüringen",16066064,"Schwallungen",2507,1258,1249,0.501794974072597,2515,1244,1271,0.494632206759443,0.0189120464968442,0.343595332152749,0.637492621350406
16,"Thüringen",16066065,"Schwarza",1267,626,641,0.494080505130229,1261,626,635,0.496431403647899,0.0189120464968442,0.343595332152749,0.637492621350406
16,"Thüringen",16066067,"Springstille",610,316,294,0.518032786885246,577,307,270,0.532062391681109,0.0189120464968442,0.343595332152749,0.637492621350406
16,"Thüringen",16066069,"Steinbach-Hallenberg, Kurort, Stadt",5191,2513,2678,0.484107108456945,5295,2558,2737,0.483097261567517,0.0189120464968442,0.343595332152749,0.637492621350406
16,"Thüringen",16066071,"Stepfershausen",651,331,320,0.508448540706605,638,332,306,0.520376175548589,0.0189120464968442,0.343595332152749,0.637492621350406
16,"Thüringen",16066073,"Sülzfeld",875,425,450,0.485714285714286,877,423,454,0.482326111744584,0.0189120464968442,0.343595332152749,0.637492621350406
16,"Thüringen",16066074,"Brotterode-Trusetal, Stadt",6512,3203,3309,0.491861179361179,6563,3226,3337,0.491543501447509,0.0189120464968442,0.343595332152749,0.637492621350406
16,"Thüringen",16066075,"Unterkatz",390,205,185,0.525641025641026,411,216,195,0.525547445255474,0.0189120464968442,0.343595332152749,0.637492621350406
16,"Thüringen",16066076,"Untermaßfeld",1291,738,553,0.571649883810999,1293,729,564,0.563805104408353,0.0189120464968442,0.343595332152749,0.637492621350406
16,"Thüringen",16066077,"Unterschönau",546,264,282,0.483516483516484,544,255,289,0.46875,0.0189120464968442,0.343595332152749,0.637492621350406
16,"Thüringen",16066078,"Unterweid",458,233,225,0.508733624454148,455,235,220,0.516483516483517,0.0189120464968442,0.343595332152749,0.637492621350406
16,"Thüringen",16066079,"Utendorf",475,242,233,0.509473684210526,468,238,230,0.508547008547009,0.0189120464968442,0.343595332152749,0.637492621350406
16,"Thüringen",16066081,"Vachdorf",816,391,425,0.479166666666667,821,396,425,0.482338611449452,0.0189120464968442,0.343595332152749,0.637492621350406
16,"Thüringen",16066082,"Viernau",2022,987,1035,0.48813056379822,2025,1000,1025,0.493827160493827,0.0189120464968442,0.343595332152749,0.637492621350406
16,"Thüringen",16066083,"Wahns",426,213,213,0.5,437,223,214,0.510297482837529,0.0189120464968442,0.343595332152749,0.637492621350406
16,"Thüringen",16066084,"Wallbach",358,185,173,0.516759776536313,347,177,170,0.510086455331412,0.0189120464968442,0.343595332152749,0.637492621350406
16,"Thüringen",16066085,"Walldorf",2212,1060,1152,0.479204339963834,2192,1060,1132,0.483576642335766,0.0189120464968442,0.343595332152749,0.637492621350406
16,"Thüringen",16066086,"Wasungen, Stadt",3511,1754,1757,0.499572771290231,3530,1758,1772,0.498016997167139,0.0189120464968442,0.343595332152749,0.637492621350406
16,"Thüringen",16066088,"Wölfershausen",366,179,187,0.489071038251366,376,186,190,0.49468085106383,0.0189120464968442,0.343595332152749,0.637492621350406
16,"Thüringen",16066092,"Zella-Mehlis, Stadt",11075,5467,5608,0.493634311512415,11612,5731,5881,0.49354116431278,0.0189120464968442,0.343595332152749,0.637492621350406
16,"Thüringen",16066093,"Rhönblick",2853,1442,1411,0.505432877672625,2876,1440,1436,0.500695410292072,0.0189120464968442,0.343595332152749,0.637492621350406
16,"Thüringen",16066094,"Grabfeld",5248,2646,2602,0.504192073170732,5308,2678,2630,0.504521477015825,0.0189120464968442,0.343595332152749,0.637492621350406
16,"Thüringen",16067003,"Ballstädt",696,344,352,0.494252873563218,686,338,348,0.492711370262391,0.0189120464968442,0.343595332152749,0.637492621350406
16,"Thüringen",16067004,"Bienstädt",684,363,321,0.530701754385965,711,389,322,0.547116736990155,0.0189120464968442,0.343595332152749,0.637492621350406
16,"Thüringen",16067005,"Brüheim",518,260,258,0.501930501930502,526,265,261,0.503802281368821,0.0189120464968442,0.343595332152749,0.637492621350406
16,"Thüringen",16067006,"Bufleben",1038,512,526,0.493256262042389,1026,507,519,0.494152046783626,0.0189120464968442,0.343595332152749,0.637492621350406
16,"Thüringen",16067008,"Crawinkel",1492,755,737,0.506032171581769,1513,769,744,0.508261731658956,0.0189120464968442,0.343595332152749,0.637492621350406
16,"Thüringen",16067009,"Dachwig",1583,792,791,0.500315855969678,1580,803,777,0.508227848101266,0.0189120464968442,0.343595332152749,0.637492621350406
16,"Thüringen",16067011,"Döllstädt",1138,542,596,0.476274165202109,1136,545,591,0.479753521126761,0.0189120464968442,0.343595332152749,0.637492621350406
16,"Thüringen",16067013,"Emleben",767,385,382,0.501955671447197,758,364,394,0.480211081794195,0.0189120464968442,0.343595332152749,0.637492621350406
16,"Thüringen",16067016,"Eschenbergen",743,383,360,0.515477792732167,751,384,367,0.511318242343542,0.0189120464968442,0.343595332152749,0.637492621350406
16,"Thüringen",16067019,"Friedrichroda, Stadt",7360,3536,3824,0.480434782608696,7451,3576,3875,0.479935579116897,0.0189120464968442,0.343595332152749,0.637492621350406
16,"Thüringen",16067021,"Friedrichswerth",494,254,240,0.51417004048583,522,279,243,0.53448275862069,0.0189120464968442,0.343595332152749,0.637492621350406
16,"Thüringen",16067022,"Friemar",1087,569,518,0.523459061637535,1098,574,524,0.522768670309654,0.0189120464968442,0.343595332152749,0.637492621350406
16,"Thüringen",16067025,"Georgenthal/Thür. Wald",2631,1303,1328,0.495248954770049,2548,1274,1274,0.5,0.0189120464968442,0.343595332152749,0.637492621350406
16,"Thüringen",16067026,"Gierstädt",849,423,426,0.498233215547703,845,421,424,0.498224852071006,0.0189120464968442,0.343595332152749,0.637492621350406
16,"Thüringen",16067027,"Goldbach",1687,831,856,0.492590397154713,1664,824,840,0.495192307692308,0.0189120464968442,0.343595332152749,0.637492621350406
16,"Thüringen",16067029,"Gotha, Stadt",44264,21404,22860,0.483553226097958,45564,22275,23289,0.488872794311298,0.0189120464968442,0.343595332152749,0.637492621350406
16,"Thüringen",16067032,"Gräfenhain",1347,677,670,0.502598366740906,1343,684,659,0.509307520476545,0.0189120464968442,0.343595332152749,0.637492621350406
16,"Thüringen",16067033,"Großfahner",833,421,412,0.505402160864346,834,412,422,0.49400479616307,0.0189120464968442,0.343595332152749,0.637492621350406
16,"Thüringen",16067035,"Haina",504,251,253,0.498015873015873,493,246,247,0.498985801217039,0.0189120464968442,0.343595332152749,0.637492621350406
16,"Thüringen",16067036,"Herrenhof",795,399,396,0.50188679245283,777,390,387,0.501930501930502,0.0189120464968442,0.343595332152749,0.637492621350406
16,"Thüringen",16067037,"Hochheim",476,253,223,0.531512605042017,455,233,222,0.512087912087912,0.0189120464968442,0.343595332152749,0.637492621350406
16,"Thüringen",16067039,"Hohenkirchen",734,368,366,0.501362397820163,722,360,362,0.498614958448753,0.0189120464968442,0.343595332152749,0.637492621350406
16,"Thüringen",16067044,"Luisenthal",1272,636,636,0.5,1305,654,651,0.501149425287356,0.0189120464968442,0.343595332152749,0.637492621350406
16,"Thüringen",16067047,"Molschleben",1088,555,533,0.510110294117647,1105,561,544,0.507692307692308,0.0189120464968442,0.343595332152749,0.637492621350406
16,"Thüringen",16067052,"Nottleben",436,216,220,0.495412844036697,431,214,217,0.496519721577726,0.0189120464968442,0.343595332152749,0.637492621350406
16,"Thüringen",16067053,"Ohrdruf, Stadt",5569,2739,2830,0.491829771951876,5708,2798,2910,0.490189208128942,0.0189120464968442,0.343595332152749,0.637492621350406
16,"Thüringen",16067054,"Petriroda",342,163,179,0.476608187134503,339,163,176,0.480825958702065,0.0189120464968442,0.343595332152749,0.637492621350406
16,"Thüringen",16067055,"Pferdingsleben",408,201,207,0.492647058823529,401,198,203,0.493765586034913,0.0189120464968442,0.343595332152749,0.637492621350406
16,"Thüringen",16067056,"Remstädt",949,482,467,0.507903055848261,947,489,458,0.51636747624076,0.0189120464968442,0.343595332152749,0.637492621350406
16,"Thüringen",16067059,"Schwabhausen",723,362,361,0.500691562932227,716,360,356,0.502793296089385,0.0189120464968442,0.343595332152749,0.637492621350406
16,"Thüringen",16067063,"Sonneborn",1254,621,633,0.495215311004785,1230,600,630,0.48780487804878,0.0189120464968442,0.343595332152749,0.637492621350406
16,"Thüringen",16067064,"Tabarz/Thür. Wald",4034,1973,2061,0.489092711948438,4023,1970,2053,0.489684315187671,0.0189120464968442,0.343595332152749,0.637492621350406
16,"Thüringen",16067065,"Tambach-Dietharz/Thür. Wald, Stadt",4148,2067,2081,0.49831243972999,4193,2095,2098,0.499642260911042,0.0189120464968442,0.343595332152749,0.637492621350406
16,"Thüringen",16067067,"Tonna",2982,1704,1278,0.571428571428571,2798,1535,1263,0.548606147248034,0.0189120464968442,0.343595332152749,0.637492621350406
16,"Thüringen",16067068,"Tröchtelborn",305,148,157,0.485245901639344,297,148,149,0.498316498316498,0.0189120464968442,0.343595332152749,0.637492621350406
16,"Thüringen",16067071,"Tüttleben",765,359,406,0.469281045751634,757,366,391,0.483487450462351,0.0189120464968442,0.343595332152749,0.637492621350406
16,"Thüringen",16067072,"Waltershausen, Stadt",10396,5075,5321,0.488168526356291,10618,5204,5414,0.490111132039932,0.0189120464968442,0.343595332152749,0.637492621350406
16,"Thüringen",16067074,"Wangenheim",708,358,350,0.505649717514124,683,340,343,0.497803806734993,0.0189120464968442,0.343595332152749,0.637492621350406
16,"Thüringen",16067075,"Warza",721,345,376,0.478502080443828,712,342,370,0.480337078651685,0.0189120464968442,0.343595332152749,0.637492621350406
16,"Thüringen",16067078,"Westhausen",549,283,266,0.515482695810565,552,286,266,0.518115942028985,0.0189120464968442,0.343595332152749,0.637492621350406
16,"Thüringen",16067081,"Wölfis",1473,739,734,0.501697216564834,1492,743,749,0.49798927613941,0.0189120464968442,0.343595332152749,0.637492621350406
16,"Thüringen",16067082,"Zimmernsupra",364,184,180,0.505494505494505,367,184,183,0.501362397820163,0.0189120464968442,0.343595332152749,0.637492621350406
16,"Thüringen",16067083,"Leinatal",3747,1902,1845,0.507606084867894,3680,1856,1824,0.504347826086956,0.0189120464968442,0.343595332152749,0.637492621350406
16,"Thüringen",16067084,"Emsetal",2829,1419,1410,0.501590668080594,2833,1420,1413,0.501235439463466,0.0189120464968442,0.343595332152749,0.637492621350406
16,"Thüringen",16067085,"Günthersleben-Wechmar",3038,1511,1527,0.497366688610928,2996,1477,1519,0.492990654205608,0.0189120464968442,0.343595332152749,0.637492621350406
16,"Thüringen",16067086,"Drei Gleichen",5163,2605,2558,0.504551617276777,5186,2601,2585,0.501542614731971,0.0189120464968442,0.343595332152749,0.637492621350406
16,"Thüringen",16067087,"Nesse-Apfelstädt",6043,3008,3035,0.497766010259805,6101,3059,3042,0.501393214227176,0.0189120464968442,0.343595332152749,0.637492621350406
16,"Thüringen",16067088,"Hörsel",4960,2501,2459,0.504233870967742,4867,2456,2411,0.504622971029382,0.0189120464968442,0.343595332152749,0.637492621350406
16,"Thüringen",16068001,"Alperstedt",697,325,372,0.466284074605452,702,330,372,0.47008547008547,0.0189120464968442,0.343595332152749,0.637492621350406
16,"Thüringen",16068002,"Andisleben",584,302,282,0.517123287671233,610,327,283,0.536065573770492,0.0189120464968442,0.343595332152749,0.637492621350406
16,"Thüringen",16068003,"Beichlingen",514,258,256,0.501945525291829,543,270,273,0.497237569060773,0.0189120464968442,0.343595332152749,0.637492621350406
16,"Thüringen",16068004,"Bilzingsleben",729,376,353,0.515775034293553,735,380,355,0.517006802721088,0.0189120464968442,0.343595332152749,0.637492621350406
16,"Thüringen",16068005,"Büchel",240,116,124,0.483333333333333,248,120,128,0.483870967741935,0.0189120464968442,0.343595332152749,0.637492621350406
16,"Thüringen",16068006,"Buttstädt, Stadt",2479,1201,1278,0.484469544171037,2501,1213,1288,0.48500599760096,0.0189120464968442,0.343595332152749,0.637492621350406
16,"Thüringen",16068007,"Eckstedt",609,296,313,0.486042692939245,594,286,308,0.481481481481481,0.0189120464968442,0.343595332152749,0.637492621350406
16,"Thüringen",16068008,"Ellersleben",276,141,135,0.510869565217391,284,146,138,0.514084507042254,0.0189120464968442,0.343595332152749,0.637492621350406
16,"Thüringen",16068009,"Elxleben",2251,1094,1157,0.486006219458019,2278,1111,1167,0.487708516242318,0.0189120464968442,0.343595332152749,0.637492621350406
16,"Thüringen",16068011,"Eßleben-Teutleben",316,151,165,0.477848101265823,339,158,181,0.466076696165192,0.0189120464968442,0.343595332152749,0.637492621350406
16,"Thüringen",16068012,"Frömmstedt",542,269,273,0.496309963099631,545,272,273,0.499082568807339,0.0189120464968442,0.343595332152749,0.637492621350406
16,"Thüringen",16068013,"Gangloffsömmern",1012,513,499,0.506916996047431,1008,509,499,0.504960317460317,0.0189120464968442,0.343595332152749,0.637492621350406
16,"Thüringen",16068014,"Gebesee, Stadt",2154,1091,1063,0.506499535747447,2149,1087,1062,0.505816658911121,0.0189120464968442,0.343595332152749,0.637492621350406
16,"Thüringen",16068015,"Griefstedt",290,145,145,0.5,288,143,145,0.496527777777778,0.0189120464968442,0.343595332152749,0.637492621350406
16,"Thüringen",16068016,"Großbrembach",724,368,356,0.50828729281768,738,380,358,0.514905149051491,0.0189120464968442,0.343595332152749,0.637492621350406
16,"Thüringen",16068017,"Großmölsen",223,113,110,0.506726457399103,232,115,117,0.495689655172414,0.0189120464968442,0.343595332152749,0.637492621350406
16,"Thüringen",16068018,"Großmonra",902,458,444,0.507760532150776,930,477,453,0.512903225806452,0.0189120464968442,0.343595332152749,0.637492621350406
16,"Thüringen",16068019,"Großneuhausen",687,353,334,0.513828238719068,696,348,348,0.5,0.0189120464968442,0.343595332152749,0.637492621350406
16,"Thüringen",16068021,"Großrudestedt",1907,981,926,0.51442055584688,1916,981,935,0.512004175365344,0.0189120464968442,0.343595332152749,0.637492621350406
16,"Thüringen",16068022,"Günstedt",771,385,386,0.49935149156939,773,384,389,0.496765847347995,0.0189120464968442,0.343595332152749,0.637492621350406
16,"Thüringen",16068023,"Guthmannshausen",784,399,385,0.508928571428571,816,420,396,0.514705882352941,0.0189120464968442,0.343595332152749,0.637492621350406
16,"Thüringen",16068024,"Hardisleben",575,297,278,0.516521739130435,585,298,287,0.509401709401709,0.0189120464968442,0.343595332152749,0.637492621350406
16,"Thüringen",16068025,"Haßleben",997,495,502,0.496489468405216,1005,495,510,0.492537313432836,0.0189120464968442,0.343595332152749,0.637492621350406
16,"Thüringen",16068026,"Henschleben",365,187,178,0.512328767123288,349,180,169,0.515759312320917,0.0189120464968442,0.343595332152749,0.637492621350406
16,"Thüringen",16068027,"Herrnschwende",295,139,156,0.471186440677966,304,141,163,0.463815789473684,0.0189120464968442,0.343595332152749,0.637492621350406
16,"Thüringen",16068028,"Kannawurf",825,433,392,0.524848484848485,838,438,400,0.522673031026253,0.0189120464968442,0.343595332152749,0.637492621350406
16,"Thüringen",16068029,"Kindelbrück, Stadt",1766,880,886,0.498301245753114,1751,869,882,0.496287835522559,0.0189120464968442,0.343595332152749,0.637492621350406
16,"Thüringen",16068031,"Kleinbrembach",323,169,154,0.523219814241486,317,169,148,0.533123028391167,0.0189120464968442,0.343595332152749,0.637492621350406
16,"Thüringen",16068032,"Kleinmölsen",343,182,161,0.530612244897959,340,179,161,0.526470588235294,0.0189120464968442,0.343595332152749,0.637492621350406
16,"Thüringen",16068033,"Kleinneuhausen",402,214,188,0.532338308457711,414,222,192,0.536231884057971,0.0189120464968442,0.343595332152749,0.637492621350406
16,"Thüringen",16068034,"Kölleda, Stadt",5294,2593,2701,0.489799773328296,5459,2677,2782,0.490382854002565,0.0189120464968442,0.343595332152749,0.637492621350406
16,"Thüringen",16068035,"Mannstedt",367,192,175,0.523160762942779,383,203,180,0.530026109660574,0.0189120464968442,0.343595332152749,0.637492621350406
16,"Thüringen",16068036,"Markvippach",551,280,271,0.508166969147005,539,272,267,0.504638218923933,0.0189120464968442,0.343595332152749,0.637492621350406
16,"Thüringen",16068037,"Nöda",828,422,406,0.509661835748792,827,416,411,0.503022974607013,0.0189120464968442,0.343595332152749,0.637492621350406
16,"Thüringen",16068038,"Olbersleben",755,384,371,0.508609271523179,755,383,372,0.50728476821192,0.0189120464968442,0.343595332152749,0.637492621350406
16,"Thüringen",16068039,"Ollendorf",447,229,218,0.512304250559284,428,215,213,0.502336448598131,0.0189120464968442,0.343595332152749,0.637492621350406
16,"Thüringen",16068041,"Ostramondra",533,258,275,0.484052532833021,563,276,287,0.490230905861456,0.0189120464968442,0.343595332152749,0.637492621350406
16,"Thüringen",16068042,"Rastenberg, Stadt",2710,1369,1341,0.505166051660517,2665,1342,1323,0.503564727954972,0.0189120464968442,0.343595332152749,0.637492621350406
16,"Thüringen",16068043,"Riethgen",248,125,123,0.504032258064516,239,118,121,0.493723849372385,0.0189120464968442,0.343595332152749,0.637492621350406
16,"Thüringen",16068044,"Riethnordhausen",1000,499,501,0.499,1005,505,500,0.502487562189055,0.0189120464968442,0.343595332152749,0.637492621350406
16,"Thüringen",16068045,"Ringleben",499,255,244,0.511022044088176,507,263,244,0.518737672583826,0.0189120464968442,0.343595332152749,0.637492621350406
16,"Thüringen",16068046,"Rudersdorf",342,171,171,0.5,328,159,169,0.484756097560976,0.0189120464968442,0.343595332152749,0.637492621350406
16,"Thüringen",16068047,"Schillingstedt",230,119,111,0.517391304347826,231,122,109,0.528138528138528,0.0189120464968442,0.343595332152749,0.637492621350406
16,"Thüringen",16068048,"Schloßvippach",1410,708,702,0.502127659574468,1377,683,694,0.4960058097313,0.0189120464968442,0.343595332152749,0.637492621350406
16,"Thüringen",16068049,"Schwerstedt",613,312,301,0.508972267536705,624,322,302,0.516025641025641,0.0189120464968442,0.343595332152749,0.637492621350406
16,"Thüringen",16068051,"Sömmerda, Stadt",19374,9468,9906,0.488696190771137,19817,9713,10104,0.490134732805167,0.0189120464968442,0.343595332152749,0.637492621350406
16,"Thüringen",16068052,"Sprötau",788,422,366,0.535532994923858,822,440,382,0.535279805352798,0.0189120464968442,0.343595332152749,0.637492621350406
16,"Thüringen",16068053,"Straußfurt",1810,920,890,0.50828729281768,1769,907,862,0.51271905031091,0.0189120464968442,0.343595332152749,0.637492621350406
16,"Thüringen",16068055,"Udestedt",792,402,390,0.507575757575758,810,414,396,0.511111111111111,0.0189120464968442,0.343595332152749,0.637492621350406
16,"Thüringen",16068056,"Vogelsberg",698,352,346,0.504297994269341,688,347,341,0.504360465116279,0.0189120464968442,0.343595332152749,0.637492621350406
16,"Thüringen",16068057,"Walschleben",1781,871,910,0.489051094890511,1790,884,906,0.493854748603352,0.0189120464968442,0.343595332152749,0.637492621350406
16,"Thüringen",16068058,"Weißensee, Stadt",3429,1720,1709,0.501603966170895,3427,1714,1713,0.50014590020426,0.0189120464968442,0.343595332152749,0.637492621350406
16,"Thüringen",16068059,"Werningshausen",688,340,348,0.494186046511628,689,338,351,0.490566037735849,0.0189120464968442,0.343595332152749,0.637492621350406
16,"Thüringen",16068061,"Witterda",1099,572,527,0.520473157415833,1095,563,532,0.514155251141552,0.0189120464968442,0.343595332152749,0.637492621350406
16,"Thüringen",16068062,"Wundersleben",676,335,341,0.495562130177515,680,334,346,0.491176470588235,0.0189120464968442,0.343595332152749,0.637492621350406
16,"Thüringen",16069001,"Ahlstädt",138,73,65,0.528985507246377,134,71,63,0.529850746268657,0.0189120464968442,0.343595332152749,0.637492621350406
16,"Thüringen",16069002,"Bad Colberg-Heldburg, Stadt",2088,1057,1031,0.506226053639847,2076,1056,1020,0.508670520231214,0.0189120464968442,0.343595332152749,0.637492621350406
16,"Thüringen",16069003,"Beinerstadt",341,161,180,0.472140762463343,356,168,188,0.471910112359551,0.0189120464968442,0.343595332152749,0.637492621350406
16,"Thüringen",16069004,"Bischofrod",184,92,92,0.5,186,89,97,0.478494623655914,0.0189120464968442,0.343595332152749,0.637492621350406
16,"Thüringen",16069005,"Bockstadt",293,158,135,0.539249146757679,287,154,133,0.536585365853659,0.0189120464968442,0.343595332152749,0.637492621350406
16,"Thüringen",16069006,"Brünn/Thür.",445,226,219,0.507865168539326,451,230,221,0.509977827050998,0.0189120464968442,0.343595332152749,0.637492621350406
16,"Thüringen",16069008,"Dingsleben",257,129,128,0.501945525291829,261,133,128,0.509578544061303,0.0189120464968442,0.343595332152749,0.637492621350406
16,"Thüringen",16069009,"Ehrenberg",186,93,93,0.5,180,89,91,0.494444444444444,0.0189120464968442,0.343595332152749,0.637492621350406
16,"Thüringen",16069011,"Eichenberg",184,92,92,0.5,177,89,88,0.502824858757062,0.0189120464968442,0.343595332152749,0.637492621350406
16,"Thüringen",16069012,"Eisfeld, Stadt",5432,2728,2704,0.50220913107511,5453,2728,2725,0.500275077938749,0.0189120464968442,0.343595332152749,0.637492621350406
16,"Thüringen",16069014,"Gleichamberg",2788,1381,1407,0.495337159253946,2822,1396,1426,0.494684620836286,0.0189120464968442,0.343595332152749,0.637492621350406
16,"Thüringen",16069015,"Gompertshausen",456,234,222,0.513157894736842,499,262,237,0.525050100200401,0.0189120464968442,0.343595332152749,0.637492621350406
16,"Thüringen",16069016,"Grimmelshausen",183,85,98,0.46448087431694,182,83,99,0.456043956043956,0.0189120464968442,0.343595332152749,0.637492621350406
16,"Thüringen",16069017,"Grub",167,83,84,0.497005988023952,161,79,82,0.490683229813665,0.0189120464968442,0.343595332152749,0.637492621350406
16,"Thüringen",16069018,"Haina",998,486,512,0.486973947895792,991,479,512,0.48335015136226,0.0189120464968442,0.343595332152749,0.637492621350406
16,"Thüringen",16069019,"Hellingen",1034,537,497,0.519342359767892,1034,534,500,0.516441005802708,0.0189120464968442,0.343595332152749,0.637492621350406
16,"Thüringen",16069021,"Henfstädt",384,198,186,0.515625,351,168,183,0.478632478632479,0.0189120464968442,0.343595332152749,0.637492621350406
16,"Thüringen",16069024,"Hildburghausen, Stadt",11704,5793,5911,0.494958988380041,11784,5842,5942,0.495756958587916,0.0189120464968442,0.343595332152749,0.637492621350406
16,"Thüringen",16069025,"Kloster Veßra",323,174,149,0.538699690402477,333,175,158,0.525525525525526,0.0189120464968442,0.343595332152749,0.637492621350406
16,"Thüringen",16069026,"Lengfeld",454,224,230,0.493392070484582,444,219,225,0.493243243243243,0.0189120464968442,0.343595332152749,0.637492621350406
16,"Thüringen",16069028,"Marisfeld",452,233,219,0.515486725663717,435,230,205,0.528735632183908,0.0189120464968442,0.343595332152749,0.637492621350406
16,"Thüringen",16069031,"Mendhausen",280,143,137,0.510714285714286,310,152,158,0.490322580645161,0.0189120464968442,0.343595332152749,0.637492621350406
16,"Thüringen",16069032,"Milz",887,431,456,0.485907553551297,922,433,489,0.469631236442516,0.0189120464968442,0.343595332152749,0.637492621350406
16,"Thüringen",16069035,"Oberstadt",367,186,181,0.506811989100817,370,185,185,0.5,0.0189120464968442,0.343595332152749,0.637492621350406
16,"Thüringen",16069037,"Reurieth",869,443,426,0.509781357882624,885,451,434,0.509604519774011,0.0189120464968442,0.343595332152749,0.637492621350406
16,"Thüringen",16069038,"Römhild, Stadt",1816,891,925,0.490638766519824,1846,914,932,0.495124593716143,0.0189120464968442,0.343595332152749,0.637492621350406
16,"Thüringen",16069039,"Sachsenbrunn",2168,1092,1076,0.503690036900369,2124,1077,1047,0.507062146892655,0.0189120464968442,0.343595332152749,0.637492621350406
16,"Thüringen",16069041,"Schlechtsart",165,81,84,0.490909090909091,168,83,85,0.494047619047619,0.0189120464968442,0.343595332152749,0.637492621350406
16,"Thüringen",16069042,"Schleusegrund",2959,1459,1500,0.493071983778303,3000,1471,1529,0.490333333333333,0.0189120464968442,0.343595332152749,0.637492621350406
16,"Thüringen",16069043,"Schleusingen, Stadt",5415,2668,2747,0.492705447830102,5359,2632,2727,0.491136406045904,0.0189120464968442,0.343595332152749,0.637492621350406
16,"Thüringen",16069044,"Schmeheim",313,159,154,0.507987220447284,320,163,157,0.509375,0.0189120464968442,0.343595332152749,0.637492621350406
16,"Thüringen",16069046,"Schweickershausen",158,71,87,0.449367088607595,153,66,87,0.431372549019608,0.0189120464968442,0.343595332152749,0.637492621350406
16,"Thüringen",16069047,"St.Bernhard",277,137,140,0.494584837545126,281,138,143,0.491103202846975,0.0189120464968442,0.343595332152749,0.637492621350406
16,"Thüringen",16069048,"St.Kilian",2881,1418,1463,0.492190211732037,2947,1440,1507,0.488632507634883,0.0189120464968442,0.343595332152749,0.637492621350406
16,"Thüringen",16069049,"Straufhain",2795,1414,1381,0.505903398926655,2785,1421,1364,0.510233393177738,0.0189120464968442,0.343595332152749,0.637492621350406
16,"Thüringen",16069051,"Themar, Stadt",2950,1448,1502,0.490847457627119,2953,1442,1511,0.488316965797494,0.0189120464968442,0.343595332152749,0.637492621350406
16,"Thüringen",16069052,"Ummerstadt, Stadt",492,258,234,0.524390243902439,499,258,241,0.517034068136273,0.0189120464968442,0.343595332152749,0.637492621350406
16,"Thüringen",16069053,"Veilsdorf",2936,1472,1464,0.501362397820163,2952,1474,1478,0.499322493224932,0.0189120464968442,0.343595332152749,0.637492621350406
16,"Thüringen",16069055,"Westenfeld",390,206,184,0.528205128205128,380,205,175,0.539473684210526,0.0189120464968442,0.343595332152749,0.637492621350406
16,"Thüringen",16069056,"Westhausen",722,386,336,0.534626038781163,601,303,298,0.504159733777038,0.0189120464968442,0.343595332152749,0.637492621350406
16,"Thüringen",16069058,"Auengrund",3052,1563,1489,0.512123197903014,3133,1597,1536,0.509735078199808,0.0189120464968442,0.343595332152749,0.637492621350406
16,"Thüringen",16069059,"Nahetal-Waldau",3092,1515,1577,0.489974126778784,3146,1543,1603,0.490464081373172,0.0189120464968442,0.343595332152749,0.637492621350406
16,"Thüringen",16069061,"Masserberg",2532,1283,1249,0.506714060031596,2576,1314,1262,0.510093167701863,0.0189120464968442,0.343595332152749,0.637492621350406
16,"Thüringen",16070001,"Alkersleben",323,163,160,0.504643962848297,323,164,159,0.507739938080495,0.0189120464968442,0.343595332152749,0.637492621350406
16,"Thüringen",16070002,"Altenfeld",1126,637,489,0.565719360568384,1119,622,497,0.555853440571939,0.0189120464968442,0.343595332152749,0.637492621350406
16,"Thüringen",16070003,"Angelroda",397,204,193,0.513853904282116,397,207,190,0.521410579345088,0.0189120464968442,0.343595332152749,0.637492621350406
16,"Thüringen",16070004,"Arnstadt, Stadt",23758,11318,12440,0.476386901254314,24922,12005,12917,0.481702913088837,0.0189120464968442,0.343595332152749,0.637492621350406
16,"Thüringen",16070005,"Böhlen",584,282,302,0.482876712328767,591,285,306,0.482233502538071,0.0189120464968442,0.343595332152749,0.637492621350406
16,"Thüringen",16070006,"Bösleben-Wüllersleben",604,294,310,0.486754966887417,621,306,315,0.492753623188406,0.0189120464968442,0.343595332152749,0.637492621350406
16,"Thüringen",16070008,"Dornheim",557,282,275,0.506283662477558,557,280,277,0.502692998204668,0.0189120464968442,0.343595332152749,0.637492621350406
16,"Thüringen",16070011,"Elgersburg",1236,600,636,0.485436893203884,1252,610,642,0.487220447284345,0.0189120464968442,0.343595332152749,0.637492621350406
16,"Thüringen",16070012,"Elleben",898,440,458,0.489977728285078,892,439,453,0.492152466367713,0.0189120464968442,0.343595332152749,0.637492621350406
16,"Thüringen",16070013,"Elxleben",580,287,293,0.494827586206897,572,288,284,0.503496503496504,0.0189120464968442,0.343595332152749,0.637492621350406
16,"Thüringen",16070014,"Frankenhain",770,379,391,0.492207792207792,769,373,396,0.485045513654096,0.0189120464968442,0.343595332152749,0.637492621350406
16,"Thüringen",16070015,"Frauenwald",998,496,502,0.496993987975952,1000,496,504,0.496,0.0189120464968442,0.343595332152749,0.637492621350406
16,"Thüringen",16070016,"Friedersdorf",208,106,102,0.509615384615385,210,107,103,0.509523809523809,0.0189120464968442,0.343595332152749,0.637492621350406
16,"Thüringen",16070017,"Gehlberg",556,268,288,0.482014388489209,645,321,324,0.497674418604651,0.0189120464968442,0.343595332152749,0.637492621350406
16,"Thüringen",16070018,"Gehren, Stadt",3309,1634,1675,0.493804774856452,3442,1707,1735,0.495932597327135,0.0189120464968442,0.343595332152749,0.637492621350406
16,"Thüringen",16070019,"Geraberg",2415,1231,1184,0.509730848861284,2420,1226,1194,0.506611570247934,0.0189120464968442,0.343595332152749,0.637492621350406
16,"Thüringen",16070021,"Geschwenda",2059,1015,1044,0.492957746478873,2078,1021,1057,0.491337824831569,0.0189120464968442,0.343595332152749,0.637492621350406
16,"Thüringen",16070022,"Gillersdorf",276,137,139,0.496376811594203,281,142,139,0.505338078291815,0.0189120464968442,0.343595332152749,0.637492621350406
16,"Thüringen",16070023,"Gossel",497,254,243,0.511066398390342,497,257,240,0.517102615694165,0.0189120464968442,0.343595332152749,0.637492621350406
16,"Thüringen",16070024,"Gräfenroda",3279,1583,1696,0.482769136931991,3304,1589,1715,0.480932203389831,0.0189120464968442,0.343595332152749,0.637492621350406
16,"Thüringen",16070025,"Großbreitenbach, Stadt",2647,1332,1315,0.503211182470722,2662,1335,1327,0.501502629601803,0.0189120464968442,0.343595332152749,0.637492621350406
16,"Thüringen",16070027,"Herschdorf",899,450,449,0.50055617352614,931,459,472,0.493018259935553,0.0189120464968442,0.343595332152749,0.637492621350406
16,"Thüringen",16070028,"Ichtershausen",3880,1984,1896,0.511340206185567,3890,1966,1924,0.505398457583548,0.0189120464968442,0.343595332152749,0.637492621350406
16,"Thüringen",16070029,"Ilmenau, Stadt",26122,13524,12598,0.517724523390246,26005,13256,12749,0.509748125360508,0.0189120464968442,0.343595332152749,0.637492621350406
16,"Thüringen",16070031,"Kirchheim",1189,616,573,0.518082422203532,1195,623,572,0.521338912133891,0.0189120464968442,0.343595332152749,0.637492621350406
16,"Thüringen",16070032,"Langewiesen, Stadt",3499,1761,1738,0.503286653329523,3483,1759,1724,0.50502440424921,0.0189120464968442,0.343595332152749,0.637492621350406
16,"Thüringen",16070033,"Liebenstein",368,185,183,0.502717391304348,370,184,186,0.497297297297297,0.0189120464968442,0.343595332152749,0.637492621350406
16,"Thüringen",16070034,"Martinroda",862,418,444,0.48491879350348,866,418,448,0.482678983833718,0.0189120464968442,0.343595332152749,0.637492621350406
16,"Thüringen",16070035,"Möhrenbach",677,347,330,0.512555391432792,682,349,333,0.511730205278592,0.0189120464968442,0.343595332152749,0.637492621350406
16,"Thüringen",16070037,"Neusiß",228,116,112,0.508771929824561,228,117,111,0.513157894736842,0.0189120464968442,0.343595332152749,0.637492621350406
16,"Thüringen",16070038,"Neustadt am Rennsteig",1000,509,491,0.509,1024,522,502,0.509765625,0.0189120464968442,0.343595332152749,0.637492621350406
16,"Thüringen",16070041,"Osthausen-Wülfershausen",533,270,263,0.50656660412758,537,269,268,0.500931098696462,0.0189120464968442,0.343595332152749,0.637492621350406
16,"Thüringen",16070042,"Pennewitz",513,258,255,0.502923976608187,529,266,263,0.502835538752363,0.0189120464968442,0.343595332152749,0.637492621350406
16,"Thüringen",16070043,"Plaue, Stadt",1813,890,923,0.490899062327634,1806,897,909,0.496677740863787,0.0189120464968442,0.343595332152749,0.637492621350406
16,"Thüringen",16070044,"Rockhausen",277,131,146,0.472924187725632,280,134,146,0.478571428571429,0.0189120464968442,0.343595332152749,0.637492621350406
16,"Thüringen",16070046,"Schmiedefeld am Rennsteig",1779,893,886,0.501967397414278,1787,885,902,0.495243424734191,0.0189120464968442,0.343595332152749,0.637492621350406
16,"Thüringen",16070048,"Stadtilm, Stadt",4892,2357,2535,0.481807031888798,4938,2395,2543,0.485014175779668,0.0189120464968442,0.343595332152749,0.637492621350406
16,"Thüringen",16070049,"Stützerbach",1474,716,758,0.485753052917232,1467,697,770,0.475119291070211,0.0189120464968442,0.343595332152749,0.637492621350406
16,"Thüringen",16070051,"Wachsenburggemeinde",2505,1272,1233,0.507784431137725,2531,1272,1259,0.502568154879494,0.0189120464968442,0.343595332152749,0.637492621350406
16,"Thüringen",16070052,"Wildenspring",198,101,97,0.51010101010101,201,105,96,0.522388059701492,0.0189120464968442,0.343595332152749,0.637492621350406
16,"Thüringen",16070053,"Wipfratal",2757,1391,1366,0.504533913674284,2828,1439,1389,0.508840169731259,0.0189120464968442,0.343595332152749,0.637492621350406
16,"Thüringen",16070054,"Witzleben",672,329,343,0.489583333333333,686,336,350,0.489795918367347,0.0189120464968442,0.343595332152749,0.637492621350406
16,"Thüringen",16070055,"Wolfsberg",3040,1553,1487,0.510855263157895,3074,1561,1513,0.507807417046194,0.0189120464968442,0.343595332152749,0.637492621350406
16,"Thüringen",16070056,"Ilmtal",3881,1964,1917,0.506055140427725,3867,1944,1923,0.502715283165244,0.0189120464968442,0.343595332152749,0.637492621350406
16,"Thüringen",16071001,"Apolda, Stadt",22010,10572,11438,0.48032712403453,22925,11065,11860,0.482660850599782,0.0189120464968442,0.343595332152749,0.637492621350406
16,"Thüringen",16071002,"Auerstedt",455,224,231,0.492307692307692,457,231,226,0.5054704595186,0.0189120464968442,0.343595332152749,0.637492621350406
16,"Thüringen",16071003,"Bad Berka, Stadt",7631,3735,3896,0.48945092386319,7640,3742,3898,0.48979057591623,0.0189120464968442,0.343595332152749,0.637492621350406
16,"Thüringen",16071004,"Bad Sulza, Stadt",2848,1374,1474,0.482443820224719,2926,1422,1504,0.485987696514012,0.0189120464968442,0.343595332152749,0.637492621350406
16,"Thüringen",16071005,"Ballstedt",312,154,158,0.493589743589744,310,150,160,0.483870967741935,0.0189120464968442,0.343595332152749,0.637492621350406
16,"Thüringen",16071006,"Bechstedtstraß",265,137,128,0.516981132075472,255,131,124,0.513725490196078,0.0189120464968442,0.343595332152749,0.637492621350406
16,"Thüringen",16071007,"Berlstedt",1759,881,878,0.500852757248437,1843,925,918,0.501899077590884,0.0189120464968442,0.343595332152749,0.637492621350406
16,"Thüringen",16071008,"Blankenhain, Stadt",6466,3172,3294,0.490566037735849,6616,3275,3341,0.495012091898428,0.0189120464968442,0.343595332152749,0.637492621350406
16,"Thüringen",16071009,"Buchfart",184,95,89,0.516304347826087,185,97,88,0.524324324324324,0.0189120464968442,0.343595332152749,0.637492621350406
16,"Thüringen",16071011,"Buttelstedt, Stadt",1358,686,672,0.505154639175258,1361,705,656,0.518001469507715,0.0189120464968442,0.343595332152749,0.637492621350406
16,"Thüringen",16071012,"Daasdorf a. Berge",254,127,127,0.5,245,119,126,0.485714285714286,0.0189120464968442,0.343595332152749,0.637492621350406
16,"Thüringen",16071013,"Döbritschen",213,114,99,0.535211267605634,219,117,102,0.534246575342466,0.0189120464968442,0.343595332152749,0.637492621350406
16,"Thüringen",16071015,"Eberstedt",213,111,102,0.52112676056338,214,110,104,0.514018691588785,0.0189120464968442,0.343595332152749,0.637492621350406
16,"Thüringen",16071017,"Ettersburg",570,265,305,0.464912280701754,583,277,306,0.475128644939966,0.0189120464968442,0.343595332152749,0.637492621350406
16,"Thüringen",16071018,"Flurstedt",245,121,124,0.493877551020408,254,128,126,0.503937007874016,0.0189120464968442,0.343595332152749,0.637492621350406
16,"Thüringen",16071019,"Frankendorf",172,86,86,0.5,174,87,87,0.5,0.0189120464968442,0.343595332152749,0.637492621350406
16,"Thüringen",16071021,"Gebstedt",290,140,150,0.482758620689655,287,138,149,0.480836236933798,0.0189120464968442,0.343595332152749,0.637492621350406
16,"Thüringen",16071022,"Großheringen",680,330,350,0.485294117647059,693,341,352,0.492063492063492,0.0189120464968442,0.343595332152749,0.637492621350406
16,"Thüringen",16071023,"Großobringen",864,437,427,0.505787037037037,853,433,420,0.507620164126612,0.0189120464968442,0.343595332152749,0.637492621350406
16,"Thüringen",16071025,"Großschwabhausen",1037,534,503,0.514946962391514,1068,539,529,0.504681647940075,0.0189120464968442,0.343595332152749,0.637492621350406
16,"Thüringen",16071027,"Hammerstedt",164,92,72,0.560975609756098,167,95,72,0.568862275449102,0.0189120464968442,0.343595332152749,0.637492621350406
16,"Thüringen",16071028,"Heichelheim",299,151,148,0.505016722408027,316,164,152,0.518987341772152,0.0189120464968442,0.343595332152749,0.637492621350406
16,"Thüringen",16071031,"Hetschburg",235,117,118,0.497872340425532,236,119,117,0.504237288135593,0.0189120464968442,0.343595332152749,0.637492621350406
16,"Thüringen",16071032,"Hohenfelden",367,183,184,0.498637602179836,374,180,194,0.481283422459893,0.0189120464968442,0.343595332152749,0.637492621350406
16,"Thüringen",16071034,"Hopfgarten",700,361,339,0.515714285714286,637,322,315,0.505494505494505,0.0189120464968442,0.343595332152749,0.637492621350406
16,"Thüringen",16071036,"Isseroda",569,299,270,0.525483304042179,552,291,261,0.527173913043478,0.0189120464968442,0.343595332152749,0.637492621350406
16,"Thüringen",16071037,"Kapellendorf",419,211,208,0.503579952267303,433,212,221,0.489607390300231,0.0189120464968442,0.343595332152749,0.637492621350406
16,"Thüringen",16071038,"Kiliansroda",215,105,110,0.488372093023256,222,110,112,0.495495495495495,0.0189120464968442,0.343595332152749,0.637492621350406
16,"Thüringen",16071039,"Kleinobringen",294,141,153,0.479591836734694,289,145,144,0.501730103806228,0.0189120464968442,0.343595332152749,0.637492621350406
16,"Thüringen",16071042,"Kleinschwabhausen",236,116,120,0.491525423728814,239,119,120,0.497907949790795,0.0189120464968442,0.343595332152749,0.637492621350406
16,"Thüringen",16071043,"Klettbach",1303,642,661,0.49270913277053,1296,638,658,0.492283950617284,0.0189120464968442,0.343595332152749,0.637492621350406
16,"Thüringen",16071044,"Ködderitzsch",117,56,61,0.478632478632479,121,61,60,0.504132231404959,0.0189120464968442,0.343595332152749,0.637492621350406
16,"Thüringen",16071046,"Kranichfeld, Stadt",3472,1717,1755,0.494527649769585,3519,1770,1749,0.502983802216539,0.0189120464968442,0.343595332152749,0.637492621350406
16,"Thüringen",16071047,"Krautheim",485,250,235,0.515463917525773,481,253,228,0.525987525987526,0.0189120464968442,0.343595332152749,0.637492621350406
16,"Thüringen",16071048,"Kromsdorf",1505,745,760,0.495016611295681,1539,773,766,0.50227420402859,0.0189120464968442,0.343595332152749,0.637492621350406
16,"Thüringen",16071049,"Lehnstedt",353,170,183,0.481586402266289,346,168,178,0.485549132947977,0.0189120464968442,0.343595332152749,0.637492621350406
16,"Thüringen",16071051,"Leutenthal",262,133,129,0.50763358778626,262,131,131,0.5,0.0189120464968442,0.343595332152749,0.637492621350406
16,"Thüringen",16071052,"Liebstedt",425,213,212,0.501176470588235,423,214,209,0.505910165484634,0.0189120464968442,0.343595332152749,0.637492621350406
16,"Thüringen",16071053,"Magdala, Stadt",1945,962,983,0.494601542416452,1977,992,985,0.501770359129995,0.0189120464968442,0.343595332152749,0.637492621350406
16,"Thüringen",16071054,"Mattstedt",499,249,250,0.498997995991984,505,251,254,0.497029702970297,0.0189120464968442,0.343595332152749,0.637492621350406
16,"Thüringen",16071055,"Mechelroda",271,144,127,0.531365313653137,277,149,128,0.537906137184116,0.0189120464968442,0.343595332152749,0.637492621350406
16,"Thüringen",16071056,"Mellingen",1257,614,643,0.488464598249801,1258,609,649,0.484101748807631,0.0189120464968442,0.343595332152749,0.637492621350406
16,"Thüringen",16071057,"Mönchenholzhausen",1553,786,767,0.506117192530586,1579,787,792,0.498416719442685,0.0189120464968442,0.343595332152749,0.637492621350406
16,"Thüringen",16071059,"Nauendorf",293,151,142,0.515358361774744,282,141,141,0.5,0.0189120464968442,0.343595332152749,0.637492621350406
16,"Thüringen",16071061,"Neumark, Stadt",479,236,243,0.492693110647182,469,228,241,0.486140724946695,0.0189120464968442,0.343595332152749,0.637492621350406
16,"Thüringen",16071062,"Niederreißen",220,102,118,0.463636363636364,219,103,116,0.470319634703196,0.0189120464968442,0.343595332152749,0.637492621350406
16,"Thüringen",16071063,"Niederroßla",1104,546,558,0.494565217391304,1115,553,562,0.495964125560538,0.0189120464968442,0.343595332152749,0.637492621350406
16,"Thüringen",16071064,"Niedertrebra",793,390,403,0.491803278688525,817,403,414,0.493268053855569,0.0189120464968442,0.343595332152749,0.637492621350406
16,"Thüringen",16071065,"Niederzimmern",1017,516,501,0.507374631268437,1037,521,516,0.502410800385728,0.0189120464968442,0.343595332152749,0.637492621350406
16,"Thüringen",16071066,"Nirmsdorf",88,41,47,0.465909090909091,88,39,49,0.443181818181818,0.0189120464968442,0.343595332152749,0.637492621350406
16,"Thüringen",16071067,"Nohra",1698,871,827,0.512956419316843,1927,1021,906,0.529839128178516,0.0189120464968442,0.343595332152749,0.637492621350406
16,"Thüringen",16071068,"Oberreißen",174,88,86,0.505747126436782,173,88,85,0.508670520231214,0.0189120464968442,0.343595332152749,0.637492621350406
16,"Thüringen",16071069,"Obertrebra",287,147,140,0.51219512195122,287,145,142,0.505226480836237,0.0189120464968442,0.343595332152749,0.637492621350406
16,"Thüringen",16071071,"Oettern",133,66,67,0.496240601503759,141,73,68,0.517730496453901,0.0189120464968442,0.343595332152749,0.637492621350406
16,"Thüringen",16071072,"Oßmannstedt",1260,623,637,0.494444444444444,1286,635,651,0.493779160186625,0.0189120464968442,0.343595332152749,0.637492621350406
16,"Thüringen",16071073,"Ottstedt a. Berge",254,127,127,0.5,264,135,129,0.511363636363636,0.0189120464968442,0.343595332152749,0.637492621350406
16,"Thüringen",16071074,"Pfiffelbach",573,287,286,0.50087260034904,579,289,290,0.499136442141624,0.0189120464968442,0.343595332152749,0.637492621350406
16,"Thüringen",16071076,"Ramsla",321,159,162,0.495327102803738,320,160,160,0.5,0.0189120464968442,0.343595332152749,0.637492621350406
16,"Thüringen",16071077,"Rannstedt",182,88,94,0.483516483516484,181,86,95,0.475138121546961,0.0189120464968442,0.343595332152749,0.637492621350406
16,"Thüringen",16071078,"Reisdorf",320,164,156,0.5125,311,159,152,0.511254019292605,0.0189120464968442,0.343595332152749,0.637492621350406
16,"Thüringen",16071079,"Rittersdorf",254,123,131,0.484251968503937,260,130,130,0.5,0.0189120464968442,0.343595332152749,0.637492621350406
16,"Thüringen",16071081,"Rohrbach",199,104,95,0.522613065326633,197,103,94,0.522842639593909,0.0189120464968442,0.343595332152749,0.637492621350406
16,"Thüringen",16071082,"Sachsenhausen",381,194,187,0.509186351706037,360,181,179,0.502777777777778,0.0189120464968442,0.343595332152749,0.637492621350406
16,"Thüringen",16071083,"Schmiedehausen",409,210,199,0.513447432762836,411,209,202,0.508515815085158,0.0189120464968442,0.343595332152749,0.637492621350406
16,"Thüringen",16071085,"Schwerstedt",343,170,173,0.495626822157434,342,178,164,0.52046783625731,0.0189120464968442,0.343595332152749,0.637492621350406
16,"Thüringen",16071087,"Tonndorf",662,353,309,0.533232628398791,657,352,305,0.535768645357686,0.0189120464968442,0.343595332152749,0.637492621350406
16,"Thüringen",16071088,"Troistedt",199,103,96,0.517587939698492,202,107,95,0.52970297029703,0.0189120464968442,0.343595332152749,0.637492621350406
16,"Thüringen",16071089,"Umpferstedt",605,310,295,0.512396694214876,617,321,296,0.520259319286872,0.0189120464968442,0.343595332152749,0.637492621350406
16,"Thüringen",16071092,"Vippachedelhausen",570,281,289,0.492982456140351,589,296,293,0.502546689303905,0.0189120464968442,0.343595332152749,0.637492621350406
16,"Thüringen",16071093,"Vollersroda",200,107,93,0.535,203,110,93,0.541871921182266,0.0189120464968442,0.343595332152749,0.637492621350406
16,"Thüringen",16071094,"Wickerstedt",747,376,371,0.50334672021419,765,380,385,0.496732026143791,0.0189120464968442,0.343595332152749,0.637492621350406
16,"Thüringen",16071095,"Wiegendorf",338,177,161,0.523668639053254,349,185,164,0.530085959885387,0.0189120464968442,0.343595332152749,0.637492621350406
16,"Thüringen",16071096,"Willerstedt",289,151,138,0.522491349480969,283,152,131,0.537102473498233,0.0189120464968442,0.343595332152749,0.637492621350406
16,"Thüringen",16071097,"Wohlsborn",479,239,240,0.498956158663883,511,260,251,0.50880626223092,0.0189120464968442,0.343595332152749,0.637492621350406
16,"Thüringen",16071099,"Saaleplatte",2816,1455,1361,0.516690340909091,2881,1499,1382,0.520305449496703,0.0189120464968442,0.343595332152749,0.637492621350406
16,"Thüringen",16072001,"Bachfeld",491,235,256,0.478615071283096,485,234,251,0.482474226804124,0.0189120464968442,0.343595332152749,0.637492621350406
16,"Thüringen",16072002,"Effelder-Rauenstein",3540,1761,1779,0.497457627118644,3647,1821,1826,0.499314505072662,0.0189120464968442,0.343595332152749,0.637492621350406
16,"Thüringen",16072005,"Föritz",3523,1747,1776,0.495884189611127,3550,1772,1778,0.499154929577465,0.0189120464968442,0.343595332152749,0.637492621350406
16,"Thüringen",16072006,"Goldisthal",466,257,209,0.551502145922747,474,269,205,0.567510548523207,0.0189120464968442,0.343595332152749,0.637492621350406
16,"Thüringen",16072009,"Judenbach",2453,1223,1230,0.498573175703221,2518,1250,1268,0.496425734710087,0.0189120464968442,0.343595332152749,0.637492621350406
16,"Thüringen",16072011,"Lauscha, Stadt",3576,1743,1833,0.48741610738255,3654,1808,1846,0.49480021893815,0.0189120464968442,0.343595332152749,0.637492621350406
16,"Thüringen",16072012,"Mengersgereuth-Hämmern",2715,1333,1382,0.49097605893186,2695,1334,1361,0.494990723562152,0.0189120464968442,0.343595332152749,0.637492621350406
16,"Thüringen",16072013,"Neuhaus am Rennweg, Stadt",6368,3101,3267,0.48696608040201,6485,3146,3339,0.485119506553585,0.0189120464968442,0.343595332152749,0.637492621350406
16,"Thüringen",16072014,"Neuhaus-Schierschnitz",3136,1564,1572,0.498724489795918,3121,1550,1571,0.496635693687921,0.0189120464968442,0.343595332152749,0.637492621350406
16,"Thüringen",16072015,"Schalkau, Stadt",3073,1525,1548,0.49625772860397,3089,1511,1578,0.489155066364519,0.0189120464968442,0.343595332152749,0.637492621350406
16,"Thüringen",16072016,"Scheibe-Alsbach",585,282,303,0.482051282051282,567,270,297,0.476190476190476,0.0189120464968442,0.343595332152749,0.637492621350406
16,"Thüringen",16072017,"Siegmundsburg",231,119,112,0.515151515151515,227,115,112,0.506607929515419,0.0189120464968442,0.343595332152749,0.637492621350406
16,"Thüringen",16072018,"Sonneberg, Stadt",21916,10506,11410,0.479375798503377,22222,10788,11434,0.485464854648546,0.0189120464968442,0.343595332152749,0.637492621350406
16,"Thüringen",16072019,"Steinach, Stadt",4158,2044,2114,0.491582491582492,4207,2078,2129,0.493938673639173,0.0189120464968442,0.343595332152749,0.637492621350406
16,"Thüringen",16072022,"Oberland am Rennsteig",2234,1131,1103,0.50626678603402,2308,1169,1139,0.506499133448873,0.0189120464968442,0.343595332152749,0.637492621350406
16,"Thüringen",16073001,"Allendorf",350,180,170,0.514285714285714,358,188,170,0.525139664804469,0.0189120464968442,0.343595332152749,0.637492621350406
16,"Thüringen",16073002,"Altenbeuthen",222,113,109,0.509009009009009,220,114,106,0.518181818181818,0.0189120464968442,0.343595332152749,0.637492621350406
16,"Thüringen",16073005,"Bad Blankenburg, Stadt",6873,3305,3568,0.480867161356031,6933,3373,3560,0.486513774700707,0.0189120464968442,0.343595332152749,0.637492621350406
16,"Thüringen",16073006,"Bechstedt",162,78,84,0.481481481481481,163,80,83,0.49079754601227,0.0189120464968442,0.343595332152749,0.637492621350406
16,"Thüringen",16073013,"Cursdorf",642,308,334,0.479750778816199,663,326,337,0.491704374057315,0.0189120464968442,0.343595332152749,0.637492621350406
16,"Thüringen",16073014,"Deesbach",368,198,170,0.53804347826087,395,216,179,0.546835443037975,0.0189120464968442,0.343595332152749,0.637492621350406
16,"Thüringen",16073017,"Döschnitz",261,135,126,0.517241379310345,270,139,131,0.514814814814815,0.0189120464968442,0.343595332152749,0.637492621350406
16,"Thüringen",16073021,"Dröbischau",477,244,233,0.511530398322851,493,251,242,0.509127789046653,0.0189120464968442,0.343595332152749,0.637492621350406
16,"Thüringen",16073028,"Gräfenthal, Stadt",2208,1087,1121,0.492300724637681,2440,1234,1206,0.505737704918033,0.0189120464968442,0.343595332152749,0.637492621350406
16,"Thüringen",16073035,"Hohenwarte",171,86,85,0.502923976608187,153,75,78,0.490196078431373,0.0189120464968442,0.343595332152749,0.637492621350406
16,"Thüringen",16073036,"Kamsdorf",2710,1319,1391,0.486715867158672,2796,1388,1408,0.496423462088698,0.0189120464968442,0.343595332152749,0.637492621350406
16,"Thüringen",16073037,"Katzhütte",1511,756,755,0.500330906684315,1630,824,806,0.505521472392638,0.0189120464968442,0.343595332152749,0.637492621350406
16,"Thüringen",16073038,"Kaulsdorf",2661,1337,1324,0.502442690717775,2730,1385,1345,0.507326007326007,0.0189120464968442,0.343595332152749,0.637492621350406
16,"Thüringen",16073042,"Königsee, Stadt",4963,2407,2556,0.484988917993149,5036,2447,2589,0.485901509134234,0.0189120464968442,0.343595332152749,0.637492621350406
16,"Thüringen",16073046,"Lehesten, Stadt",1814,904,910,0.498346196251378,1885,940,945,0.49867374005305,0.0189120464968442,0.343595332152749,0.637492621350406
16,"Thüringen",16073049,"Lichte",1575,794,781,0.504126984126984,1549,786,763,0.507424144609425,0.0189120464968442,0.343595332152749,0.637492621350406
16,"Thüringen",16073054,"Mellenbach-Glasbach",1026,514,512,0.500974658869396,1005,512,493,0.509452736318408,0.0189120464968442,0.343595332152749,0.637492621350406
16,"Thüringen",16073055,"Meura",460,226,234,0.491304347826087,457,222,235,0.485776805251641,0.0189120464968442,0.343595332152749,0.637492621350406
16,"Thüringen",16073056,"Meuselbach-Schwarzmühle",1180,547,633,0.463559322033898,1221,573,648,0.469287469287469,0.0189120464968442,0.343595332152749,0.637492621350406
16,"Thüringen",16073063,"Oberhain",720,367,353,0.509722222222222,725,369,356,0.508965517241379,0.0189120464968442,0.343595332152749,0.637492621350406
16,"Thüringen",16073065,"Oberweißbach/Thür. Wald, Stadt",1840,885,955,0.480978260869565,1887,922,965,0.488606253312136,0.0189120464968442,0.343595332152749,0.637492621350406
16,"Thüringen",16073066,"Piesau",780,396,384,0.507692307692308,771,388,383,0.503242542153048,0.0189120464968442,0.343595332152749,0.637492621350406
16,"Thüringen",16073067,"Probstzella",3245,1611,1634,0.496456086286595,3293,1634,1659,0.496204069237777,0.0189120464968442,0.343595332152749,0.637492621350406
16,"Thüringen",16073068,"Reichmannsdorf",798,394,404,0.493734335839599,777,385,392,0.495495495495495,0.0189120464968442,0.343595332152749,0.637492621350406
16,"Thüringen",16073074,"Rohrbach",197,97,100,0.49238578680203,190,92,98,0.484210526315789,0.0189120464968442,0.343595332152749,0.637492621350406
16,"Thüringen",16073075,"Rottenbach",1877,983,894,0.523708044752264,1848,959,889,0.518939393939394,0.0189120464968442,0.343595332152749,0.637492621350406
16,"Thüringen",16073076,"Rudolstadt, Stadt",22998,11108,11890,0.482998521610575,23630,11458,12172,0.484892086330935,0.0189120464968442,0.343595332152749,0.637492621350406
16,"Thüringen",16073077,"Saalfeld/Saale, Stadt",25440,12207,13233,0.479834905660377,26837,12990,13847,0.484033237694228,0.0189120464968442,0.343595332152749,0.637492621350406
16,"Thüringen",16073079,"Schmiedefeld",1034,497,537,0.480657640232108,1013,490,523,0.483711747285291,0.0189120464968442,0.343595332152749,0.637492621350406
16,"Thüringen",16073082,"Schwarzburg",535,266,269,0.497196261682243,554,281,273,0.507220216606498,0.0189120464968442,0.343595332152749,0.637492621350406
16,"Thüringen",16073084,"Sitzendorf",878,437,441,0.497722095671982,891,439,452,0.492704826038159,0.0189120464968442,0.343595332152749,0.637492621350406
16,"Thüringen",16073094,"Unterweißbach",794,393,401,0.494962216624685,791,393,398,0.496839443742099,0.0189120464968442,0.343595332152749,0.637492621350406
16,"Thüringen",16073101,"Wittgendorf",178,92,86,0.51685393258427,177,87,90,0.491525423728814,0.0189120464968442,0.343595332152749,0.637492621350406
16,"Thüringen",16073105,"Remda-Teichel, Stadt",3005,1532,1473,0.50981697171381,2975,1514,1461,0.50890756302521,0.0189120464968442,0.343595332152749,0.637492621350406
16,"Thüringen",16073106,"Leutenberg, Stadt",2283,1117,1166,0.489268506351292,2348,1173,1175,0.499574105621806,0.0189120464968442,0.343595332152749,0.637492621350406
16,"Thüringen",16073107,"Drognitz",660,328,332,0.496969696969697,682,338,344,0.495601173020528,0.0189120464968442,0.343595332152749,0.637492621350406
16,"Thüringen",16073108,"Saalfelder Höhe",3253,1649,1604,0.506916692284045,3300,1679,1621,0.508787878787879,0.0189120464968442,0.343595332152749,0.637492621350406
16,"Thüringen",16073109,"Uhlstädt-Kirchhasel",6220,3169,3051,0.509485530546624,6300,3227,3073,0.512222222222222,0.0189120464968442,0.343595332152749,0.637492621350406
16,"Thüringen",16073111,"Unterwellenborn",6186,3103,3083,0.501616553507921,6336,3178,3158,0.501578282828283,0.0189120464968442,0.343595332152749,0.637492621350406
16,"Thüringen",16074001,"Albersdorf",277,149,128,0.537906137184116,259,139,120,0.536679536679537,0.0189120464968442,0.343595332152749,0.637492621350406
16,"Thüringen",16074002,"Altenberga",746,373,373,0.5,744,374,370,0.502688172043011,0.0189120464968442,0.343595332152749,0.637492621350406
16,"Thüringen",16074003,"Bad Klosterlausnitz",3558,1744,1814,0.490163012928612,3495,1697,1798,0.48555078683834,0.0189120464968442,0.343595332152749,0.637492621350406
16,"Thüringen",16074004,"Bibra",263,142,121,0.539923954372624,251,139,112,0.553784860557769,0.0189120464968442,0.343595332152749,0.637492621350406
16,"Thüringen",16074005,"Bobeck",299,157,142,0.525083612040134,294,154,140,0.523809523809524,0.0189120464968442,0.343595332152749,0.637492621350406
16,"Thüringen",16074006,"Bollberg",289,136,153,0.470588235294118,289,133,156,0.460207612456747,0.0189120464968442,0.343595332152749,0.637492621350406
16,"Thüringen",16074007,"Bremsnitz",140,64,76,0.457142857142857,137,63,74,0.45985401459854,0.0189120464968442,0.343595332152749,0.637492621350406
16,"Thüringen",16074008,"Bucha",1078,540,538,0.500927643784787,1099,549,550,0.499545040946315,0.0189120464968442,0.343595332152749,0.637492621350406
16,"Thüringen",16074009,"Bürgel, Stadt",3117,1568,1549,0.503047802374078,3131,1574,1557,0.502714787607793,0.0189120464968442,0.343595332152749,0.637492621350406
16,"Thüringen",16074011,"Dornburg-Camburg, Stadt",5553,2686,2867,0.48370250315145,5645,2752,2893,0.487511071744907,0.0189120464968442,0.343595332152749,0.637492621350406
16,"Thüringen",16074012,"Crossen an der Elster",1723,859,864,0.498549042367963,1703,860,843,0.504991192014093,0.0189120464968442,0.343595332152749,0.637492621350406
16,"Thüringen",16074016,"Eichenberg",416,219,197,0.526442307692308,432,233,199,0.539351851851852,0.0189120464968442,0.343595332152749,0.637492621350406
16,"Thüringen",16074017,"Eineborn",338,165,173,0.488165680473373,343,165,178,0.481049562682216,0.0189120464968442,0.343595332152749,0.637492621350406
16,"Thüringen",16074018,"Eisenberg, Stadt",10653,5095,5558,0.478269032197503,11103,5369,5734,0.483563000990723,0.0189120464968442,0.343595332152749,0.637492621350406
16,"Thüringen",16074019,"Frauenprießnitz",888,455,433,0.512387387387387,953,486,467,0.5099685204617,0.0189120464968442,0.343595332152749,0.637492621350406
16,"Thüringen",16074021,"Freienorla",330,155,175,0.46969696969697,329,153,176,0.465045592705167,0.0189120464968442,0.343595332152749,0.637492621350406
16,"Thüringen",16074022,"Geisenhain",188,89,99,0.473404255319149,192,94,98,0.489583333333333,0.0189120464968442,0.343595332152749,0.637492621350406
16,"Thüringen",16074024,"Gneus",161,75,86,0.46583850931677,161,73,88,0.453416149068323,0.0189120464968442,0.343595332152749,0.637492621350406
16,"Thüringen",16074025,"Gösen",216,107,109,0.49537037037037,222,105,117,0.472972972972973,0.0189120464968442,0.343595332152749,0.637492621350406
16,"Thüringen",16074026,"Golmsdorf",653,331,322,0.506891271056662,659,337,322,0.511380880121396,0.0189120464968442,0.343595332152749,0.637492621350406
16,"Thüringen",16074028,"Graitschen b. Bürgel",404,207,197,0.512376237623762,413,213,200,0.515738498789346,0.0189120464968442,0.343595332152749,0.637492621350406
16,"Thüringen",16074029,"Großbockedra",178,97,81,0.544943820224719,170,91,79,0.535294117647059,0.0189120464968442,0.343595332152749,0.637492621350406
16,"Thüringen",16074031,"Großeutersdorf",270,137,133,0.507407407407407,281,146,135,0.519572953736655,0.0189120464968442,0.343595332152749,0.637492621350406
16,"Thüringen",16074032,"Großlöbichau",782,395,387,0.505115089514066,780,394,386,0.505128205128205,0.0189120464968442,0.343595332152749,0.637492621350406
16,"Thüringen",16074033,"Großpürschütz",387,189,198,0.488372093023256,394,190,204,0.482233502538071,0.0189120464968442,0.343595332152749,0.637492621350406
16,"Thüringen",16074034,"Gumperda",398,203,195,0.510050251256281,370,191,179,0.516216216216216,0.0189120464968442,0.343595332152749,0.637492621350406
16,"Thüringen",16074036,"Hainichen",197,109,88,0.553299492385787,182,108,74,0.593406593406593,0.0189120464968442,0.343595332152749,0.637492621350406
16,"Thüringen",16074037,"Hainspitz",668,322,346,0.482035928143713,720,356,364,0.494444444444444,0.0189120464968442,0.343595332152749,0.637492621350406
16,"Thüringen",16074038,"Hartmannsdorf",678,337,341,0.497050147492625,713,357,356,0.50070126227209,0.0189120464968442,0.343595332152749,0.637492621350406
16,"Thüringen",16074039,"Heideland",1898,975,923,0.513698630136986,1932,980,952,0.507246376811594,0.0189120464968442,0.343595332152749,0.637492621350406
16,"Thüringen",16074041,"Hermsdorf, Stadt",7999,3864,4135,0.483060382547818,8272,4022,4250,0.486218568665377,0.0189120464968442,0.343595332152749,0.637492621350406
16,"Thüringen",16074042,"Hummelshain",621,284,337,0.457326892109501,595,278,317,0.467226890756303,0.0189120464968442,0.343595332152749,0.637492621350406
16,"Thüringen",16074043,"Jenalöbnitz",154,72,82,0.467532467532468,155,74,81,0.47741935483871,0.0189120464968442,0.343595332152749,0.637492621350406
16,"Thüringen",16074044,"Kahla, Stadt",7121,3464,3657,0.486448532509479,7337,3590,3747,0.489300804143383,0.0189120464968442,0.343595332152749,0.637492621350406
16,"Thüringen",16074045,"Karlsdorf",111,60,51,0.540540540540541,98,51,47,0.520408163265306,0.0189120464968442,0.343595332152749,0.637492621350406
16,"Thüringen",16074046,"Kleinbockedra",35,15,20,0.428571428571429,36,16,20,0.444444444444444,0.0189120464968442,0.343595332152749,0.637492621350406
16,"Thüringen",16074047,"Kleinebersdorf",183,93,90,0.508196721311475,181,88,93,0.486187845303867,0.0189120464968442,0.343595332152749,0.637492621350406
16,"Thüringen",16074048,"Kleineutersdorf",372,194,178,0.521505376344086,383,197,186,0.514360313315927,0.0189120464968442,0.343595332152749,0.637492621350406
16,"Thüringen",16074049,"Laasdorf",496,246,250,0.495967741935484,514,266,248,0.517509727626459,0.0189120464968442,0.343595332152749,0.637492621350406
16,"Thüringen",16074051,"Lehesten",716,375,341,0.523743016759777,716,368,348,0.513966480446927,0.0189120464968442,0.343595332152749,0.637492621350406
16,"Thüringen",16074052,"Lindig",237,129,108,0.544303797468354,245,131,114,0.53469387755102,0.0189120464968442,0.343595332152749,0.637492621350406
16,"Thüringen",16074053,"Lippersdorf-Erdmannsdorf",467,252,215,0.539614561027837,465,251,214,0.539784946236559,0.0189120464968442,0.343595332152749,0.637492621350406
16,"Thüringen",16074054,"Löberschütz",138,67,71,0.485507246376812,137,71,66,0.518248175182482,0.0189120464968442,0.343595332152749,0.637492621350406
16,"Thüringen",16074055,"Mertendorf",161,82,79,0.509316770186335,161,80,81,0.496894409937888,0.0189120464968442,0.343595332152749,0.637492621350406
16,"Thüringen",16074056,"Meusebach",100,52,48,0.52,98,49,49,0.5,0.0189120464968442,0.343595332152749,0.637492621350406
16,"Thüringen",16074057,"Milda",779,389,390,0.499358151476252,800,404,396,0.505,0.0189120464968442,0.343595332152749,0.637492621350406
16,"Thüringen",16074058,"Möckern",130,63,67,0.484615384615385,118,59,59,0.5,0.0189120464968442,0.343595332152749,0.637492621350406
16,"Thüringen",16074059,"Mörsdorf",439,229,210,0.521640091116173,443,225,218,0.507900677200903,0.0189120464968442,0.343595332152749,0.637492621350406
16,"Thüringen",16074061,"Nausnitz",68,32,36,0.470588235294118,72,36,36,0.5,0.0189120464968442,0.343595332152749,0.637492621350406
16,"Thüringen",16074063,"Neuengönna",647,336,311,0.519319938176198,684,366,318,0.535087719298246,0.0189120464968442,0.343595332152749,0.637492621350406
16,"Thüringen",16074064,"Oberbodnitz",246,130,116,0.528455284552846,256,133,123,0.51953125,0.0189120464968442,0.343595332152749,0.637492621350406
16,"Thüringen",16074065,"Orlamünde, Stadt",1165,578,587,0.496137339055794,1173,586,587,0.499573742540494,0.0189120464968442,0.343595332152749,0.637492621350406
16,"Thüringen",16074066,"Ottendorf",408,198,210,0.485294117647059,412,204,208,0.495145631067961,0.0189120464968442,0.343595332152749,0.637492621350406
16,"Thüringen",16074067,"Petersberg",275,134,141,0.487272727272727,281,137,144,0.487544483985765,0.0189120464968442,0.343595332152749,0.637492621350406
16,"Thüringen",16074068,"Poxdorf",105,54,51,0.514285714285714,107,56,51,0.523364485981308,0.0189120464968442,0.343595332152749,0.637492621350406
16,"Thüringen",16074069,"Quirla",504,252,252,0.5,511,252,259,0.493150684931507,0.0189120464968442,0.343595332152749,0.637492621350406
16,"Thüringen",16074071,"Rattelsdorf",87,40,47,0.459770114942529,87,43,44,0.494252873563218,0.0189120464968442,0.343595332152749,0.637492621350406
16,"Thüringen",16074072,"Rauda",298,156,142,0.523489932885906,292,157,135,0.537671232876712,0.0189120464968442,0.343595332152749,0.637492621350406
16,"Thüringen",16074073,"Rauschwitz",223,115,108,0.515695067264574,225,111,114,0.493333333333333,0.0189120464968442,0.343595332152749,0.637492621350406
16,"Thüringen",16074074,"Rausdorf",184,97,87,0.527173913043478,182,95,87,0.521978021978022,0.0189120464968442,0.343595332152749,0.637492621350406
16,"Thüringen",16074075,"Reichenbach",934,463,471,0.495717344753747,934,455,479,0.487152034261242,0.0189120464968442,0.343595332152749,0.637492621350406
16,"Thüringen",16074076,"Reinstädt",505,257,248,0.508910891089109,517,263,254,0.508704061895551,0.0189120464968442,0.343595332152749,0.637492621350406
16,"Thüringen",16074077,"Renthendorf",425,214,211,0.503529411764706,427,217,210,0.508196721311475,0.0189120464968442,0.343595332152749,0.637492621350406
16,"Thüringen",16074079,"Rothenstein",1207,608,599,0.503728251864126,1335,699,636,0.523595505617978,0.0189120464968442,0.343595332152749,0.637492621350406
16,"Thüringen",16074081,"Ruttersdorf-Lotschen",323,160,163,0.495356037151703,330,159,171,0.481818181818182,0.0189120464968442,0.343595332152749,0.637492621350406
16,"Thüringen",16074082,"Scheiditz",53,28,25,0.528301886792453,41,21,20,0.51219512195122,0.0189120464968442,0.343595332152749,0.637492621350406
16,"Thüringen",16074084,"Schleifreisen",430,214,216,0.497674418604651,429,217,212,0.505827505827506,0.0189120464968442,0.343595332152749,0.637492621350406
16,"Thüringen",16074085,"Schlöben",921,463,458,0.50271444082519,922,466,456,0.505422993492408,0.0189120464968442,0.343595332152749,0.637492621350406
16,"Thüringen",16074086,"Schöngleina",467,236,231,0.505353319057816,484,242,242,0.5,0.0189120464968442,0.343595332152749,0.637492621350406
16,"Thüringen",16074087,"Schöps",342,200,142,0.584795321637427,381,244,137,0.640419947506562,0.0189120464968442,0.343595332152749,0.637492621350406
16,"Thüringen",16074089,"Seitenroda",196,99,97,0.505102040816326,200,103,97,0.515,0.0189120464968442,0.343595332152749,0.637492621350406
16,"Thüringen",16074091,"Serba",676,351,325,0.519230769230769,689,354,335,0.513788098693759,0.0189120464968442,0.343595332152749,0.637492621350406
16,"Thüringen",16074092,"Silbitz",676,345,331,0.510355029585799,692,358,334,0.517341040462428,0.0189120464968442,0.343595332152749,0.637492621350406
16,"Thüringen",16074093,"St.Gangloff",1247,623,624,0.499599037690457,1291,648,643,0.501936483346243,0.0189120464968442,0.343595332152749,0.637492621350406
16,"Thüringen",16074094,"Stadtroda, Stadt",5961,2914,3047,0.488844153665492,6041,2963,3078,0.490481708326436,0.0189120464968442,0.343595332152749,0.637492621350406
16,"Thüringen",16074095,"Sulza",283,143,140,0.50530035335689,285,142,143,0.498245614035088,0.0189120464968442,0.343595332152749,0.637492621350406
16,"Thüringen",16074096,"Tautenburg",298,160,138,0.536912751677852,310,160,150,0.516129032258065,0.0189120464968442,0.343595332152749,0.637492621350406
16,"Thüringen",16074097,"Tautendorf",170,88,82,0.517647058823529,170,87,83,0.511764705882353,0.0189120464968442,0.343595332152749,0.637492621350406
16,"Thüringen",16074098,"Tautenhain",1059,544,515,0.513692162417375,1081,573,508,0.530064754856614,0.0189120464968442,0.343595332152749,0.637492621350406
16,"Thüringen",16074099,"Thierschneck",109,58,51,0.532110091743119,110,56,54,0.509090909090909,0.0189120464968442,0.343595332152749,0.637492621350406
16,"Thüringen",16074101,"Tissa",140,77,63,0.55,139,73,66,0.525179856115108,0.0189120464968442,0.343595332152749,0.637492621350406
16,"Thüringen",16074102,"Trockenborn-Wolfersdorf",572,289,283,0.505244755244755,590,302,288,0.511864406779661,0.0189120464968442,0.343595332152749,0.637492621350406
16,"Thüringen",16074103,"Tröbnitz",475,245,230,0.515789473684211,454,231,223,0.508810572687225,0.0189120464968442,0.343595332152749,0.637492621350406
16,"Thüringen",16074104,"Unterbodnitz",196,98,98,0.5,194,96,98,0.494845360824742,0.0189120464968442,0.343595332152749,0.637492621350406
16,"Thüringen",16074105,"Waldeck",249,131,118,0.526104417670683,243,123,120,0.506172839506173,0.0189120464968442,0.343595332152749,0.637492621350406
16,"Thüringen",16074106,"Walpernhain",193,99,94,0.512953367875648,200,107,93,0.535,0.0189120464968442,0.343595332152749,0.637492621350406
16,"Thüringen",16074107,"Waltersdorf",187,105,82,0.561497326203209,168,92,76,0.547619047619048,0.0189120464968442,0.343595332152749,0.637492621350406
16,"Thüringen",16074108,"Weißbach",121,55,66,0.454545454545455,152,71,81,0.467105263157895,0.0189120464968442,0.343595332152749,0.637492621350406
16,"Thüringen",16074109,"Weißenborn",1192,599,593,0.50251677852349,1218,614,604,0.504105090311987,0.0189120464968442,0.343595332152749,0.637492621350406
16,"Thüringen",16074112,"Wichmar",229,120,109,0.524017467248908,231,121,110,0.523809523809524,0.0189120464968442,0.343595332152749,0.637492621350406
16,"Thüringen",16074113,"Zimmern",201,98,103,0.487562189054726,194,99,95,0.510309278350515,0.0189120464968442,0.343595332152749,0.637492621350406
16,"Thüringen",16074114,"Zöllnitz",766,375,391,0.489556135770235,770,382,388,0.496103896103896,0.0189120464968442,0.343595332152749,0.637492621350406
16,"Thüringen",16074116,"Schkölen, Stadt",2659,1390,1269,0.52275291462956,2649,1383,1266,0.522083805209513,0.0189120464968442,0.343595332152749,0.637492621350406
16,"Thüringen",16075002,"Birkenhügel",407,200,207,0.491400491400491,430,218,212,0.506976744186047,0.0189120464968442,0.343595332152749,0.637492621350406
16,"Thüringen",16075003,"Blankenberg",984,496,488,0.504065040650406,986,498,488,0.505070993914807,0.0189120464968442,0.343595332152749,0.637492621350406
16,"Thüringen",16075004,"Blankenstein",800,398,402,0.4975,838,422,416,0.503579952267303,0.0189120464968442,0.343595332152749,0.637492621350406
16,"Thüringen",16075006,"Bodelwitz",596,304,292,0.51006711409396,607,305,302,0.502471169686985,0.0189120464968442,0.343595332152749,0.637492621350406
16,"Thüringen",16075008,"Bucha",92,45,47,0.489130434782609,87,39,48,0.448275862068966,0.0189120464968442,0.343595332152749,0.637492621350406
16,"Thüringen",16075009,"Burgk",87,42,45,0.482758620689655,91,47,44,0.516483516483517,0.0189120464968442,0.343595332152749,0.637492621350406
16,"Thüringen",16075012,"Chursdorf",192,89,103,0.463541666666667,206,97,109,0.470873786407767,0.0189120464968442,0.343595332152749,0.637492621350406
16,"Thüringen",16075013,"Crispendorf",392,205,187,0.522959183673469,388,208,180,0.536082474226804,0.0189120464968442,0.343595332152749,0.637492621350406
16,"Thüringen",16075014,"Dittersdorf",284,143,141,0.503521126760563,277,139,138,0.501805054151625,0.0189120464968442,0.343595332152749,0.637492621350406
16,"Thüringen",16075016,"Döbritz",189,95,94,0.502645502645503,199,97,102,0.487437185929648,0.0189120464968442,0.343595332152749,0.637492621350406
16,"Thüringen",16075018,"Dreba",267,133,134,0.49812734082397,269,133,136,0.494423791821561,0.0189120464968442,0.343595332152749,0.637492621350406
16,"Thüringen",16075019,"Dreitzsch",429,227,202,0.529137529137529,430,230,200,0.534883720930233,0.0189120464968442,0.343595332152749,0.637492621350406
16,"Thüringen",16075023,"Eßbach",248,130,118,0.524193548387097,244,128,116,0.524590163934426,0.0189120464968442,0.343595332152749,0.637492621350406
16,"Thüringen",16075029,"Geroda",252,130,122,0.515873015873016,264,138,126,0.522727272727273,0.0189120464968442,0.343595332152749,0.637492621350406
16,"Thüringen",16075031,"Gertewitz",162,82,80,0.506172839506173,163,82,81,0.503067484662577,0.0189120464968442,0.343595332152749,0.637492621350406
16,"Thüringen",16075033,"Görkwitz",302,158,144,0.52317880794702,304,158,146,0.519736842105263,0.0189120464968442,0.343595332152749,0.637492621350406
16,"Thüringen",16075034,"Göschitz",258,135,123,0.523255813953488,257,133,124,0.517509727626459,0.0189120464968442,0.343595332152749,0.637492621350406
16,"Thüringen",16075035,"Gössitz",322,160,162,0.496894409937888,327,162,165,0.495412844036697,0.0189120464968442,0.343595332152749,0.637492621350406
16,"Thüringen",16075039,"Grobengereuth",221,112,109,0.506787330316742,225,115,110,0.511111111111111,0.0189120464968442,0.343595332152749,0.637492621350406
16,"Thüringen",16075042,"Harra",880,436,444,0.495454545454545,869,424,445,0.487917146144994,0.0189120464968442,0.343595332152749,0.637492621350406
16,"Thüringen",16075046,"Hirschberg, Stadt",2280,1089,1191,0.477631578947368,2343,1121,1222,0.478446436192915,0.0189120464968442,0.343595332152749,0.637492621350406
16,"Thüringen",16075047,"Keila",80,42,38,0.525,85,45,40,0.529411764705882,0.0189120464968442,0.343595332152749,0.637492621350406
16,"Thüringen",16075048,"Kirschkau",242,128,114,0.528925619834711,242,127,115,0.524793388429752,0.0189120464968442,0.343595332152749,0.637492621350406
16,"Thüringen",16075049,"Knau",637,317,320,0.497645211930926,644,312,332,0.484472049689441,0.0189120464968442,0.343595332152749,0.637492621350406
16,"Thüringen",16075051,"Kospoda",405,216,189,0.533333333333333,420,228,192,0.542857142857143,0.0189120464968442,0.343595332152749,0.637492621350406
16,"Thüringen",16075054,"Langenorla",1347,675,672,0.501113585746102,1462,727,735,0.497264021887825,0.0189120464968442,0.343595332152749,0.637492621350406
16,"Thüringen",16075056,"Lausnitz b. Neustadt an der Orla",337,169,168,0.501483679525223,338,169,169,0.5,0.0189120464968442,0.343595332152749,0.637492621350406
16,"Thüringen",16075057,"Lemnitz",386,198,188,0.512953367875648,383,197,186,0.514360313315927,0.0189120464968442,0.343595332152749,0.637492621350406
16,"Thüringen",16075061,"Linda b. Neustadt an der Orla",396,193,203,0.487373737373737,409,197,212,0.481662591687042,0.0189120464968442,0.343595332152749,0.637492621350406
16,"Thüringen",16075062,"Bad Lobenstein, Stadt",6236,3070,3166,0.492302758178319,6365,3160,3205,0.496465043205027,0.0189120464968442,0.343595332152749,0.637492621350406
16,"Thüringen",16075063,"Löhma",297,150,147,0.505050505050505,293,144,149,0.491467576791809,0.0189120464968442,0.343595332152749,0.637492621350406
16,"Thüringen",16075065,"Miesitz",288,152,136,0.527777777777778,300,151,149,0.503333333333333,0.0189120464968442,0.343595332152749,0.637492621350406
16,"Thüringen",16075066,"Mittelpöllnitz",278,142,136,0.510791366906475,284,143,141,0.503521126760563,0.0189120464968442,0.343595332152749,0.637492621350406
16,"Thüringen",16075068,"Moßbach",413,216,197,0.523002421307506,418,221,197,0.528708133971292,0.0189120464968442,0.343595332152749,0.637492621350406
16,"Thüringen",16075069,"Moxa",86,48,38,0.558139534883721,85,48,37,0.564705882352941,0.0189120464968442,0.343595332152749,0.637492621350406
16,"Thüringen",16075071,"Neundorf (bei Lobenstein)",602,306,296,0.508305647840532,604,310,294,0.513245033112583,0.0189120464968442,0.343595332152749,0.637492621350406
16,"Thüringen",16075072,"Neundorf (bei Schleiz)",282,137,145,0.485815602836879,297,144,153,0.484848484848485,0.0189120464968442,0.343595332152749,0.637492621350406
16,"Thüringen",16075073,"Neustadt an der Orla, Stadt",8359,4065,4294,0.486302189257088,8525,4168,4357,0.48891495601173,0.0189120464968442,0.343595332152749,0.637492621350406
16,"Thüringen",16075074,"Nimritz",316,167,149,0.528481012658228,319,166,153,0.520376175548589,0.0189120464968442,0.343595332152749,0.637492621350406
16,"Thüringen",16075075,"Oberoppurg",167,82,85,0.491017964071856,169,83,86,0.49112426035503,0.0189120464968442,0.343595332152749,0.637492621350406
16,"Thüringen",16075076,"Oettersdorf",840,424,416,0.504761904761905,844,426,418,0.504739336492891,0.0189120464968442,0.343595332152749,0.637492621350406
16,"Thüringen",16075077,"Oppurg",1241,630,611,0.507655116841257,1265,652,613,0.515415019762846,0.0189120464968442,0.343595332152749,0.637492621350406
16,"Thüringen",16075079,"Paska",112,61,51,0.544642857142857,109,58,51,0.532110091743119,0.0189120464968442,0.343595332152749,0.637492621350406
16,"Thüringen",16075081,"Peuschen",481,235,246,0.488565488565489,480,234,246,0.4875,0.0189120464968442,0.343595332152749,0.637492621350406
16,"Thüringen",16075082,"Pillingsdorf",151,74,77,0.490066225165563,163,79,84,0.484662576687117,0.0189120464968442,0.343595332152749,0.637492621350406
16,"Thüringen",16075083,"Plothen",286,144,142,0.503496503496504,288,145,143,0.503472222222222,0.0189120464968442,0.343595332152749,0.637492621350406
16,"Thüringen",16075084,"Pörmitz",185,95,90,0.513513513513513,187,95,92,0.508021390374332,0.0189120464968442,0.343595332152749,0.637492621350406
16,"Thüringen",16075085,"Pößneck, Stadt",12351,5868,6483,0.475103230507651,12756,6098,6658,0.47804954531201,0.0189120464968442,0.343595332152749,0.637492621350406
16,"Thüringen",16075086,"Pottiga",430,221,209,0.513953488372093,436,219,217,0.502293577981651,0.0189120464968442,0.343595332152749,0.637492621350406
16,"Thüringen",16075087,"Quaschwitz",67,36,31,0.537313432835821,64,36,28,0.5625,0.0189120464968442,0.343595332152749,0.637492621350406
16,"Thüringen",16075088,"Ranis, Stadt",1744,823,921,0.471903669724771,1765,836,929,0.473654390934844,0.0189120464968442,0.343595332152749,0.637492621350406
16,"Thüringen",16075093,"Rosendorf",174,96,78,0.551724137931034,169,93,76,0.550295857988166,0.0189120464968442,0.343595332152749,0.637492621350406
16,"Thüringen",16075097,"Schlegel",362,182,180,0.502762430939227,358,178,180,0.497206703910615,0.0189120464968442,0.343595332152749,0.637492621350406
16,"Thüringen",16075098,"Schleiz, Stadt",8502,4115,4387,0.484003763820278,8579,4181,4398,0.487352838326145,0.0189120464968442,0.343595332152749,0.637492621350406
16,"Thüringen",16075099,"Schmieritz",409,202,207,0.493887530562347,417,205,212,0.491606714628297,0.0189120464968442,0.343595332152749,0.637492621350406
16,"Thüringen",16075101,"Schmorda",85,40,45,0.470588235294118,84,39,45,0.464285714285714,0.0189120464968442,0.343595332152749,0.637492621350406
16,"Thüringen",16075102,"Schöndorf",293,144,149,0.491467576791809,297,144,153,0.484848484848485,0.0189120464968442,0.343595332152749,0.637492621350406
16,"Thüringen",16075103,"Seisla",151,77,74,0.509933774834437,159,82,77,0.515723270440252,0.0189120464968442,0.343595332152749,0.637492621350406
16,"Thüringen",16075105,"Solkwitz",66,36,30,0.545454545454545,64,34,30,0.53125,0.0189120464968442,0.343595332152749,0.637492621350406
16,"Thüringen",16075106,"Stanau",139,67,72,0.482014388489209,142,70,72,0.492957746478873,0.0189120464968442,0.343595332152749,0.637492621350406
16,"Thüringen",16075109,"Tegau",394,189,205,0.479695431472081,404,192,212,0.475247524752475,0.0189120464968442,0.343595332152749,0.637492621350406
16,"Thüringen",16075114,"Tömmelsdorf",142,68,74,0.47887323943662,150,76,74,0.506666666666667,0.0189120464968442,0.343595332152749,0.637492621350406
16,"Thüringen",16075116,"Triptis, Stadt",3744,1804,1940,0.481837606837607,3730,1794,1936,0.480965147453083,0.0189120464968442,0.343595332152749,0.637492621350406
16,"Thüringen",16075119,"Volkmannsdorf",278,140,138,0.503597122302158,268,137,131,0.511194029850746,0.0189120464968442,0.343595332152749,0.637492621350406
16,"Thüringen",16075121,"Weira",386,196,190,0.507772020725389,398,203,195,0.510050251256281,0.0189120464968442,0.343595332152749,0.637492621350406
16,"Thüringen",16075124,"Wernburg",662,340,322,0.513595166163142,679,347,332,0.511045655375552,0.0189120464968442,0.343595332152749,0.637492621350406
16,"Thüringen",16075125,"Wilhelmsdorf",218,111,107,0.509174311926605,218,110,108,0.504587155963303,0.0189120464968442,0.343595332152749,0.637492621350406
16,"Thüringen",16075127,"Ziegenrück, Stadt",722,357,365,0.494459833795014,722,351,371,0.486149584487535,0.0189120464968442,0.343595332152749,0.637492621350406
16,"Thüringen",16075129,"Krölpa",2797,1394,1403,0.498391133357168,2941,1455,1486,0.494729683781027,0.0189120464968442,0.343595332152749,0.637492621350406
16,"Thüringen",16075131,"Gefell, Stadt",2629,1305,1324,0.496386458729555,2678,1339,1339,0.5,0.0189120464968442,0.343595332152749,0.637492621350406
16,"Thüringen",16075132,"Tanna, Stadt",3791,1855,1936,0.489316802954366,3823,1883,1940,0.492545121632226,0.0189120464968442,0.343595332152749,0.637492621350406
16,"Thüringen",16075133,"Wurzbach, Stadt",3265,1640,1625,0.50229709035222,3343,1692,1651,0.506132216571941,0.0189120464968442,0.343595332152749,0.637492621350406
16,"Thüringen",16075134,"Remptendorf",3724,1895,1829,0.508861439312567,3767,1923,1844,0.510485797717016,0.0189120464968442,0.343595332152749,0.637492621350406
16,"Thüringen",16075135,"Saalburg-Ebersdorf, Stadt",3640,1784,1856,0.49010989010989,3713,1811,1902,0.487745758147051,0.0189120464968442,0.343595332152749,0.637492621350406
16,"Thüringen",16076003,"Bad Köstritz, Stadt",3662,1765,1897,0.48197706171491,3707,1812,1895,0.488804963582412,0.0189120464968442,0.343595332152749,0.637492621350406
16,"Thüringen",16076004,"Berga/Elster, Stadt",3535,1756,1779,0.496746817538897,3444,1700,1744,0.493612078977933,0.0189120464968442,0.343595332152749,0.637492621350406
16,"Thüringen",16076006,"Bethenhausen",249,126,123,0.506024096385542,255,126,129,0.494117647058824,0.0189120464968442,0.343595332152749,0.637492621350406
16,"Thüringen",16076007,"Bocka",462,238,224,0.515151515151515,491,244,247,0.496945010183299,0.0189120464968442,0.343595332152749,0.637492621350406
16,"Thüringen",16076008,"Brahmenau",983,490,493,0.498474059003052,1001,512,489,0.511488511488511,0.0189120464968442,0.343595332152749,0.637492621350406
16,"Thüringen",16076009,"Braunichswalde",617,312,305,0.505672609400324,630,320,310,0.507936507936508,0.0189120464968442,0.343595332152749,0.637492621350406
16,"Thüringen",16076012,"Caaschwitz",644,329,315,0.510869565217391,641,327,314,0.510140405616225,0.0189120464968442,0.343595332152749,0.637492621350406
16,"Thüringen",16076014,"Crimla",287,148,139,0.515679442508711,284,147,137,0.517605633802817,0.0189120464968442,0.343595332152749,0.637492621350406
16,"Thüringen",16076017,"Endschütz",343,175,168,0.510204081632653,353,183,170,0.518413597733711,0.0189120464968442,0.343595332152749,0.637492621350406
16,"Thüringen",16076019,"Gauern",119,60,59,0.504201680672269,120,60,60,0.5,0.0189120464968442,0.343595332152749,0.637492621350406
16,"Thüringen",16076022,"Greiz, Stadt",20713,9935,10778,0.4796504610631,21310,10243,11067,0.480666353824496,0.0189120464968442,0.343595332152749,0.637492621350406
16,"Thüringen",16076023,"Großenstein",1278,642,636,0.502347417840376,1287,652,635,0.506604506604507,0.0189120464968442,0.343595332152749,0.637492621350406
16,"Thüringen",16076024,"Hain",75,39,36,0.52,70,38,32,0.542857142857143,0.0189120464968442,0.343595332152749,0.637492621350406
16,"Thüringen",16076026,"Hartmannsdorf",368,190,178,0.516304347826087,365,182,183,0.498630136986301,0.0189120464968442,0.343595332152749,0.637492621350406
16,"Thüringen",16076027,"Hilbersdorf",229,117,112,0.510917030567686,226,118,108,0.52212389380531,0.0189120464968442,0.343595332152749,0.637492621350406
16,"Thüringen",16076028,"Hirschfeld",127,68,59,0.535433070866142,123,66,57,0.536585365853659,0.0189120464968442,0.343595332152749,0.637492621350406
16,"Thüringen",16076029,"Hohenleuben, Stadt",1646,919,727,0.558323207776428,1629,897,732,0.550644567219153,0.0189120464968442,0.343595332152749,0.637492621350406
16,"Thüringen",16076031,"Hohenölsen",620,324,296,0.52258064516129,622,321,301,0.516077170418006,0.0189120464968442,0.343595332152749,0.637492621350406
16,"Thüringen",16076033,"Hundhaupten",355,179,176,0.504225352112676,363,171,192,0.471074380165289,0.0189120464968442,0.343595332152749,0.637492621350406
16,"Thüringen",16076034,"Kauern",423,219,204,0.517730496453901,433,221,212,0.510392609699769,0.0189120464968442,0.343595332152749,0.637492621350406
16,"Thüringen",16076036,"Korbußen",468,230,238,0.491452991452991,467,230,237,0.492505353319058,0.0189120464968442,0.343595332152749,0.637492621350406
16,"Thüringen",16076038,"Kühdorf",69,34,35,0.492753623188406,71,28,43,0.394366197183099,0.0189120464968442,0.343595332152749,0.637492621350406
16,"Thüringen",16076039,"Langenwetzendorf",3425,1692,1733,0.494014598540146,3477,1718,1759,0.494104112740869,0.0189120464968442,0.343595332152749,0.637492621350406
16,"Thüringen",16076041,"Langenwolschendorf",885,448,437,0.506214689265537,878,464,414,0.528473804100228,0.0189120464968442,0.343595332152749,0.637492621350406
16,"Thüringen",16076042,"Lederhose",267,143,124,0.535580524344569,274,144,130,0.525547445255474,0.0189120464968442,0.343595332152749,0.637492621350406
16,"Thüringen",16076043,"Linda b. Weida",460,244,216,0.530434782608696,467,250,217,0.535331905781585,0.0189120464968442,0.343595332152749,0.637492621350406
16,"Thüringen",16076044,"Lindenkreuz",480,253,227,0.527083333333333,481,258,223,0.536382536382536,0.0189120464968442,0.343595332152749,0.637492621350406
16,"Thüringen",16076045,"Lunzig",165,78,87,0.472727272727273,164,79,85,0.481707317073171,0.0189120464968442,0.343595332152749,0.637492621350406
16,"Thüringen",16076047,"Mohlsdorf",2725,1349,1376,0.495045871559633,2765,1377,1388,0.498010849909584,0.0189120464968442,0.343595332152749,0.637492621350406
16,"Thüringen",16076049,"Münchenbernsdorf, Stadt",3037,1468,1569,0.483371748435957,3013,1463,1550,0.485562562230335,0.0189120464968442,0.343595332152749,0.637492621350406
16,"Thüringen",16076051,"Neugernsdorf",161,80,81,0.496894409937888,154,76,78,0.493506493506494,0.0189120464968442,0.343595332152749,0.637492621350406
16,"Thüringen",16076052,"Neumühle/Elster",430,204,226,0.474418604651163,384,202,182,0.526041666666667,0.0189120464968442,0.343595332152749,0.637492621350406
16,"Thüringen",16076055,"Paitzdorf",399,203,196,0.508771929824561,402,203,199,0.504975124378109,0.0189120464968442,0.343595332152749,0.637492621350406
16,"Thüringen",16076058,"Pölzig",1231,627,604,0.509341998375305,1245,633,612,0.508433734939759,0.0189120464968442,0.343595332152749,0.637492621350406
16,"Thüringen",16076059,"Reichstädt",374,196,178,0.524064171122995,375,197,178,0.525333333333333,0.0189120464968442,0.343595332152749,0.637492621350406
16,"Thüringen",16076061,"Ronneburg, Stadt",4982,2395,2587,0.480730630268968,5048,2422,2626,0.479793977812995,0.0189120464968442,0.343595332152749,0.637492621350406
16,"Thüringen",16076062,"Rückersdorf",796,391,405,0.491206030150754,809,399,410,0.493201483312732,0.0189120464968442,0.343595332152749,0.637492621350406
16,"Thüringen",16076064,"Saara",625,317,308,0.5072,598,323,275,0.540133779264214,0.0189120464968442,0.343595332152749,0.637492621350406
16,"Thüringen",16076065,"Schömberg",113,63,50,0.557522123893805,109,61,48,0.559633027522936,0.0189120464968442,0.343595332152749,0.637492621350406
16,"Thüringen",16076067,"Schwaara",153,77,76,0.503267973856209,146,75,71,0.513698630136986,0.0189120464968442,0.343595332152749,0.637492621350406
16,"Thüringen",16076068,"Schwarzbach",236,116,120,0.491525423728814,233,113,120,0.484978540772532,0.0189120464968442,0.343595332152749,0.637492621350406
16,"Thüringen",16076069,"Seelingstädt",1447,763,684,0.527297857636489,1313,661,652,0.503427265803503,0.0189120464968442,0.343595332152749,0.637492621350406
16,"Thüringen",16076073,"Steinsdorf",665,327,338,0.491729323308271,675,316,359,0.468148148148148,0.0189120464968442,0.343595332152749,0.637492621350406
16,"Thüringen",16076074,"Teichwitz",101,46,55,0.455445544554455,103,46,57,0.446601941747573,0.0189120464968442,0.343595332152749,0.637492621350406
16,"Thüringen",16076075,"Teichwolframsdorf",2449,1218,1231,0.497345855451205,2465,1223,1242,0.496146044624746,0.0189120464968442,0.343595332152749,0.637492621350406
16,"Thüringen",16076079,"Weida, Stadt",7439,3590,3849,0.482591746202447,7605,3695,3910,0.48586456278764,0.0189120464968442,0.343595332152749,0.637492621350406
16,"Thüringen",16076081,"Weißendorf",311,160,151,0.514469453376206,330,172,158,0.521212121212121,0.0189120464968442,0.343595332152749,0.637492621350406
16,"Thüringen",16076083,"Wildetaube",665,335,330,0.503759398496241,676,344,332,0.50887573964497,0.0189120464968442,0.343595332152749,0.637492621350406
16,"Thüringen",16076084,"Wünschendorf/Elster",2978,1459,1519,0.489926124916051,3010,1458,1552,0.484385382059801,0.0189120464968442,0.343595332152749,0.637492621350406
16,"Thüringen",16076086,"Zedlitz",680,328,352,0.482352941176471,662,322,340,0.486404833836858,0.0189120464968442,0.343595332152749,0.637492621350406
16,"Thüringen",16076087,"Zeulenroda-Triebes, Stadt",15859,7667,8192,0.483447884481998,16445,8043,8402,0.489084828215263,0.0189120464968442,0.343595332152749,0.637492621350406
16,"Thüringen",16076088,"Harth-Pöllnitz",2996,1470,1526,0.490654205607477,3046,1507,1539,0.494747209455023,0.0189120464968442,0.343595332152749,0.637492621350406
16,"Thüringen",16076089,"Kraftsdorf",3981,2001,1980,0.502637528259231,4007,2022,1985,0.504616920389319,0.0189120464968442,0.343595332152749,0.637492621350406
16,"Thüringen",16076091,"Vogtländisches Oberland",2841,1392,1449,0.489968321013728,2851,1394,1457,0.488951245177131,0.0189120464968442,0.343595332152749,0.637492621350406
16,"Thüringen",16076092,"Auma-Weidatal, Stadt",3836,1901,1935,0.495568300312826,3900,1938,1962,0.496923076923077,0.0189120464968442,0.343595332152749,0.637492621350406
16,"Thüringen",16077001,"Altenburg, Stadt",33671,16112,17559,0.478512666686466,34456,16617,17839,0.482267239377757,0.0189120464968442,0.343595332152749,0.637492621350406
16,"Thüringen",16077002,"Altkirchen",1080,550,530,0.509259259259259,1062,543,519,0.511299435028249,0.0189120464968442,0.343595332152749,0.637492621350406
16,"Thüringen",16077003,"Dobitschen",487,242,245,0.496919917864476,505,255,250,0.504950495049505,0.0189120464968442,0.343595332152749,0.637492621350406
16,"Thüringen",16077004,"Drogen",146,79,67,0.541095890410959,150,75,75,0.5,0.0189120464968442,0.343595332152749,0.637492621350406
16,"Thüringen",16077005,"Fockendorf",838,416,422,0.496420047732697,854,420,434,0.491803278688525,0.0189120464968442,0.343595332152749,0.637492621350406
16,"Thüringen",16077006,"Frohnsdorf",296,146,150,0.493243243243243,295,144,151,0.488135593220339,0.0189120464968442,0.343595332152749,0.637492621350406
16,"Thüringen",16077007,"Gerstenberg",522,250,272,0.478927203065134,530,251,279,0.473584905660377,0.0189120464968442,0.343595332152749,0.637492621350406
16,"Thüringen",16077008,"Göhren",423,215,208,0.508274231678487,419,211,208,0.503579952267303,0.0189120464968442,0.343595332152749,0.637492621350406
16,"Thüringen",16077009,"Göllnitz",339,176,163,0.519174041297935,331,166,165,0.501510574018127,0.0189120464968442,0.343595332152749,0.637492621350406
16,"Thüringen",16077011,"Göpfersdorf",247,126,121,0.510121457489879,237,121,116,0.510548523206751,0.0189120464968442,0.343595332152749,0.637492621350406
16,"Thüringen",16077012,"Gößnitz, Stadt",3724,1798,1926,0.4828141783029,3743,1808,1935,0.483034998664173,0.0189120464968442,0.343595332152749,0.637492621350406
16,"Thüringen",16077013,"Großröda",211,102,109,0.483412322274882,215,99,116,0.46046511627907,0.0189120464968442,0.343595332152749,0.637492621350406
16,"Thüringen",16077015,"Haselbach",824,409,415,0.496359223300971,830,410,420,0.493975903614458,0.0189120464968442,0.343595332152749,0.637492621350406
16,"Thüringen",16077016,"Heukewalde",211,103,108,0.488151658767773,217,103,114,0.474654377880184,0.0189120464968442,0.343595332152749,0.637492621350406
16,"Thüringen",16077017,"Heyersdorf",138,76,62,0.550724637681159,150,81,69,0.54,0.0189120464968442,0.343595332152749,0.637492621350406
16,"Thüringen",16077018,"Jonaswalde",311,158,153,0.508038585209003,316,166,150,0.525316455696203,0.0189120464968442,0.343595332152749,0.637492621350406
16,"Thüringen",16077019,"Jückelberg",306,158,148,0.516339869281046,314,162,152,0.515923566878981,0.0189120464968442,0.343595332152749,0.637492621350406
16,"Thüringen",16077022,"Kriebitzsch",1102,550,552,0.499092558983666,1120,565,555,0.504464285714286,0.0189120464968442,0.343595332152749,0.637492621350406
16,"Thüringen",16077023,"Langenleuba-Niederhain",1888,965,923,0.511122881355932,1894,967,927,0.510559662090813,0.0189120464968442,0.343595332152749,0.637492621350406
16,"Thüringen",16077026,"Löbichau",1027,508,519,0.494644595910419,1061,524,537,0.49387370405278,0.0189120464968442,0.343595332152749,0.637492621350406
16,"Thüringen",16077027,"Lödla",709,345,364,0.486600846262341,723,350,373,0.484094052558783,0.0189120464968442,0.343595332152749,0.637492621350406
16,"Thüringen",16077028,"Lucka, Stadt",4085,1943,2142,0.475642594859241,4065,1912,2153,0.470356703567036,0.0189120464968442,0.343595332152749,0.637492621350406
16,"Thüringen",16077029,"Lumpzig",554,265,289,0.478339350180505,562,271,291,0.48220640569395,0.0189120464968442,0.343595332152749,0.637492621350406
16,"Thüringen",16077031,"Mehna",322,161,161,0.5,336,174,162,0.517857142857143,0.0189120464968442,0.343595332152749,0.637492621350406
16,"Thüringen",16077032,"Meuselwitz, Stadt",10858,5254,5604,0.48388285135384,11087,5343,5744,0.481915757193109,0.0189120464968442,0.343595332152749,0.637492621350406
16,"Thüringen",16077034,"Monstab",464,226,238,0.487068965517241,471,233,238,0.494692144373673,0.0189120464968442,0.343595332152749,0.637492621350406
16,"Thüringen",16077036,"Nobitz",3445,1731,1714,0.502467343976778,3505,1764,1741,0.503281027104137,0.0189120464968442,0.343595332152749,0.637492621350406
16,"Thüringen",16077037,"Nöbdenitz",929,469,460,0.504843918191604,912,443,469,0.485745614035088,0.0189120464968442,0.343595332152749,0.637492621350406
16,"Thüringen",16077039,"Ponitz",1578,800,778,0.506970849176172,1645,838,807,0.509422492401216,0.0189120464968442,0.343595332152749,0.637492621350406
16,"Thüringen",16077041,"Posterstein",431,224,207,0.519721577726218,437,228,209,0.521739130434783,0.0189120464968442,0.343595332152749,0.637492621350406
16,"Thüringen",16077042,"Rositz",3012,1472,1540,0.48871181938911,3046,1491,1555,0.489494418910046,0.0189120464968442,0.343595332152749,0.637492621350406
16,"Thüringen",16077043,"Schmölln, Stadt",11571,5635,5936,0.486993345432547,11706,5708,5998,0.487613189817188,0.0189120464968442,0.343595332152749,0.637492621350406
16,"Thüringen",16077044,"Starkenberg",1853,946,907,0.510523475445224,1889,964,925,0.510322922181048,0.0189120464968442,0.343595332152749,0.637492621350406
16,"Thüringen",16077047,"Thonhausen",557,282,275,0.506283662477558,568,283,285,0.498239436619718,0.0189120464968442,0.343595332152749,0.637492621350406
16,"Thüringen",16077048,"Treben",1268,607,661,0.478706624605678,1265,610,655,0.482213438735178,0.0189120464968442,0.343595332152749,0.637492621350406
16,"Thüringen",16077049,"Vollmershain",323,159,164,0.492260061919505,325,163,162,0.501538461538461,0.0189120464968442,0.343595332152749,0.637492621350406
16,"Thüringen",16077051,"Wildenbörten",308,155,153,0.503246753246753,320,158,162,0.49375,0.0189120464968442,0.343595332152749,0.637492621350406
16,"Thüringen",16077052,"Windischleuba",2071,1039,1032,0.501690004828585,2076,1049,1027,0.505298651252408,0.0189120464968442,0.343595332152749,0.637492621350406
16,"Thüringen",16077055,"Ziegelheim",854,430,424,0.503512880562061,864,435,429,0.503472222222222,0.0189120464968442,0.343595332152749,0.637492621350406
16,"Thüringen",16077056,"Saara",2846,1438,1408,0.505270555165144,2942,1482,1460,0.503738953093134,0.0189120464968442,0.343595332152749,0.637492621350406
